SEASON_2,TEAM_NAME,total_shots_made,total_shots_attempted,total_2pt_made,total_2pt_attempted,total_3pt_made,total_3pt_attempted,clutch_shots_made,average_shot_distance,home_performance,away_performance,Offensive rating
2003-04,Atlanta Hawks,2829,6529,2410,5280,419,1249,129,11.302496553836727,0.4404287901990811,0.4261642156862745,99.1
2004-05,Atlanta Hawks,2942,6672,2638,5699,304,973,144,10.049010791366907,0.4459783913565426,0.4359281437125748,98.8
2005-06,Atlanta Hawks,2946,6496,2522,5342,424,1154,141,10.995535714285714,0.4621258399511301,0.4447548106765984,104.8
2006-07,Atlanta Hawks,2831,6372,2490,5334,341,1038,127,11.360954174513497,0.4519826517967782,0.4363867684478371,102.0
2007-08,Atlanta Hawks,2975,6552,2591,5474,384,1078,137,11.171550671550673,0.4682660188278166,0.4397054311138386,105.5
2008-09,Atlanta Hawks,2954,6447,2359,4818,595,1629,142,12.843803319373352,0.4696545284780579,0.4468150896722325,108.3
2009-10,Atlanta Hawks,3181,6799,2657,5346,524,1453,125,11.8471834093249,0.4715070870697136,0.4640933572710951,110.0
2010-11,Atlanta Hawks,2971,6428,2469,5002,502,1426,128,13.02846919726198,0.4648365206662554,0.4595103578154426,105.1
2011-12,Atlanta Hawks,2429,5348,1937,4018,492,1330,99,12.761406133133882,0.4553903345724907,0.4529721595184349,104.2
2012-13,Atlanta Hawks,3084,6644,2378,4743,706,1901,131,12.94521372667068,0.4688908926961226,0.4594513114259873,103.7
2013-14,Atlanta Hawks,3061,6687,2293,4572,768,2115,133,12.907581875280394,0.453781512605042,0.461698956780924,104.9
2014-15,Atlanta Hawks,3121,6699,2303,4547,818,2152,123,12.747574264815643,0.4758745476477684,0.456104049660065,108.2
2015-16,Atlanta Hawks,3166,6920,2353,4597,813,2323,116,12.684826589595376,0.4672225416906268,0.447704822777455,104.6
2016-17,Atlanta Hawks,3122,6913,2394,4781,728,2132,142,12.508028352379574,0.4568817818389492,0.4462034593960715,104.5
2017-18,Atlanta Hawks,3130,7015,2213,4471,917,2544,141,13.573057733428367,0.4527706000574217,0.4396942242355606,104.4
2018-19,Atlanta Hawks,3392,7524,2325,4490,1067,3034,151,13.072833599149387,0.4540441176470588,0.447524219590958,107.5
2019-20,Atlanta Hawks,2723,6067,1918,3651,805,2416,116,13.581506510631284,0.45830639948287,0.4389505549949546,107.0
2020-21,Atlanta Hawks,2937,6281,2042,3879,895,2402,119,13.456774398981054,0.4754150702426564,0.4598285169895205,114.3
2021-22,Atlanta Hawks,3401,7241,2345,4420,1056,2821,127,14.049164480044192,0.4815022421524663,0.4582085488701334,115.4
2022-23,Atlanta Hawks,3658,7574,2776,5069,882,2505,147,12.8662529706892,0.4812322029510743,0.4847749932632713,115.5
2003-04,Boston Celtics,2843,6415,2290,4816,553,1599,123,12.621200311769291,0.4437577255871446,0.4425920100660585,100.7
2004-05,Boston Celtics,3046,6511,2609,5259,437,1252,123,10.945630471509752,0.4686346863468634,0.4670144216017183,105.9
2005-06,Boston Celtics,2951,6322,2484,5032,467,1290,132,11.564220183486238,0.46112,0.4723177979355646,104.0
2006-07,Boston Celtics,2858,6454,2387,5171,471,1283,147,11.612643321970872,0.442799876657416,0.4428526938648396,102.3
2007-08,Boston Celtics,2986,6286,2390,4722,596,1564,133,12.255170219535476,0.482085732565579,0.4680379746835443,108.8
2008-09,Boston Celtics,3075,6333,2537,4978,538,1355,115,11.66335070266856,0.4970560892469786,0.4735994848679974,109.5
2009-10,Boston Celtics,3039,6293,2540,4861,499,1432,111,11.49324646432544,0.4890213299874529,0.4766505636070853,106.9
2010-11,Boston Celtics,3023,6219,2615,5100,408,1119,110,11.575816047596076,0.5032278889606198,0.4690804229413649,105.5
2011-12,Boston Celtics,2341,5086,1978,4098,363,988,95,12.411521824616594,0.4600155279503105,0.4605577689243028,100.1
2012-13,Boston Celtics,3001,6458,2503,5069,498,1389,125,12.388355528027253,0.4769861286254729,0.4528301886792453,102.2
2013-14,Boston Celtics,2996,6881,2421,5154,575,1727,117,12.770963522743788,0.441840023439789,0.4290657439446367,101.9
2014-15,Boston Celtics,3193,7209,2533,5190,660,2019,153,12.84006103481759,0.4419630548662807,0.4438860971524288,103.8
2015-16,Boston Celtics,3216,7316,2499,5176,717,2140,148,12.388463641334065,0.4355099838100378,0.4437673130193906,105.8
2016-17,Boston Celtics,3166,6974,2183,4236,983,2738,124,13.77717235445942,0.4557610241820768,0.4521538016767852,110.6
2017-18,Boston Celtics,3141,6975,2202,4483,939,2492,140,13.677562724014336,0.4546228020419739,0.4459263554653522,106.8
2018-19,Boston Celtics,3451,7423,2419,4594,1032,2829,148,14.003367910548295,0.4723712446351931,0.4573748308525033,111.3
2019-20,Boston Celtics,2971,6448,2066,3961,905,2487,133,13.451923076923077,0.4682564261381232,0.4532463497980739,112.8
2020-21,Boston Celtics,2985,6401,2006,3783,979,2618,141,14.198718950164038,0.4744479495268139,0.4583720210461157,113.1
2021-22,Boston Celtics,3341,7167,2256,4123,1085,3044,128,14.341146923398911,0.4664617104527669,0.4658679297854555,113.6
2022-23,Boston Celtics,3460,7278,2145,3786,1315,3492,129,15.028854080791426,0.4825117047645277,0.4683301343570057,117.3
2012-13,Brooklyn Nets,2942,6541,2314,4784,628,1757,102,12.157009631554809,0.4506699147381242,0.4488793368130181,106.9
2013-14,Brooklyn Nets,2930,6390,2222,4469,708,1921,106,13.092801251956182,0.4768148385033579,0.4410052099295127,105.4
2014-15,Brooklyn Nets,3069,6804,2528,5171,541,1633,119,11.918577307466196,0.4486769409712126,0.4534918276374443,103.4
2015-16,Brooklyn Nets,3135,6918,2605,5412,530,1506,146,11.59207863544377,0.4636443921106859,0.4430559500142005,102.4
2016-17,Brooklyn Nets,3101,6985,2225,4395,876,2590,154,12.74001431639227,0.4361671879442707,0.4518454440599769,103.6
2017-18,Brooklyn Nets,3136,7114,2095,4190,1041,2924,130,13.687095867303908,0.435543018335684,0.4460633230596806,106.1
2018-19,Brooklyn Nets,3301,7358,2254,4393,1047,2965,137,13.184968741505845,0.4563685636856368,0.4408396946564885,108.9
2019-20,Brooklyn Nets,2908,6498,1967,3752,941,2746,108,13.282856263465682,0.461659333752357,0.433956574185766,108.7
2020-21,Brooklyn Nets,3106,6289,2086,3689,1020,2600,107,13.63507711877882,0.4950176792028287,0.4927627438640654,117.3
2021-22,Brooklyn Nets,3442,7251,2502,4649,940,2602,118,13.476486001930768,0.4658025372311086,0.4835862068965517,113.2
2022-23,Brooklyn Nets,3399,6978,2351,4207,1048,2771,135,14.103038119805102,0.4851598173515982,0.4890616004605642,114.6
2004-05,Charlotte Hornets,2961,6859,2641,5978,320,881,116,11.377751858871555,0.4387456037514654,0.4247171453437772,99.8
2005-06,Charlotte Hornets,2961,6843,2533,5582,428,1261,136,11.576355399678503,0.4324167872648335,0.4329988193624557,101.2
2006-07,Charlotte Hornets,2960,6643,2503,5363,457,1280,121,11.40990516332982,0.4435096153846153,0.4476621417797888,102.4
2007-08,Charlotte Hornets,2960,6554,2431,5111,529,1443,117,11.69438510833079,0.4584848484848485,0.4446834665027658,103.7
2008-09,Charlotte Hornets,2866,6299,2376,4960,490,1339,127,11.225591363708524,0.4542820347714101,0.4556843094268712,103.7
2009-10,Charlotte Hornets,2858,6305,2398,4975,460,1330,111,10.73148295003965,0.4609130706691682,0.4454457676214998,103.9
2010-11,Charlotte Hornets,2873,6364,2480,5162,393,1202,135,11.461973601508486,0.4595519601742377,0.4431746031746031,102.8
2011-12,Charlotte Hornets,2193,5293,1930,4401,263,892,115,12.3011524655205,0.4066390041493776,0.4220287660862982,94.4
2012-13,Charlotte Hornets,2823,6649,2354,5250,469,1399,112,11.70747480824184,0.4350571256764883,0.4140836593439663,100.4
2013-14,Charlotte Hornets,2976,6727,2460,5259,516,1468,135,12.150587185966998,0.441527446300716,0.4432592592592592,103.0
2014-15,Charlotte Hornets,2913,6932,2415,5366,498,1566,127,12.747836122331217,0.4191428571428571,0.4213286713286713,99.6
2015-16,Charlotte Hornets,3036,6921,2163,4512,873,2409,121,13.701632712035831,0.4451201853460759,0.432237600922722,106.4
2016-17,Charlotte Hornets,3093,6998,2269,4653,824,2345,147,13.412403543869678,0.4485230857470605,0.4354884648248362,108.4
2017-18,Charlotte Hornets,3197,7106,2373,4873,824,2233,112,13.162257247396566,0.4563626126126126,0.4434440067529544,109.0
2018-19,Charlotte Hornets,3297,7362,2320,4579,977,2783,130,13.401792991035045,0.4596001095590249,0.4362705470223659,110.7
2019-20,Charlotte Hornets,2425,5586,1640,3355,785,2231,102,13.020766201217327,0.4408885542168674,0.4279863481228669,105.9
2020-21,Charlotte Hornets,2875,6324,1890,3658,985,2666,124,13.741302972802025,0.4550047363435427,0.4542286981311371,110.1
2021-22,Charlotte Hornets,3508,7497,2365,4367,1143,3130,148,13.424569827931172,0.4642094017094017,0.4716227018385291,113.6
2022-23,Charlotte Hornets,3385,7413,2504,4744,881,2669,165,12.598947794415215,0.4529282977558839,0.4602287842511306,108.4
2003-04,Chicago Bulls,2798,6753,2369,5497,429,1256,129,12.08262994224789,0.4044679600235156,0.4243509400179051,95.6
2004-05,Chicago Bulls,2849,6592,2338,5159,511,1433,124,11.936893203883496,0.4343098761703413,0.4300518134715025,105.8
2005-06,Chicago Bulls,3004,6737,2444,5260,560,1477,136,12.626243134926526,0.4503271861986913,0.4414814814814815,103.3
2006-07,Chicago Bulls,3046,6663,2566,5426,480,1237,143,12.316073840612336,0.4639545318576129,0.4503012048192771,104.0
2007-08,Chicago Bulls,2987,6861,2513,5556,474,1305,111,12.212505465675555,0.4383443518252371,0.4322885866351271,102.9
2008-09,Chicago Bulls,3126,6844,2633,5553,493,1291,134,12.0562536528346,0.4603685288095934,0.4531386861313868,107.2
2009-10,Chicago Bulls,3081,6824,2729,5759,352,1065,121,11.500879249706916,0.4519872352770525,0.450992004737933,102.6
2010-11,Chicago Bulls,3042,6587,2531,5172,511,1415,137,12.047517838166083,0.4642424242424242,0.4593854578643139,107.2
2011-12,Chicago Bulls,2467,5461,2048,4345,419,1116,99,12.10309467130562,0.4442426443879404,0.4593796159527326,106.3
2012-13,Chicago Bulls,2926,6698,2480,5433,446,1265,116,11.733502538071066,0.4316353887399464,0.4420832086201736,102.4
2013-14,Chicago Bulls,2843,6577,2335,5118,508,1459,97,12.184734681465716,0.4324970131421744,0.4320222979250542,101.7
2014-15,Chicago Bulls,3001,6797,2356,4972,645,1825,129,12.179049580697368,0.4396999422965955,0.4434103872710898,106.3
2015-16,Chicago Bulls,3165,7170,2514,5417,651,1753,134,12.189958158995816,0.4386936064212566,0.4441945459657014,104.1
2016-17,Chicago Bulls,3169,7138,2546,5310,623,1828,126,12.355001400952649,0.4385041551246537,0.4495464852607709,106.5
2017-18,Chicago Bulls,3170,7285,2264,4736,906,2549,132,13.611805078929306,0.4378600823045268,0.4324175824175824,103.4
2018-19,Chicago Bulls,3266,7205,2521,5082,745,2123,170,11.897571131158918,0.4489626556016597,0.4576601671309192,104.5
2019-20,Chicago Bulls,2573,5762,1780,3480,793,2282,107,12.760152724748352,0.4437086092715231,0.449671772428884,105.8
2020-21,Chicago Bulls,3035,6380,2131,3934,904,2446,110,13.303291536050155,0.4690851735015773,0.4822429906542056,110.4
2021-22,Chicago Bulls,3422,7127,2550,4763,872,2364,131,13.367756419250735,0.4852005532503458,0.4749430523917995,112.7
2022-23,Chicago Bulls,3488,7116,2634,4749,854,2367,133,13.100758853288363,0.4949095022624434,0.4854748603351955,112.8
2003-04,Cleveland Cavaliers,2922,6753,2675,5967,247,786,119,10.155042203465127,0.4333817126269956,0.4319830713422007,100.6
2004-05,Cleveland Cavaliers,2990,6687,2690,5783,300,904,135,10.741887243906088,0.4620731338773043,0.4325044404973357,105.3
2005-06,Cleveland Cavaliers,2908,6412,2411,4947,497,1465,132,11.494541484716157,0.4628357276702061,0.4442367601246106,106.6
2006-07,Cleveland Cavaliers,2978,6658,2484,5254,494,1404,128,11.629918894562932,0.4536760310818888,0.4408212560386473,104.4
2007-08,Cleveland Cavaliers,2937,6697,2385,5153,552,1544,149,12.284903688218606,0.4427253793513835,0.4343525179856115,104.8
2008-09,Cleveland Cavaliers,3022,6454,2366,4784,656,1670,105,13.315308335915711,0.4777365491651206,0.458695652173913,111.2
2009-10,Cleveland Cavaliers,3100,6390,2499,4809,601,1581,106,12.050234741784038,0.4965560425798372,0.4737171464330413,110.6
2010-11,Cleveland Cavaliers,2886,6647,2377,5158,509,1489,116,11.850910185045883,0.4336842105263158,0.4346779048765803,101.5
2011-12,Cleveland Cavaliers,2261,5360,1821,4087,440,1273,129,11.255597014925373,0.4227188081936685,0.4209345794392523,100.0
2012-13,Cleveland Cavaliers,2993,6901,2446,5320,547,1581,136,11.88566874366034,0.4351476548928778,0.4322599361763852,103.2
2013-14,Cleveland Cavaliers,3036,6954,2452,5315,584,1639,121,12.298964624676444,0.4337964275588318,0.4394514152319813,103.5
2014-15,Cleveland Cavaliers,3088,6738,2263,4486,825,2252,119,12.770851884832297,0.4683088014418744,0.448518627163391,110.1
2015-16,Cleveland Cavaliers,3169,6883,2291,4460,878,2423,133,13.246404184221996,0.4688760806916426,0.451801933782596,110.2
2016-17,Cleveland Cavaliers,3273,6956,2208,4184,1065,2772,129,13.98174238067855,0.4818519577022006,0.4590685565519236,112.8
2017-18,Cleveland Cavaliers,3311,6950,2330,4314,981,2636,126,13.81093525179856,0.483204134366925,0.4695702336313816,112.0
2018-19,Cleveland Cavaliers,3189,7184,2342,4796,847,2388,131,12.937360801781738,0.4450931331665276,0.4427097853359353,106.8
2019-20,Cleveland Cavaliers,2619,5715,1892,3645,727,2070,115,12.745056867891511,0.4616352201257861,0.454043392504931,106.8
2020-21,Cleveland Cavaliers,2778,6175,2058,4034,720,2141,96,12.07012145748988,0.4596513879922531,0.4400389990250243,105.2
2021-22,Cleveland Cavaliers,3255,6940,2302,4254,953,2686,127,13.263544668587896,0.4678951914771091,0.4701471012402654,111.0
2022-23,Cleveland Cavaliers,3408,6984,2458,4395,950,2589,108,12.932846506300114,0.4918126975007182,0.4841564373394234,115.5
2003-04,Dallas Mavericks,3322,7230,2815,5774,507,1456,134,11.717704011065006,0.4803215077605322,0.4387078961899503,110.4
2004-05,Dallas Mavericks,3058,6691,2595,5418,463,1273,122,11.904498580182334,0.457252358490566,0.4568050924522582,108.5
2005-06,Dallas Mavericks,2948,6375,2532,5262,416,1113,112,11.485333333333331,0.4712571067593177,0.4537239015269554,109.9
2006-07,Dallas Mavericks,3010,6442,2475,5038,535,1404,115,12.621701334989131,0.4767945544554455,0.457632398753894,109.7
2007-08,Dallas Mavericks,3025,6515,2531,5112,494,1403,127,12.66968534151957,0.4788602941176471,0.4497077822208551,109.5
2008-09,Dallas Mavericks,3128,6770,2557,5138,571,1632,127,13.002363367799116,0.4791790600832837,0.4451291079812207,109.0
2009-10,Dallas Mavericks,3140,6759,2582,5262,558,1497,113,12.340434975588105,0.4606973995271867,0.4684444444444444,107.8
2010-11,Dallas Mavericks,3069,6463,2424,4695,645,1768,124,13.125019340863377,0.4824588637069233,0.4673041332510795,108.4
2011-12,Dallas Mavericks,2398,5412,1901,3948,497,1464,90,12.911677753141168,0.4426529864419201,0.4435333581811405,102.1
2012-13,Dallas Mavericks,3182,6892,2576,5264,606,1628,121,12.55034822983169,0.4676113360323887,0.4557367501456028,104.7
2013-14,Dallas Mavericks,3248,6857,2528,4981,720,1876,124,12.773078605804288,0.4797297297297297,0.4677092383434694,109.5
2014-15,Dallas Mavericks,3255,7036,2523,4954,732,2082,144,12.805571347356452,0.4717963552212901,0.4537580329701033,108.2
2015-16,Dallas Mavericks,3062,6898,2258,4558,804,2340,118,13.6928095100029,0.4515001456452083,0.4363636363636363,105.5
2016-17,Dallas Mavericks,2967,6749,2090,4277,877,2472,127,14.890650466735812,0.4426912771658232,0.4365781710914454,104.7
2017-18,Dallas Mavericks,3128,7042,2161,4354,967,2688,157,14.4092587333144,0.4433775769556622,0.4450157097972008,105.4
2018-19,Dallas Mavericks,3182,7122,2160,4120,1022,3002,129,14.009407469811851,0.4523539421440726,0.4413236929922136,108.7
2019-20,Dallas Mavericks,3124,6772,1988,3677,1136,3095,116,14.710720614294152,0.4620087336244541,0.4605933473179502,115.9
2020-21,Dallas Mavericks,2958,6287,1964,3543,994,2744,123,14.778431684428185,0.4665594855305466,0.4743468681145735,114.6
2021-22,Dallas Mavericks,3222,6982,2149,3919,1073,3063,117,14.81094242337439,0.4597602739726027,0.4631972397929845,112.5
2022-23,Dallas Mavericks,3283,6909,2037,3547,1246,3362,108,15.140686061658704,0.4750499001996008,0.4753086419753086,115.9
2003-04,Denver Nuggets,2993,6763,2662,5778,331,985,127,10.99659914239243,0.4504820333041192,0.4344311377245509,102.4
2004-05,Denver Nuggets,3038,6615,2718,5675,320,940,136,10.772184429327286,0.4678047319556753,0.4505494505494505,104.7
2005-06,Denver Nuggets,3078,6672,2728,5596,350,1076,105,11.06115107913669,0.4661190965092402,0.4563285320257432,104.4
2006-07,Denver Nuggets,3164,6805,2680,5365,484,1440,111,11.12417340191036,0.464420563462097,0.465496728138013,106.7
2007-08,Denver Nuggets,3307,7038,2738,5433,569,1605,134,11.548593350383632,0.4661971830985915,0.4736238532110092,108.9
2008-09,Denver Nuggets,3058,6510,2510,5033,548,1477,114,11.443317972350233,0.4745038167938931,0.4649149922720247,109.0
2009-10,Denver Nuggets,3124,6678,2580,5161,544,1517,120,11.702605570530098,0.4767269493032908,0.4586989409984871,110.8
2010-11,Denver Nuggets,3144,6609,2483,4909,661,1700,144,11.829626267211378,0.4884971616372871,0.4625996321275291,111.7
2011-12,Denver Nuggets,2572,5403,2137,4093,435,1310,106,10.526374236535258,0.4791666666666667,0.4730365544697792,108.3
2012-13,Denver Nuggets,3339,6981,2818,5465,521,1516,136,9.86219739292365,0.486138896827665,0.4704192992533027,109.3
2013-14,Denver Nuggets,3147,7042,2445,5083,702,1959,118,12.018176654359555,0.4455583402951824,0.4482758620689655,105.1
2014-15,Denver Nuggets,3099,7158,2439,5126,660,2032,141,12.26348141939089,0.4369040942232193,0.4290089086859688,103.9
2015-16,Denver Nuggets,3092,7002,2437,5060,655,1942,123,11.75078548986004,0.44380236925744,0.4394238915560576,104.9
2016-17,Denver Nuggets,3377,7190,2507,4829,870,2361,133,12.322531293463143,0.481998325425621,0.4574438591627391,112.2
2017-18,Denver Nuggets,3338,7102,2398,4566,940,2536,140,12.795550549141089,0.4777304964539007,0.4623986580933743,111.4
2018-19,Denver Nuggets,3439,7384,2536,4813,903,2571,145,12.572589382448538,0.4852216748768473,0.4466487935656836,112.1
2019-20,Denver Nuggets,3069,6488,2268,4254,801,2234,122,12.816892725030826,0.4784456587735276,0.4674389480275516,112.6
2020-21,Denver Nuggets,3114,6422,2187,3960,927,2462,129,13.64481469947057,0.4819722650231124,0.4878816493547371,116.3
2021-22,Denver Nuggets,3416,7079,2377,4135,1039,2944,133,13.933606441587797,0.4822278197593059,0.4828864803194523,113.8
2022-23,Denver Nuggets,3574,7088,2605,4529,969,2559,115,12.928329571106095,0.5138927869772664,0.4944680851063829,116.8
2003-04,Detroit Pistons,2747,6314,2414,5346,333,968,111,10.328159645232816,0.4429065743944637,0.4271132376395534,100.3
2004-05,Detroit Pistons,2851,6421,2488,5368,363,1053,113,11.10169755489799,0.4342308882698855,0.4539184952978056,103.9
2005-06,Detroit Pistons,2983,6558,2426,5107,557,1451,113,12.81793229643184,0.4595001505570611,0.45010812480692,109.3
2006-07,Detroit Pistons,2942,6484,2493,5179,449,1305,127,11.989049969154845,0.454320987654321,0.4531442663378545,107.4
2007-08,Detroit Pistons,2999,6551,2512,5221,487,1330,128,13.119218439932837,0.4679817905918058,0.4474815724815725,109.8
2008-09,Detroit Pistons,2981,6559,2604,5480,377,1079,131,12.300045738679676,0.4622003687768899,0.4468986384266263,105.8
2009-10,Detroit Pistons,2938,6600,2566,5412,372,1188,136,11.455454545454543,0.4377669310555216,0.4524382901866345,104.5
2010-11,Detroit Pistons,3055,6646,2584,5391,471,1255,126,11.478934697562444,0.4761189546410333,0.4431715405486885,107.0
2011-12,Detroit Pistons,2291,5232,1974,4316,317,916,105,10.924120795107031,0.4488854727132975,0.4269961977186312,100.0
2012-13,Detroit Pistons,2979,6638,2466,5198,513,1440,151,10.613136486893644,0.4597631339204373,0.4379671150971599,102.7
2013-14,Detroit Pistons,3181,7123,2675,5544,506,1579,109,10.658149656043802,0.4520703346568349,0.4412010008340283,105.2
2014-15,Detroit Pistons,3041,7038,2338,4995,703,2043,156,11.768684285308328,0.4401941193262917,0.424045261669024,104.3
2015-16,Detroit Pistons,3111,7083,2371,4939,740,2144,133,12.285048708174502,0.4493243243243243,0.4290569243840272,105.3
2016-17,Detroit Pistons,3268,7278,2638,5367,630,1911,134,12.575982412750756,0.4542966611932129,0.4437086092715231,105.3
2017-18,Detroit Pistons,3208,7129,2322,4756,886,2373,133,13.146584373684949,0.458909912454109,0.4411928651059086,106.6
2018-19,Detroit Pistons,3185,7238,2192,4384,993,2854,144,13.489085382702404,0.4488558036945134,0.431182497923013,108.4
2019-20,Detroit Pistons,2595,5658,1804,3501,791,2157,118,12.75751148815836,0.4690921935711762,0.4481782808631058,108.8
2020-21,Detroit Pistons,2783,6162,1951,3792,832,2370,113,13.01152223304122,0.4480928689883914,0.4550365427391166,107.6
2021-22,Detroit Pistons,3129,7267,2204,4429,925,2838,125,13.566120820145866,0.4326553051126993,0.4284926977128686,105.6
2022-23,Detroit Pistons,3244,7140,2310,4481,934,2659,138,13.458403361344535,0.4624860022396416,0.4461883408071749,109.9
2003-04,Golden State Warriors,2875,6511,2446,5228,429,1283,123,11.502073414222084,0.449772382397572,0.4331467661691542,101.5
2004-05,Golden State Warriors,3029,7039,2405,5265,624,1774,137,12.919448785338826,0.4359619686800894,0.4244874386370199,103.4
2005-06,Golden State Warriors,2939,6785,2314,4953,625,1832,140,12.671333824613118,0.4441465594280607,0.4224037339556593,103.5
2006-07,Golden State Warriors,3261,7048,2561,5082,700,1966,128,11.933598183881951,0.4798973481608212,0.4456368257554363,106.2
2007-08,Golden State Warriors,3403,7406,2642,5221,761,2185,140,12.331758034026466,0.4663641217298451,0.4524590163934426,110.4
2008-09,Golden State Warriors,3231,7054,2681,5580,550,1474,133,12.138644740572724,0.4750283768444949,0.4410764872521246,108.0
2009-10,Golden State Warriors,3329,7094,2696,5407,633,1687,135,12.855229771638005,0.4730822873082287,0.4653747506412083,107.0
2010-11,Golden State Warriors,3251,7047,2566,5298,685,1749,132,12.539094650205762,0.4725930133484805,0.4500850822461713,107.1
2011-12,Golden State Warriors,2489,5443,1965,4092,524,1351,103,12.89178761712291,0.4632623071271124,0.4513046674016905,103.9
2012-13,Golden State Warriors,3130,6840,2472,5208,658,1632,120,13.003362573099416,0.465619442797866,0.4497980380842469,105.1
2013-14,Golden State Warriors,3236,7005,2462,4968,774,2037,132,12.929764453961456,0.4655858930602958,0.4582975064488392,106.3
2014-15,Golden State Warriors,3410,7137,2527,4920,883,2217,134,13.078043996076785,0.4959166431990988,0.4598438371444506,110.4
2015-16,Golden State Warriors,3486,7155,2412,4567,1074,2588,143,13.45213137665968,0.49315833566043,0.4812534974818131,113.5
2016-17,Golden State Warriors,3531,7139,2550,4578,981,2561,128,13.675724891441378,0.5111669458403126,0.4779308405960079,114.8
2017-18,Golden State Warriors,3509,6979,2583,4610,926,2369,118,13.96690070210632,0.5098152424942263,0.4958748221906117,112.8
2018-19,Golden State Warriors,3612,7361,2525,4537,1087,2824,134,14.758185029207988,0.4921323928377645,0.4892517006802721,115.0
2019-20,Golden State Warriors,2510,5730,1832,3698,678,2032,103,13.960383944153577,0.4424898511502029,0.4333093006488824,104.4
2020-21,Golden State Warriors,2973,6347,1925,3558,1048,2789,133,14.84055459272097,0.4850223072020395,0.4521657837332502,110.5
2021-22,Golden State Warriors,3323,7087,2147,3856,1176,3231,140,15.040073373782985,0.4739626844890002,0.4636727688787185,112.1
2022-23,Golden State Warriors,3538,7393,2175,3853,1363,3540,149,15.527796564317596,0.4806555615260612,0.476436938163988,115.1
2003-04,Houston Rockets,2738,6195,2223,4789,515,1406,126,12.334301856335754,0.4507491233662735,0.4329627207325049,99.7
2004-05,Houston Rockets,2846,6419,2293,4898,553,1521,129,13.041127901542296,0.4358893777498429,0.4507259808464627,104.4
2005-06,Houston Rockets,2708,6252,2239,4838,469,1414,122,12.229526551503518,0.4279407127089246,0.4384939954560207,100.4
2006-07,Houston Rockets,2906,6528,2201,4635,705,1893,105,12.853400735294118,0.4506912442396313,0.4396578062939199,104.7
2007-08,Houston Rockets,3003,6698,2420,4991,583,1707,117,12.31516870707674,0.452402004126142,0.4441754916792738,105.4
2008-09,Houston Rockets,2959,6525,2338,4870,621,1655,114,11.962145593869732,0.4564755838641189,0.4504337050805452,107.1
2009-10,Houston Rockets,3093,6921,2448,5085,645,1836,121,11.654674180031789,0.456099681251811,0.4377521613832853,106.8
2010-11,Houston Rockets,3169,6973,2493,5132,676,1841,144,12.396099239925428,0.4506802721088435,0.4583454281567489,110.2
2011-12,Houston Rockets,2489,5542,2011,4213,478,1329,104,12.254601226993865,0.450875312611647,0.4473204520597885,104.2
2012-13,Houston Rockets,3124,6781,2257,4413,867,2368,137,12.30261023447869,0.4678414096916299,0.4534952606635071,108.8
2013-14,Houston Rockets,3114,6599,2339,4424,775,2175,103,11.457948173965752,0.4781144781144781,0.4657863145258103,109.8
2014-15,Houston Rockets,3032,6831,2099,4152,933,2679,117,12.69814082857561,0.4414705882352941,0.4462255902069367,106.0
2015-16,Houston Rockets,3093,6841,2216,4314,877,2527,121,12.509574623593045,0.4528742340239276,0.4513766842413591,107.3
2016-17,Houston Rockets,3302,7145,2124,3846,1178,3299,130,13.965010496850944,0.4628397115917914,0.4614297824244137,114.1
2017-18,Houston Rockets,3174,6906,1918,3436,1256,3470,118,15.047929336808572,0.46286701208981,0.4562937062937063,114.1
2018-19,Houston Rockets,3218,7163,1895,3442,1323,3721,117,15.108194890409049,0.4513792142658122,0.4471180749860101,114.9
2019-20,Houston Rockets,2936,6512,1810,3251,1126,3261,110,14.743857493857494,0.4484645788993615,0.4533043748060812,112.5
2020-21,Houston Rockets,2826,6372,1834,3449,992,2923,120,14.226773383553043,0.4339861023373342,0.4529008109794136,107.0
2021-22,Houston Rockets,3229,7083,2124,3913,1105,3170,143,13.727234222786954,0.4600280504908836,0.4516770892552587,108.1
2022-23,Houston Rockets,3329,7287,2473,4668,856,2619,139,12.519280911211746,0.4572059635560463,0.4564802182810368,110.5
2003-04,Indiana Pacers,2753,6322,2304,5041,449,1281,104,11.700885795634292,0.4273611546909319,0.4437001594896331,102.5
2004-05,Indiana Pacers,2668,6169,2126,4594,542,1575,116,12.731885232614689,0.4355670103092783,0.4293637846655791,103.7
2005-06,Indiana Pacers,2786,6274,2250,4738,536,1536,112,12.43018807778132,0.4532949456174024,0.4348792884371029,103.1
2006-07,Indiana Pacers,2872,6561,2391,5172,481,1389,133,12.125285779606768,0.4456883509833585,0.4296683046683047,101.9
2007-08,Indiana Pacers,3102,6993,2347,4972,755,2021,120,13.542113542113542,0.4417817874259938,0.4454439930354034,105.1
2008-09,Indiana Pacers,3220,7080,2568,5355,652,1725,132,12.456497175141244,0.4548260381593715,0.454778156996587,107.2
2009-10,Indiana Pacers,3019,6821,2361,4927,658,1894,116,12.99091042369154,0.449074074074074,0.4359583952451709,103.0
2010-11,Indiana Pacers,3003,6786,2418,5134,585,1652,109,12.697612732095491,0.4522144522144522,0.4326177698270722,104.1
2011-12,Indiana Pacers,2354,5374,1962,4311,392,1063,96,11.367696315593598,0.4439132033835969,0.432015065913371,105.5
2012-13,Indiana Pacers,2845,6524,2290,4926,555,1598,116,12.234671980380137,0.4380952380952381,0.4339443742098609,103.4
2013-14,Indiana Pacers,2949,6572,2399,5031,550,1541,113,12.494978697504564,0.4607633587786259,0.4367606915377616,103.6
2014-15,Indiana Pacers,2998,6824,2386,5084,612,1740,133,12.998974208675264,0.4462616822429907,0.4323529411764706,102.9
2015-16,Indiana Pacers,3135,6970,2479,5096,656,1874,125,13.060975609756095,0.4561959654178674,0.4434285714285714,103.8
2016-17,Indiana Pacers,3211,6918,2512,5046,699,1872,135,12.982653946227233,0.4722780810112036,0.4559208612161769,107.9
2017-18,Indiana Pacers,3345,7083,2604,5073,741,2010,140,13.027954256670904,0.4779036827195467,0.4666479031804109,108.5
2018-19,Indiana Pacers,3390,7135,2611,5054,779,2081,149,12.447372109320252,0.4784182678919521,0.4717832957110609,109.4
2019-20,Indiana Pacers,3075,6457,2332,4411,743,2046,104,12.767384234164473,0.4797615312205836,0.472782874617737,109.5
2020-21,Indiana Pacers,3115,6567,2226,4122,889,2445,126,12.669559920816202,0.4662765629812134,0.4822289156626506,111.9
2021-22,Indiana Pacers,3398,7338,2401,4439,997,2899,134,13.567593349686565,0.4762290653700702,0.4496699669966996,111.9
2022-23,Indiana Pacers,3444,7345,2332,4315,1112,3030,133,13.554663036078964,0.4736417428725121,0.4640198511166253,113.8
2003-04,LA Clippers,2817,6579,2488,5555,329,1024,144,10.674570603435171,0.4324894514767932,0.4237963814780742,101.9
2004-05,LA Clippers,2924,6368,2693,5699,231,669,132,11.054177135678392,0.4714108141702921,0.4466666666666666,103.8
2005-06,LA Clippers,2993,6443,2703,5600,290,843,126,11.509390035697656,0.4680651221039449,0.4610649430594029,103.8
2006-07,LA Clippers,2880,6318,2566,5415,314,903,118,11.823994935106048,0.4610721123165284,0.4506909547738693,103.8
2007-08,LA Clippers,2820,6445,2470,5366,350,1079,115,12.487975174553918,0.4381846635367762,0.4369230769230769,99.9
2008-09,LA Clippers,2955,6695,2420,5183,535,1512,130,11.886183719193427,0.4420925309948594,0.4406729634002361,101.0
2009-10,LA Clippers,3001,6600,2519,5144,482,1456,121,11.676363636363636,0.4618736383442265,0.4478889873043992,102.3
2010-11,LA Clippers,3012,6590,2502,5075,510,1515,138,11.566767830045524,0.4637416209628275,0.4504232164449818,104.8
2011-12,LA Clippers,2437,5362,1925,3925,512,1437,102,13.237784408802684,0.467018469656992,0.4422296050203027,107.5
2012-13,LA Clippers,3160,6606,2533,4856,627,1750,107,12.525128670905238,0.4930764599638771,0.4634591961023142,109.8
2013-14,LA Clippers,3206,6754,2515,4795,691,1959,127,13.313740005922416,0.4852071005917159,0.4641375222288085,111.3
2014-15,LA Clippers,3227,6827,2401,4628,826,2199,120,14.137835066647137,0.4698046181172291,0.4755001449695564,111.6
2003-04,Los Angeles Lakers,3028,6676,2663,5561,365,1115,123,11.129568603954464,0.4595410628019323,0.4476813317479191,104.2
2004-05,Los Angeles Lakers,2895,6629,2251,4816,644,1813,125,12.35042992909941,0.4463519313304721,0.4273834273834274,106.4
2005-06,Los Angeles Lakers,2992,6607,2440,5024,552,1583,118,12.449523232934766,0.4624434389140271,0.4431956257594168,106.8
2006-07,Los Angeles Lakers,3103,6664,2495,4940,608,1724,139,12.07593037214886,0.4754974754974755,0.4555656657567485,107.3
2007-08,Los Angeles Lakers,3248,6818,2586,5067,662,1751,147,12.246259900264008,0.4743440233236151,0.4784533648170012,111.7
2008-09,Los Angeles Lakers,3305,6978,2760,5465,545,1513,140,11.521496130696477,0.4742385425562198,0.473015873015873,111.4
2009-10,Los Angeles Lakers,3144,6875,2612,5313,532,1562,130,11.784145454545454,0.4589928057553957,0.4555882352941176,107.6
2010-11,Los Angeles Lakers,3126,6755,2604,5270,522,1485,128,12.238490007401923,0.4662970528158739,0.4591346153846153,109.6
2011-12,Los Angeles Lakers,2428,5318,2067,4207,361,1111,108,12.015419330575403,0.4678095238095238,0.4455997029335314,104.5
2012-13,Los Angeles Lakers,3037,6632,2326,4625,711,2007,141,12.835042219541617,0.4666666666666667,0.4492010853180584,107.0
2013-14,Los Angeles Lakers,3138,6974,2365,4948,773,2026,143,13.033983366790938,0.4593659942363112,0.4406392694063927,103.2
2014-15,Los Angeles Lakers,3054,7020,2522,5474,532,1546,138,12.53931623931624,0.4394026421596783,0.430751837196156,102.3
2015-16,Los Angeles Lakers,2876,6947,2241,4940,635,2007,138,13.006765510292212,0.4131874460120933,0.4147956246401842,100.7
2016-17,Los Angeles Lakers,3216,7140,2494,5054,722,2086,130,12.063305322128851,0.4647174585324712,0.4362266257326262,105.3
2017-18,Los Angeles Lakers,3338,7248,2516,4864,822,2384,125,12.413217439293598,0.4575109649122807,0.4636111111111111,106.0
2018-19,Los Angeles Lakers,3491,7425,2644,4884,847,2541,129,12.18949494949495,0.4717391304347826,0.4686248331108144,107.4
2019-20,Los Angeles Lakers,3006,6269,2224,4027,782,2242,96,12.919923432764396,0.4790727623953638,0.4799241226683528,111.7
2020-21,Los Angeles Lakers,2925,6197,2129,3949,796,2248,125,12.981119896724222,0.4792746113989637,0.4647796719202315,109.8
2021-22,Los Angeles Lakers,3415,7279,2433,4453,982,2826,134,13.520675917021569,0.4729064039408867,0.4653793103448276,110.0
2022-23,Los Angeles Lakers,3516,7298,2631,4740,885,2558,134,12.748287201973143,0.4824753559693319,0.4810751508502468,113.9
2003-04,Memphis Grizzlies,2963,6657,2516,5343,447,1314,140,10.77046717740724,0.4482862297053517,0.4419093365355749,103.4
2004-05,Memphis Grizzlies,2802,6271,2271,4785,531,1486,120,11.085472811353853,0.4488114104595879,0.444801026957638,104.2
2005-06,Memphis Grizzlies,2746,6125,2156,4547,590,1578,127,11.66269387755102,0.4544857048964837,0.4422452952628163,104.5
2006-07,Memphis Grizzlies,2998,6448,2498,5086,500,1362,151,11.403535980148884,0.4751533742331288,0.4545169385194479,105.7
2007-08,Memphis Grizzlies,3060,6737,2440,4958,620,1779,145,12.09781801989016,0.4715227817745803,0.4372243457806527,103.9
2008-09,Memphis Grizzlies,2865,6310,2467,5205,398,1105,118,11.023296354992077,0.4585304320403658,0.4495062121694807,102.3
2009-10,Memphis Grizzlies,3223,6875,2879,5855,344,1020,127,10.13410909090909,0.462253193960511,0.4753716117749927,107.5
2010-11,Memphis Grizzlies,3200,6801,2891,5875,309,926,125,10.27348919276577,0.4922848664688427,0.4491401923637423,107.0
2011-12,Memphis Grizzlies,2425,5422,2148,4573,277,849,101,11.17982294356326,0.4592592592592592,0.4353416605437178,102.8
2012-13,Memphis Grizzlies,2964,6679,2582,5572,382,1107,101,11.039377152268305,0.4377015537965406,0.4501223990208078,103.6
2013-14,Memphis Grizzlies,3122,6723,2717,5576,405,1147,130,10.781050126431651,0.4716417910447761,0.4571597983990513,105.5
2014-15,Memphis Grizzlies,3097,6763,2674,5517,423,1246,132,10.971166642022771,0.4574436969874232,0.4584330143540669,104.8
2015-16,Memphis Grizzlies,3018,6858,2515,5338,503,1520,120,11.328083989501312,0.4429237041351194,0.4372079439252336,104.7
2016-17,Memphis Grizzlies,2982,6850,2217,4685,765,2165,119,13.003649635036496,0.4274831526516261,0.4431189991271457,107.0
2017-18,Memphis Grizzlies,3013,6788,2255,4636,758,2152,124,12.791543901001768,0.441812865497076,0.4459619952494061,103.6
2018-19,Memphis Grizzlies,3113,6924,2302,4556,811,2368,140,12.81369150779896,0.4502572898799314,0.4489200233508464,105.6
2019-20,Memphis Grizzlies,3106,6634,2308,4337,798,2297,124,12.489900512511303,0.4754244861483467,0.4607873054623131,108.7
2020-21,Memphis Grizzlies,3085,6608,2282,4350,803,2258,116,12.488801452784504,0.4508618082854551,0.4828839745531657,111.7
2021-22,Memphis Grizzlies,3571,7739,2626,5060,945,2679,130,12.45419304819744,0.4724735073662445,0.4503875968992248,114.3
2022-23,Memphis Grizzlies,3585,7551,2600,4744,985,2807,121,12.554628526023045,0.485062893081761,0.4642570281124498,114.7
2003-04,Miami Heat,2729,6417,2244,5060,485,1357,115,11.911173445535296,0.4364485981308411,0.4140941690053009,100.6
2004-05,Miami Heat,3097,6368,2622,5108,475,1260,122,11.143687185929648,0.4857768052516411,0.4869043862417166,108.9
2005-06,Miami Heat,3039,6355,2542,4914,497,1441,120,11.041070023603462,0.4968132568514977,0.4600559527510102,107.5
2006-07,Miami Heat,2919,6288,2391,4749,528,1539,111,12.06663486005089,0.4811320754716981,0.4480398257622899,103.4
2007-08,Miami Heat,2808,6336,2317,4963,491,1373,124,12.98705808080808,0.4501101668240478,0.4362139917695473,99.4
2008-09,Miami Heat,3034,6645,2452,5015,582,1630,124,12.881264108352145,0.4661222020568663,0.4471398622342019,106.5
2009-10,Miami Heat,2984,6518,2490,5092,494,1426,113,12.665388155876036,0.4559538274605103,0.4597024178549287,105.7
2010-11,Miami Heat,3030,6299,2484,4822,546,1477,116,13.190347674234005,0.4793519695044472,0.4827039035226912,110.6
2011-12,Miami Heat,2446,5212,2076,4182,370,1030,102,11.576745970836532,0.4768875192604006,0.4617737003058104,105.6
2012-13,Miami Heat,3148,6346,2431,4539,717,1807,124,12.720453829183738,0.5085173501577287,0.4836272040302267,111.4
2013-14,Miami Heat,3142,6272,2477,4443,665,1829,126,12.279815051020408,0.5128612257859638,0.48895292987512,110.0
2014-15,Miami Heat,2885,6330,2329,4671,556,1659,130,12.378041074249603,0.4636161423578011,0.4480050267043669,103.2
2015-16,Miami Heat,3148,6693,2652,5217,496,1476,145,11.555953981772,0.4832780958119915,0.4576170717249555,105.5
2016-17,Miami Heat,3200,7030,2394,4824,806,2206,126,12.573684210526316,0.470621954714818,0.4399887037560011,107.4
2017-18,Miami Heat,3184,6997,2281,4491,903,2506,128,13.201800771759324,0.4602903501280956,0.4497703788748565,106.2
2018-19,Miami Heat,3251,7218,2323,4560,928,2658,124,12.803823773898587,0.4490136148930258,0.4517822602928986,106.7
2019-20,Miami Heat,2880,6160,1901,3576,979,2584,110,14.202597402597403,0.4832126398946675,0.4522741832158872,111.9
2020-21,Miami Heat,2824,6029,1892,3423,932,2606,120,14.325261237352796,0.4709439032583137,0.4659239842726081,110.6
2021-22,Miami Heat,3246,6954,2132,4018,1114,2936,129,14.407966637906242,0.4742923165800115,0.4593356242840778,113.0
2022-23,Miami Heat,3215,6991,2235,4139,980,2852,139,14.132599055929052,0.4687769784172662,0.4510807736063709,112.3
2003-04,Milwaukee Bucks,2970,6650,2569,5505,401,1145,119,10.806165413533837,0.4581444545179812,0.4351990422029332,104.6
2004-05,Milwaukee Bucks,2964,6580,2639,5655,325,925,148,10.719300911854104,0.4573189522342065,0.4437781109445277,105.1
2005-06,Milwaukee Bucks,2976,6566,2469,5231,507,1335,123,11.066098081023457,0.4623100303951368,0.4441391941391941,104.9
2006-07,Milwaukee Bucks,3121,6714,2597,5242,524,1472,120,11.052129877867143,0.4782214156079855,0.4518779342723005,106.0
2007-08,Milwaukee Bucks,3026,6745,2574,5432,452,1313,135,11.22446256486286,0.4583582983822648,0.4390959788670384,103.9
2008-09,Milwaukee Bucks,3009,6754,2498,5347,511,1407,128,12.048711874444772,0.4548927416985013,0.4359892569382274,105.2
2009-10,Milwaukee Bucks,3048,6992,2405,5185,643,1807,116,12.580091533180775,0.4388857305287095,0.4329303396660909,104.0
2010-11,Milwaukee Bucks,2814,6543,2331,5130,483,1413,108,12.287788476234144,0.4342839429634222,0.4259873379559843,100.8
2011-12,Milwaukee Bucks,2496,5645,2066,4387,430,1258,121,11.857573073516386,0.4497708847373987,0.4344729344729344,104.5
2012-13,Milwaukee Bucks,3128,7196,2527,5527,601,1669,131,11.724291272929404,0.4394064303380049,0.4298566207478212,102.5
2013-14,Milwaukee Bucks,2952,6735,2404,5184,548,1551,137,11.621974758723088,0.4354694485842026,0.4411242603550296,101.9
2014-15,Milwaukee Bucks,3083,6722,2538,5222,545,1500,128,11.400922344540316,0.4629963898916967,0.4543849323131254,102.0
2015-16,Milwaukee Bucks,3142,6726,2705,5463,437,1263,139,10.066012488849244,0.4695985832349468,0.4646494907130018,103.4
2016-17,Milwaukee Bucks,3175,6701,2462,4769,713,1932,117,11.374421728100284,0.4794520547945205,0.4681423870774753,108.5
2017-18,Milwaukee Bucks,3257,6807,2539,4783,718,2024,143,12.39474070809461,0.4828818100625186,0.4741879350348028,109.0
2018-19,Milwaukee Bucks,3555,7471,2450,4337,1105,3134,148,13.412528443314148,0.483637339055794,0.4680737376436014,113.5
2019-20,Milwaukee Bucks,3160,6638,2153,3798,1007,2840,128,14.131063573365472,0.4839723444374607,0.46875,111.9
2020-21,Milwaukee Bucks,3221,6610,2183,3941,1038,2669,124,14.169591527987896,0.4910416034011539,0.483569490503467,116.5
2021-22,Milwaukee Bucks,3429,7331,2276,4180,1153,3151,136,14.589141999727186,0.4643828167482327,0.4711196277032576,114.3
2022-23,Milwaukee Bucks,3504,7411,2287,4105,1217,3306,115,14.809067602212927,0.4791386271870794,0.4664502164502164,114.3
2003-04,Minnesota Timberwolves,3033,6571,2707,5674,326,897,130,12.582407548318368,0.4698500153045608,0.4533898305084746,104.2
2004-05,Minnesota Timberwolves,3045,6629,2650,5484,395,1145,125,12.794991703122642,0.4621394230769231,0.4565283247500757,106.6
2005-06,Minnesota Timberwolves,2888,6340,2578,5398,310,942,133,12.084069400630916,0.4603867747972551,0.4505424377791959,101.5
2006-07,Minnesota Timberwolves,2997,6502,2613,5413,384,1089,133,12.410796677945248,0.4622154779969651,0.4596195821640162,102.4
2007-08,Minnesota Timberwolves,3076,6817,2635,5558,441,1259,126,11.238521343699574,0.4569067296340023,0.4456109652960047,102.7
2008-09,Minnesota Timberwolves,2986,6766,2443,5227,543,1539,143,11.579219627549511,0.4411335086181712,0.4415195931797786,104.9
2009-10,Minnesota Timberwolves,3106,6923,2703,5742,403,1181,160,11.095189946554962,0.4557703573520796,0.4417212881162724,100.6
2010-11,Minnesota Timberwolves,3090,7014,2501,5449,589,1565,145,12.240661534074707,0.4392045454545454,0.4419004006868918,103.2
2011-12,Minnesota Timberwolves,2355,5433,1882,4011,473,1422,99,12.172280508006626,0.4252577319587629,0.4416635995583364,103.1
2012-13,Minnesota Timberwolves,2943,6702,2493,5227,450,1475,136,11.80572963294539,0.4390024038461538,0.4392412566686425,101.8
2013-14,Minnesota Timberwolves,3188,7173,2589,5418,599,1755,133,11.626516102049353,0.4492067909824659,0.4396648044692737,107.7
2014-15,Minnesota Timberwolves,2985,6819,2580,5597,405,1222,135,11.599208095028596,0.436400937866354,0.4390959788670384,101.8
2015-16,Minnesota Timberwolves,3094,6666,2640,5321,454,1345,146,11.85958595859586,0.463481436396835,0.464792899408284,105.4
2016-17,Minnesota Timberwolves,3235,6921,2634,5199,601,1722,150,11.9724028319607,0.4737767360093759,0.4612314709236031,110.0
2017-18,Minnesota Timberwolves,3365,7063,2707,5218,658,1845,140,12.290952852895373,0.4810871392546932,0.4716657126502576,112.5
2018-19,Minnesota Timberwolves,3413,7483,2586,5126,827,2357,132,12.596151276226111,0.4620523784072688,0.450147019513499,110.6
2019-20,Minnesota Timberwolves,2586,5865,1733,3325,853,2540,111,13.490537084398976,0.4286675639300135,0.4535084687175942,107.6
2020-21,Minnesota Timberwolves,2932,6546,1988,3840,944,2706,134,13.232508402077604,0.4396524976729755,0.455913331327114,109.3
2021-22,Minnesota Timberwolves,3411,7458,2200,4072,1211,3386,126,14.015017430946637,0.4469983775013521,0.4675531914893617,113.8
2022-23,Minnesota Timberwolves,3515,7167,2518,4436,997,2731,145,12.717455002092926,0.484781405644715,0.4962003940332113,113.3
2003-04,New Jersey Nets,2813,6372,2436,5249,377,1123,124,11.530445699937223,0.4525685471162937,0.4304470146920913,99.0
2004-05,New Jersey Nets,2753,6419,2318,5216,435,1203,117,12.567689671288363,0.4325077399380805,0.425211665098777,99.9
2005-06,New Jersey Nets,2778,6317,2301,4870,477,1447,136,12.53142314389742,0.4455259026687598,0.4339080459770115,102.4
2006-07,New Jersey Nets,2913,6379,2304,4703,609,1676,119,12.488634582222918,0.4566167290886392,0.4566929133858268,104.2
2007-08,New Jersey Nets,2856,6450,2358,5020,498,1430,138,12.06263565891473,0.4402593393022538,0.4453441295546558,102.3
2008-09,New Jersey Nets,2924,6535,2273,4801,651,1734,145,12.449885233358836,0.4439681567666871,0.4509024166411747,106.8
2009-10,New Jersey Nets,2813,6554,2436,5369,377,1185,126,11.060115959719257,0.4234289200732153,0.434981684981685,99.3
2010-11,New Jersey Nets,2918,6638,2459,5301,459,1337,135,12.264236215727628,0.4431749849669272,0.4359903381642512,102.1
2011-12,New Jersey Nets,2262,5320,1755,3839,507,1481,110,13.298872180451127,0.4284649776453055,0.4218512898330804,101.8
2003-04,New Orleans Pelicans,2772,6605,2241,4939,531,1666,107,12.448448145344436,0.4290085679314565,0.4105483967635601,100.7
2004-05,New Orleans Pelicans,2718,6556,2303,5240,415,1316,133,12.247559487492373,0.4277035236938031,0.4013480392156863,98.2
2007-08,New Orleans Pelicans,3164,6796,2534,5175,630,1621,126,12.389199529134784,0.4725925925925926,0.4586378251973107,110.0
2008-09,New Orleans Pelicans,2910,6364,2355,4840,555,1524,147,12.40603394091766,0.4625959079283887,0.4521013597033375,107.6
2009-10,New Orleans Pelicans,3178,6842,2607,5270,571,1572,143,11.956153171587257,0.4645369284876905,0.4644314868804665,106.5
2010-11,New Orleans Pelicans,2944,6416,2500,5184,444,1232,116,12.272288029925187,0.4695407685098406,0.4482115085536547,105.4
2011-12,New Orleans Pelicans,2300,5103,2041,4326,259,777,97,11.27787575935724,0.4492979719188767,0.4521465143757385,99.9
2012-13,New Orleans Pelicans,2955,6589,2420,5115,535,1474,140,11.592502655941722,0.4491090305043793,0.4478340451494814,104.5
2013-14,New Orleans Pelicans,3101,6761,2615,5458,486,1303,134,10.98520928856678,0.4642962962962963,0.4530419373892498,106.2
2014-15,New Orleans Pelicans,3107,6793,2522,5212,585,1581,140,11.394376564110113,0.4668815943728018,0.4477965099083111,107.1
2015-16,New Orleans Pelicans,3152,7035,2451,5089,701,1946,133,12.46638237384506,0.4581211092246746,0.4378748928877463,104.8
2016-17,New Orleans Pelicans,3208,7125,2442,4934,766,2191,135,12.880140350877191,0.4552259495425561,0.4451392836839113,104.7
2017-18,New Orleans Pelicans,3500,7241,2663,4929,837,2312,141,12.525065598674216,0.4969342251950948,0.4700246372844238,108.5
2018-19,New Orleans Pelicans,3581,7563,2739,5114,842,2449,141,11.953325399973556,0.4716283979941937,0.4753577106518283,110.7
2019-20,New Orleans Pelicans,3065,6598,2083,3942,982,2656,118,13.341921794483175,0.4638863705046842,0.4651869869261174,110.5
2020-21,New Orleans Pelicans,3060,6412,2298,4222,762,2190,123,12.10386774797255,0.4809136420525657,0.4735696517412935,113.0
2021-22,New Orleans Pelicans,3294,7212,2421,4583,873,2629,154,13.145452024403772,0.4654226125137212,0.4478699551569506,111.2
2022-23,New Orleans Pelicans,3447,7180,2548,4712,899,2468,150,12.606406685236768,0.4832441565756125,0.4769909065858363,113.8
2003-04,New York Knicks,2881,6513,2475,5398,406,1115,119,11.851988331030247,0.4461631786472551,0.4384328358208955,99.7
2004-05,New York Knicks,2978,6599,2537,5359,441,1240,141,11.758448249734808,0.4611128189363664,0.4417214584578601,104.5
2005-06,New York Knicks,2822,6205,2502,5321,320,884,136,9.723609991941982,0.4575634199812089,0.4518592297476759,102.7
2006-07,New York Knicks,2903,6356,2429,4986,474,1370,139,10.52092511013216,0.4577332498434565,0.4557242251739405,104.3
2007-08,New York Knicks,2967,6757,2477,5303,490,1454,139,11.175225691875092,0.445176752546435,0.4331675928634103,103.5
2008-09,New York Knicks,3157,7091,2334,4807,823,2284,112,12.498237202087152,0.4491068897079671,0.441358024691358,107.0
2009-10,New York Knicks,3127,6876,2384,4731,743,2145,144,13.04915648632926,0.4604003481288076,0.4491105278506853,106.4
2010-11,New York Knicks,3140,6865,2375,4786,765,2079,130,13.052002913328478,0.4715041128084606,0.4435134354232881,109.9
2011-12,New York Knicks,2365,5335,1848,3797,517,1538,107,12.533458294283037,0.4516616314199396,0.4350576851507257,103.5
2012-13,New York Knicks,2996,6689,2105,4318,891,2371,114,14.154133652264912,0.4578457845784578,0.4380214541120381,109.8
2013-14,New York Knicks,3027,6739,2268,4701,759,2038,123,13.912004748479005,0.4545183417834775,0.4438865918487891,107.0
2014-15,New York Knicks,2882,6726,2322,5112,560,1614,139,13.267618198037466,0.4281914893617021,0.4287851585876721,98.9
2015-16,New York Knicks,3021,6882,2412,5124,609,1758,123,12.960331299040975,0.4383797759264579,0.4395765951190826,103.9
2016-17,New York Knicks,3243,7254,2540,5234,703,2020,141,12.745106148331956,0.4617754130495659,0.4327993483573174,107.1
2017-18,New York Knicks,3334,7193,2661,5279,673,1914,135,12.672042263311551,0.4698228128460686,0.4571348785255515,106.3
2018-19,New York Knicks,3134,7241,2311,4820,823,2421,135,12.98895180223726,0.4402445803224013,0.425473510842712,104.0
2019-20,New York Knicks,2638,5896,2007,4024,631,1872,127,12.432835820895525,0.4486523370863187,0.4462057335581788,105.9
2020-21,New York Knicks,2839,6225,1992,4062,847,2163,115,13.049477911646589,0.4625762929649855,0.4495501285347044,110.2
2021-22,New York Knicks,3088,7069,2006,4040,1082,3029,114,14.172725986702504,0.4351535836177474,0.4385026737967914,109.7
2022-23,New York Knicks,3444,7328,2407,4398,1037,2930,145,13.152292576419214,0.4790123456790123,0.4610371979364648,117.0
2008-09,Oklahoma City Thunder,2999,6715,2671,5767,328,948,144,10.684288905435592,0.4528014616321559,0.4406878461090061,101.4
2009-10,Oklahoma City Thunder,3063,6629,2645,5400,418,1229,118,11.109518781113293,0.4761758376882877,0.4484597156398104,107.0
2010-11,Oklahoma City Thunder,3066,6609,2579,5206,487,1403,122,11.965501588742624,0.4726215968185989,0.4553892215568862,109.9
2011-12,Oklahoma City Thunder,2462,5229,1990,3912,472,1317,83,12.101740294511378,0.4917020455422616,0.4503411675511751,108.4
2012-13,Oklahoma City Thunder,3125,6503,2528,4916,597,1587,122,12.105335998769798,0.4949370972691009,0.4660912453760789,111.0
2013-14,Oklahoma City Thunder,3194,6781,2530,4943,664,1838,115,12.484736764489014,0.4827893175074184,0.4593960715332747,109.4
2014-15,Oklahoma City Thunder,3183,7116,2552,5255,631,1861,127,11.937183811129849,0.4548494983277591,0.439625850340136,106.7
2015-16,Oklahoma City Thunder,3372,7080,2694,5137,678,1943,138,11.876553672316383,0.4775613886536833,0.4749787955894826,112.1
2016-17,Oklahoma City Thunder,3236,7168,2545,5053,691,2115,147,11.652064732142858,0.4689423614997202,0.4340567612687813,107.9
2017-18,Oklahoma City Thunder,3271,7221,2390,4730,881,2491,142,13.253704473064673,0.4635313996057448,0.4427792915531335,110.1
2018-19,Oklahoma City Thunder,3497,7706,2565,5029,932,2677,133,12.425772125616405,0.4522756827048114,0.4553224553224553,109.8
2019-20,Oklahoma City Thunder,2879,6156,2109,3985,770,2171,132,13.354775828460038,0.4842807240393775,0.4502826737612238,110.1
2020-21,Oklahoma City Thunder,2795,6338,1938,3809,857,2529,111,13.1857052698012,0.4484829329962073,0.4335223692501575,102.8
2021-22,Oklahoma City Thunder,3141,7310,2150,4244,991,3066,131,13.797127222982215,0.4382207578253707,0.4212104689203926,103.8
2022-23,Oklahoma City Thunder,3533,7590,2538,4793,995,2797,152,12.661528326745715,0.480946123521682,0.4499339498018494,114.2
2003-04,Orlando Magic,2904,6768,2475,5520,429,1248,132,12.388002364066194,0.4302941176470588,0.4278503562945368,101.4
2004-05,Orlando Magic,3034,6679,2714,5763,320,916,123,11.244647402305734,0.468583283935981,0.4396369137670197,103.4
2005-06,Orlando Magic,2911,6167,2612,5371,299,796,148,10.545484027890383,0.4784998383446492,0.4655172413793103,105.3
2006-07,Orlando Magic,2875,6090,2533,5128,342,962,129,10.428735632183908,0.4748081414748081,0.469447138700291,104.1
2007-08,Orlando Magic,3058,6446,2257,4372,801,2074,138,12.42413900093081,0.4792770333437208,0.4695705900525178,110.4
2008-09,Orlando Magic,2929,6416,2112,4269,817,2147,108,13.205112219451372,0.4581772784019975,0.4548567870485678,108.3
2009-10,Orlando Magic,3005,6394,2164,4153,841,2241,138,13.285267438223334,0.4833073322932917,0.4565694575101913,110.7
2010-11,Orlando Magic,2956,6409,2186,4308,770,2101,138,13.584958651895771,0.4659126610116242,0.4566026038437694,107.4
2011-12,Orlando Magic,2275,5162,1605,3377,670,1785,105,13.379891514916698,0.4502677888293802,0.4309262166405023,104.0
2012-13,Orlando Magic,3093,6904,2587,5367,506,1537,149,12.09052723059096,0.4526653073113894,0.4433880726015557,100.9
2013-14,Orlando Magic,3021,6782,2459,5188,562,1594,134,12.629017988793866,0.4628099173553719,0.4281084266352387,101.0
2014-15,Orlando Magic,3076,6792,2522,5194,554,1598,147,11.556242638398116,0.4544121958369979,0.4513457556935817,101.0
2015-16,Orlando Magic,3242,7117,2606,5302,636,1815,117,12.49711957285373,0.4605079542283003,0.4504810413129598,104.4
2016-17,Orlando Magic,3138,7130,2438,4994,700,2136,120,13.05960729312763,0.4349421394298617,0.4452188458321717,103.7
2017-18,Orlando Magic,3182,7042,2338,4637,844,2405,151,13.304600965634762,0.4525298465036952,0.4511918274687854,104.7
2018-19,Orlando Magic,3316,7307,2379,4674,937,2633,132,13.900095798549335,0.4652701212789416,0.4425115520521881,108.2
2019-20,Orlando Magic,2871,6468,2064,4114,807,2354,109,13.663110698824983,0.4411003236245954,0.4464179988158673,107.9
2020-21,Orlando Magic,2754,6423,1970,4135,784,2288,121,13.871399657480929,0.4346608587429993,0.4228731692115924,104.6
2021-22,Orlando Magic,3139,7240,2140,4218,999,3022,130,13.959806629834254,0.4354080221300138,0.4317241379310345,103.9
2022-23,Orlando Magic,3323,7074,2440,4523,883,2551,128,13.013712185467911,0.4833759590792839,0.4562587904360056,111.3
2003-04,Philadelphia 76ers,2682,6260,2343,5268,339,992,104,10.92811501597444,0.4362714013950539,0.4204764971023825,97.8
2004-05,Philadelphia 76ers,2946,6736,2441,5283,505,1453,100,11.64771377672209,0.4450712589073634,0.4296318289786223,101.8
2005-06,Philadelphia 76ers,3001,6546,2626,5515,375,1031,120,10.708677054689886,0.4639299728342891,0.4528301886792453,104.7
2006-07,Philadelphia 76ers,2932,6408,2648,5585,284,823,126,11.019194756554308,0.4541154210028382,0.4609206054989188,102.4
2007-08,Philadelphia 76ers,3056,6648,2754,5696,302,952,130,10.58739470517449,0.4644262791401756,0.4550074738415545,105.1
2008-09,Philadelphia 76ers,2997,6531,2656,5460,341,1071,117,10.437911499004748,0.4596996628869139,0.458078335373317,106.3
2009-10,Philadelphia 76ers,3087,6706,2613,5325,474,1381,108,11.735908141962422,0.4623009912886753,0.4583950251702695,104.8
2010-11,Philadelphia 76ers,3125,6775,2682,5528,443,1247,124,11.907749077490775,0.4672009498367468,0.4553728714034057,105.3
2011-12,Philadelphia 76ers,2471,5516,2122,4553,349,963,98,12.051667875271937,0.4452501812907904,0.4506889050036258,102.7
2012-13,Philadelphia 76ers,3059,6894,2541,5457,518,1437,127,12.252393385552654,0.4526832083092902,0.4346557759626604,101.0
2013-14,Philadelphia 76ers,3108,7148,2531,5303,577,1845,136,10.912842753217683,0.4416831403558316,0.4280565566953146,99.0
2014-15,Philadelphia 76ers,2765,6776,2073,4617,692,2159,133,12.222697756788666,0.4187481633852483,0.3972724577527424,94.9
2015-16,Philadelphia 76ers,2970,6885,2206,4632,764,2253,136,12.4079883805374,0.4340882694541231,0.4286544609125254,98.4
2016-17,Philadelphia 76ers,3082,6977,2257,4549,825,2428,138,12.754765658592518,0.4421906693711968,0.4412932501418037,102.7
2017-18,Philadelphia 76ers,3349,7098,2448,4653,901,2445,129,13.33868695407157,0.4756801319043693,0.4677652500722752,108.5
2018-19,Philadelphia 76ers,3407,7233,2518,4759,889,2474,133,13.00705101617586,0.4842310912643036,0.4580821917808219,111.6
2019-20,Philadelphia 76ers,3000,6417,2152,4110,848,2307,119,13.3037244818451,0.4839764551994768,0.452515629651682,110.7
2020-21,Philadelphia 76ers,2981,6257,2170,4088,811,2169,114,13.21463960364392,0.4864694776589049,0.4660604092237739,112.5
2021-22,Philadelphia 76ers,3230,6932,2280,4324,950,2608,123,13.528274668205423,0.466189111747851,0.4657176060429983,113.0
2022-23,Philadelphia 76ers,3347,6870,2312,4195,1035,2675,125,13.477292576419217,0.4791848617176128,0.4951965065502183,117.0
2003-04,Phoenix Suns,2958,6671,2543,5469,415,1202,126,11.073452256033578,0.4511232544019429,0.4358898430559668,100.3
2004-05,Phoenix Suns,3351,7018,2555,4992,796,2026,137,12.611570247933884,0.4785189372526851,0.4764367816091954,112.7
2005-06,Phoenix Suns,3430,7167,2593,5070,837,2097,125,13.985070461838983,0.4881154499151103,0.469309110927608,110.2
2006-07,Phoenix Suns,3388,6855,2603,4890,785,1965,146,12.766010211524437,0.493395949515703,0.4950696055684455,112.9
2007-08,Phoenix Suns,3392,6782,2698,5018,694,1764,139,12.357564140371572,0.5001458151064451,0.5001491201908739,112.0
2008-09,Phoenix Suns,3372,6694,2820,5250,552,1444,135,10.610546758291006,0.5195114685731308,0.4878633503146539,112.4
2009-10,Phoenix Suns,3339,6788,2609,5018,730,1770,122,12.131850324101356,0.4979508196721312,0.4857651245551601,113.9
2010-11,Phoenix Suns,3219,6844,2518,4987,701,1857,145,12.892314436002335,0.4692262602579132,0.4714452214452214,108.6
2011-12,Phoenix Suns,2495,5445,2051,4150,444,1295,103,12.78457300275482,0.46976401179941,0.446761800219539,105.2
2012-13,Phoenix Suns,3061,6917,2581,5462,480,1455,134,12.245337574092815,0.4364211737629459,0.4487067712874164,100.2
2013-14,Phoenix Suns,3171,6843,2407,4790,764,2053,126,12.600175361683473,0.4768735362997658,0.4499562299387219,108.2
2014-15,Phoenix Suns,3178,7038,2480,4990,698,2048,149,12.607132708155726,0.4588269286333429,0.4445065697511881,104.2
2015-16,Phoenix Suns,3050,7013,2313,4900,737,2113,154,12.562811920718666,0.4400452488687782,0.4296807592752373,101.5
2016-17,Phoenix Suns,3270,7258,2655,5406,615,1852,155,12.071369523284652,0.4565456545654565,0.4445057979017117,106.1
2017-18,Phoenix Suns,3153,7141,2390,4855,763,2286,142,12.476123792185968,0.4385964912280701,0.4445070422535211,102.8
2018-19,Phoenix Suns,3289,7164,2499,4764,790,2400,152,12.605946398659968,0.4655220940050661,0.452783162558848,105.3
2019-20,Phoenix Suns,3006,6429,2175,4109,831,2320,112,12.93031575672733,0.4726470588235294,0.4618686034995047,111.3
2020-21,Phoenix Suns,3118,6357,2178,3867,940,2490,97,14.45445965077867,0.4942097026604068,0.4867172675521821,116.3
2021-22,Phoenix Suns,3581,7389,2630,4773,951,2616,156,13.727703342806874,0.4900788257678717,0.4792452830188679,114.2
2022-23,Phoenix Suns,3453,7388,2452,4714,1001,2674,145,13.836220898754735,0.4683060109289617,0.466469957081545,114.5
2003-04,Portland Trail Blazers,2898,6467,2517,5365,381,1102,117,11.14055976496057,0.4552147239263803,0.4409105082631743,102.1
2004-05,Portland Trail Blazers,2896,6422,2476,5261,420,1161,137,10.81002802865151,0.4617572692793931,0.4404542664211172,101.9
2005-06,Portland Trail Blazers,2791,6267,2427,5225,364,1042,134,11.579064943354076,0.4555837563451776,0.434991974317817,99.7
2006-07,Portland Trail Blazers,2874,6392,2448,5160,426,1232,127,11.80287859824781,0.4560149207336027,0.4431496062992126,103.8
2007-08,Portland Trail Blazers,2935,6546,2397,5120,538,1426,129,13.708829819737243,0.4598159509202454,0.4370054777845404,105.9
2008-09,Portland Trail Blazers,3018,6494,2422,4939,596,1555,132,12.396827841084075,0.475295544104274,0.4538341158059468,112.1
2009-10,Portland Trail Blazers,2974,6453,2483,5065,491,1388,124,12.52223771889044,0.460080770425598,0.4616573902288188,109.6
2010-11,Portland Trail Blazers,2950,6598,2433,5096,517,1502,111,12.13064565019703,0.4528985507246377,0.4412659768715763,107.3
2011-12,Portland Trail Blazers,2402,5417,1924,4035,478,1382,105,12.513752999815395,0.4563142437591777,0.4303750464166357,104.4
2012-13,Portland Trail Blazers,3008,6713,2336,4811,672,1902,148,13.118724862207657,0.453083109919571,0.4430870083432658,104.5
2013-14,Portland Trail Blazers,3207,7134,2437,5063,770,2071,117,13.400616764788335,0.458391706360325,0.4406732117812061,110.4
2014-15,Portland Trail Blazers,3172,7046,2368,4818,804,2228,140,13.737865455577632,0.4505805720758992,0.4497866287339971,107.1
2015-16,Portland Trail Blazers,3167,7036,2303,4704,864,2332,131,13.267197271176803,0.4618202310510003,0.4381990249498136,107.6
2016-17,Portland Trail Blazers,3241,7057,2391,4787,850,2270,137,12.959756270369846,0.4686357243319268,0.4497430039977156,109.4
2017-18,Portland Trail Blazers,3222,7132,2377,4824,845,2308,145,12.993970835670218,0.4585338239456552,0.4451236454570714,108.4
2018-19,Portland Trail Blazers,3470,7427,2566,4907,904,2520,141,12.70311027332705,0.4789374832304803,0.4554054054054054,113.7
2019-20,Portland Trail Blazers,3122,6749,2170,4224,952,2525,146,13.80500814935546,0.4689612784265519,0.4566523605150214,113.2
2020-21,Portland Trail Blazers,2973,6558,1841,3619,1132,2939,133,15.085696858798414,0.4462381967712458,0.4604580152671755,117.1
2021-22,Portland Trail Blazers,3161,7144,2118,4127,1043,3017,134,14.071248600223964,0.4452130603209739,0.4396600566572238,107.3
2022-23,Portland Trail Blazers,3317,7001,2261,4108,1056,2893,135,13.739180117126123,0.4771949828962372,0.4703693100486688,114.0
2003-04,Sacramento Kings,3103,6711,2502,5213,601,1498,115,12.625093130680971,0.4730700179533214,0.4517661027010982,108.6
2004-05,Sacramento Kings,3203,6978,2681,5582,522,1396,122,13.017913442247062,0.4742857142857143,0.4436457734330075,108.8
2005-06,Sacramento Kings,2954,6500,2460,5092,494,1408,122,12.897230769230768,0.4650371287128713,0.4440024479804161,105.3
2006-07,Sacramento Kings,2941,6532,2411,5019,530,1513,139,12.333282302510716,0.460546515198035,0.44,105.1
2007-08,Sacramento Kings,3043,6558,2533,5191,510,1367,133,11.675510826471486,0.4628727936701156,0.4651589242053789,106.2
2008-09,Sacramento Kings,2990,6684,2404,5091,586,1593,127,12.347845601436266,0.4460537984037836,0.4486519236594971,104.4
2009-10,Sacramento Kings,3143,6894,2662,5512,481,1382,156,11.211198143313023,0.4626993166287016,0.4488468361916026,104.4
2010-11,Sacramento Kings,3133,6977,2706,5702,427,1275,147,11.503224881754337,0.4435507038207412,0.4545194508009153,102.9
2011-12,Sacramento Kings,2490,5712,2079,4411,411,1301,117,11.273809523809524,0.4480084596404652,0.424,102.9
2012-13,Sacramento Kings,3086,6904,2476,5223,610,1681,139,11.72305909617613,0.4650482597250658,0.4292682926829268,105.3
2013-14,Sacramento Kings,3026,6766,2535,5291,491,1475,127,11.781554832988473,0.4545995832092885,0.4399765189316114,105.1
2014-15,Sacramento Kings,3010,6617,2549,5267,461,1350,131,11.011938945141305,0.4587458745874587,0.4509744214372716,104.5
2015-16,Sacramento Kings,3283,7082,2623,5244,660,1838,150,11.648828014685115,0.4671033893477642,0.460095211425371,105.3
2016-17,Sacramento Kings,3100,6727,2368,4774,732,1953,139,12.616173628660622,0.4702881152460984,0.4515463917525773,106.6
2017-18,Sacramento Kings,3179,7063,2441,5096,738,1967,148,12.864363584878946,0.4614509246088193,0.4388387824126268,103.1
2018-19,Sacramento Kings,3541,7637,2614,5182,927,2455,139,12.567107502946184,0.4627798021863613,0.4645586297760211,109.6
2019-20,Sacramento Kings,2943,6364,2029,3853,914,2511,137,13.66970458830924,0.4659533073929961,0.4591463414634146,109.5
2020-21,Sacramento Kings,3067,6382,2193,3982,874,2400,139,13.17141961767471,0.4949077021005729,0.4666666666666667,112.7
2021-22,Sacramento Kings,3321,7223,2384,4501,937,2722,142,13.368406479302228,0.4646293152235427,0.4551368934670642,109.6
2022-23,Sacramento Kings,3573,7232,2445,4172,1128,3060,149,13.781111725663717,0.5073631564323423,0.4808698045692265,118.6
2003-04,San Antonio Spurs,2842,6434,2434,5294,408,1140,116,11.164594342555176,0.4565896314803248,0.4269801980198019,101.0
2004-05,San Antonio Spurs,2923,6450,2416,5055,507,1395,123,11.187131782945736,0.4725239616613418,0.4349397590361445,106.1
2005-06,San Antonio Spurs,2993,6342,2469,4980,524,1362,116,11.421948912015138,0.4768605378361475,0.4669211195928753,106.2
2006-07,San Antonio Spurs,2999,6328,2404,4767,595,1561,133,12.225979772439947,0.4757097791798107,0.4721342621912603,108.6
2007-08,San Antonio Spurs,2938,6424,2344,4814,594,1610,125,12.81242216687422,0.4680719156850589,0.4465290806754221,106.0
2008-09,San Antonio Spurs,3041,6532,2417,4914,624,1618,130,12.999387630128597,0.4814930015552099,0.4501055170334639,107.6
2009-10,San Antonio Spurs,3149,6657,2596,5112,553,1545,111,11.759050623403937,0.4917392610393511,0.4543269230769231,109.3
2010-11,San Antonio Spurs,3148,6626,2463,4901,685,1725,123,12.166012677331723,0.4883863080684597,0.4621347644603458,110.5
2011-12,San Antonio Spurs,2611,5463,2059,4058,552,1405,106,11.946915614131427,0.4902912621359223,0.4660682226211849,110.0
2012-13,San Antonio Spurs,3210,6674,2547,4911,663,1763,131,11.982768954150435,0.4974358974358974,0.464721643346234,107.0
2013-14,San Antonio Spurs,3326,6843,2628,5087,698,1756,156,12.08037410492474,0.4977830328111144,0.4745664739884393,109.5
2014-15,San Antonio Spurs,3208,6852,2531,5007,677,1845,118,12.052247518972562,0.4887196015235863,0.4478045943588252,107.6
2015-16,San Antonio Spurs,3288,6792,2719,5279,569,1513,128,12.139134275618376,0.487840609434515,0.4803196211897011,109.3
2016-17,San Antonio Spurs,3222,6862,2469,4937,753,1925,117,12.995919556980471,0.4730046948356807,0.4661262304574406,110.3
2017-18,San Antonio Spurs,3202,6999,2506,5022,696,1977,129,12.713101871695956,0.4735184655024334,0.4415288077581289,107.1
2018-19,San Antonio Spurs,3468,7248,2656,5177,812,2071,121,13.39059050772627,0.4870292887029289,0.4701064701064701,112.2
2019-20,San Antonio Spurs,2995,6350,2235,4329,760,2021,131,13.604094488188975,0.4751796211626388,0.4683698296836983,111.7
2020-21,San Antonio Spurs,3014,6518,2298,4472,716,2046,116,12.87066584841976,0.4627463054187192,0.4620795107033639,110.5
2021-22,San Antonio Spurs,3546,7601,2621,4975,925,2626,142,12.881989211945797,0.4725127379994636,0.4607438016528926,111.9
2022-23,San Antonio Spurs,3533,7593,2622,4953,911,2640,124,12.580534703015935,0.4778012684989429,0.4528747702809136,109.7
2003-04,Seattle SuperSonics,2939,6590,2216,4654,723,1936,130,13.13960546282246,0.4473842453397474,0.4445465686274509,105.6
2004-05,Seattle SuperSonics,2882,6498,2216,4674,666,1824,110,12.487842413050169,0.4503513596089215,0.4365891472868217,110.3
2005-06,Seattle SuperSonics,3077,6711,2472,5080,605,1631,121,12.14558188049471,0.4660107334525939,0.4509979148048853,109.4
2006-07,Seattle SuperSonics,3047,6628,2522,5177,525,1451,137,11.454435727217865,0.4568312632535595,0.4625788999098287,105.9
2007-08,Seattle SuperSonics,3125,7032,2812,6093,313,939,150,11.272468714448236,0.4496146160433913,0.4392179087560215,99.6
2003-04,Toronto Raptors,2654,6348,2193,5054,461,1294,136,12.6734404536862,0.4272868217054263,0.4085814921549792,95.3
2004-05,Toronto Raptors,2952,6656,2304,4975,648,1681,136,12.508713942307692,0.4499243570347958,0.4371829304685168,105.4
2005-06,Toronto Raptors,3013,6639,2405,5019,608,1620,148,12.488175930109955,0.4548130703561966,0.4528069093152375,107.9
2006-07,Toronto Raptors,3032,6547,2501,5083,531,1464,124,12.783564991599206,0.4782741738066095,0.448002439768222,105.7
2007-08,Toronto Raptors,3148,6726,2576,5267,572,1459,139,13.188670829616417,0.4748073503260225,0.461217183770883,108.9
2008-09,Toronto Raptors,3054,6673,2575,5384,479,1289,126,12.71572006593736,0.4706058788242351,0.444743935309973,105.5
2009-10,Toronto Raptors,3199,6631,2681,5234,518,1397,133,12.22108279294224,0.4808612440191387,0.4840279890477639,110.2
2010-11,Toronto Raptors,3144,6755,2799,5664,345,1091,149,11.298889711324945,0.4817935600361119,0.4495920745920746,105.2
2011-12,Toronto Raptors,2268,5154,1903,4079,365,1075,122,12.624369421808304,0.4474290099769762,0.4324960753532182,99.6
2012-13,Toronto Raptors,2978,6682,2408,5020,570,1662,117,13.033672553127806,0.444311377245509,0.4470377019748653,105.0
2013-14,Toronto Raptors,2992,6716,2279,4801,713,1915,108,13.071768910065517,0.4463226571767497,0.4446770334928229,107.9
2014-15,Toronto Raptors,3108,6828,2382,4769,726,2059,133,12.74721734036321,0.4600840336134453,0.4505148741418764,110.2
2015-16,Toronto Raptors,3006,6658,2298,4754,708,1904,130,12.312406127966357,0.4592481203007519,0.4437443744374437,109.3
2016-17,Toronto Raptors,3211,6914,2486,4922,725,1992,152,12.721290135956032,0.4752161383285302,0.4535423925667828,111.4
2017-18,Toronto Raptors,3383,7169,2415,4464,968,2705,133,13.189566187752824,0.4701042238069117,0.4737439682089128,113.0
2018-19,Toronto Raptors,3460,7305,2445,4534,1015,2771,138,13.264202600958248,0.4783437755380005,0.468904788112273,112.6
2019-20,Toronto Raptors,2897,6331,1902,3668,995,2663,114,13.458695308797978,0.4650360614612731,0.4500318268618714,110.8
2020-21,Toronto Raptors,2859,6383,1818,3552,1041,2831,127,14.37004543318189,0.4435785536159601,0.4522834645669291,111.6
2021-22,Toronto Raptors,3332,7489,2353,4681,979,2808,138,13.792762718654028,0.4526737967914438,0.4371832488663643,112.1
2022-23,Toronto Raptors,3434,7489,2554,4863,880,2626,138,13.08385632260649,0.4632707774798927,0.4538441074753924,114.6
2003-04,Utah Jazz,2690,6172,2438,5386,252,786,117,11.206416072585872,0.4421258558852298,0.4296296296296296,100.0
2004-05,Utah Jazz,2828,6301,2578,5539,250,762,132,11.2859863513728,0.4546619673181672,0.4430817610062893,102.9
2005-06,Utah Jazz,2744,6207,2433,5282,311,925,107,11.340583212502017,0.4419584954604409,0.4422030099263528,102.4
2006-07,Utah Jazz,3069,6471,2715,5415,354,1056,140,11.025652912996446,0.4914728682170542,0.4571780653111522,108.6
2007-08,Utah Jazz,3279,6592,2872,5497,407,1095,139,10.88501213592233,0.5132905591200734,0.481771617957216,112.1
2008-09,Utah Jazz,3143,6623,2751,5501,392,1122,132,10.863505964064624,0.4858361254949741,0.4634730538922155,108.5
2009-10,Utah Jazz,3227,6575,2788,5368,439,1207,140,10.57277566539924,0.5113636363636364,0.4706236818318771,109.7
2010-11,Utah Jazz,3064,6590,2629,5334,435,1256,132,11.591502276176024,0.4709074464877901,0.4589062022609227,107.0
2011-12,Utah Jazz,2523,5531,2250,4686,273,845,108,10.696076658832038,0.4637258476121035,0.4487087517934003,105.5
2012-13,Utah Jazz,3046,6710,2539,5325,507,1385,119,11.978241430700448,0.4703389830508475,0.4380504991192014,105.4
2013-14,Utah Jazz,2951,6650,2408,5075,543,1575,159,12.236541353383458,0.4550698239222829,0.432657926102503,102.4
2014-15,Utah Jazz,2900,6492,2290,4711,610,1781,109,12.18222427603204,0.4497869750456482,0.4435433562071116,104.2
2015-16,Utah Jazz,2957,6593,2263,4637,694,1956,136,12.280752313059306,0.4541511771995043,0.4430906389301634,105.0
2016-17,Utah Jazz,3033,6514,2242,4387,791,2127,133,12.632944427387166,0.4684769038701623,0.4628398791540785,109.0
2017-18,Utah Jazz,3139,6797,2252,4372,887,2425,124,13.243342651169634,0.4647720544701006,0.4589061128985083,107.4
2018-19,Utah Jazz,3314,7082,2321,4293,993,2789,131,12.980090369951991,0.4664788732394366,0.4694224235560589,110.3
2019-20,Utah Jazz,2886,6130,1923,3593,963,2537,120,13.636378466557913,0.473420260782347,0.4683020070086015,111.8
2020-21,Utah Jazz,2971,6344,1766,3246,1205,3098,114,15.009142496847415,0.4716379859783301,0.4650655021834061,116.5
2021-22,Utah Jazz,3327,7067,2135,3759,1192,3308,135,14.585255412480544,0.4795947086968758,0.4618668184405236,116.2
2022-23,Utah Jazz,3485,7365,2391,4266,1094,3099,141,13.717990495587236,0.4702970297029702,0.4759989273263609,115.3
2008-09,Washington Wizards,2994,6655,2599,5457,395,1198,132,11.453493613824191,0.4514679448771719,0.448296653602653,104.0
2009-10,Washington Wizards,3008,6700,2576,5475,432,1225,134,12.151641791044776,0.4567864567864568,0.441044104410441,103.1
2010-11,Washington Wizards,3048,6888,2656,5706,392,1182,139,11.704268292682928,0.4459889950767448,0.4390101892285298,101.3
2011-12,Washington Wizards,2412,5472,2070,4400,342,1072,111,11.683479532163744,0.4517416545718432,0.4296759941089837,100.0
2012-13,Washington Wizards,2910,6692,2365,5198,545,1494,123,12.598625224148236,0.4518341783477483,0.4177897574123989,99.3
2013-14,Washington Wizards,3177,6918,2530,5216,647,1702,119,12.728100607111882,0.4638360175695461,0.454753068798173,104.9
2014-15,Washington Wizards,3139,6790,2642,5409,497,1381,128,12.111045655375552,0.4720351390922401,0.4524444444444444,103.0
2015-16,Washington Wizards,3237,7027,2529,5050,708,1977,122,12.9026611640814,0.4658119658119658,0.4555018481660506,104.5
2016-17,Washington Wizards,3385,7129,2632,5107,753,2022,134,12.630944031420956,0.4824063564131668,0.4674063800277392,110.4
2017-18,Washington Wizards,3275,7018,2461,4845,814,2173,126,13.448845825021374,0.479136690647482,0.4544171605983629,108.1
2018-19,Washington Wizards,3456,7387,2526,4656,930,2731,138,13.281034249356978,0.4801845819761129,0.4555765595463138,110.2
2019-20,Washington Wizards,2990,6544,2126,4199,864,2345,118,13.685971882640589,0.4559902200488998,0.4578239608801956,110.2
2020-21,Washington Wizards,3108,6547,2375,4459,733,2088,117,13.074385214602108,0.4828735980600181,0.4664408866995074,110.7
2021-22,Washington Wizards,3327,7056,2467,4544,860,2512,152,13.373299319727892,0.4782242202865973,0.4646840148698885,110.2
2022-23,Washington Wizards,3456,7127,2531,4526,925,2601,141,13.525466535709274,0.4846796657381615,0.4851569126378287,113.7
