SEASON_2,PLAYER_ID,PLAYER_NAME,position,total_shots_made,total_shots_attempted,total_2pt_made,total_2pt_attempted,total_3pt_made,total_3pt_attempted,preferred_shot_zone,clutch_shots_made,preferred_action_type,average_shot_distance
2022-23,1630639,A.J. Lawson,SG,22,44,12,19,10,25,Center,4,Jump Shot,14.227272727272727
2022-23,1631260,AJ Green,,53,125,9,20,44,105,Right Side Center,3,Jump Shot,23.224
2022-23,1631100,AJ Griffin,SF,248,533,147,274,101,259,Center,15,Jump Shot,16.348968105065666
2016-17,1627773,AJ Hammons,C,17,42,12,32,5,10,Center,4,Jump Shot,14.785714285714286
2009-10,201985,AJ Price,PG,145,354,85,180,60,174,Center,18,Jump Shot,16.65536723163842
2010-11,201985,AJ Price,PG,114,320,73,171,41,149,Center,5,Jump Shot,18.41875
2011-12,201985,AJ Price,PG,59,174,33,86,26,88,Center,8,Jump Shot,18.862068965517242
2012-13,201985,AJ Price,PG,161,413,91,213,70,200,Center,10,Jump Shot,17.85230024213075
2013-14,201985,AJ Price,SG,19,46,13,24,6,22,Left Side Center,9,Jump Shot,19.52173913043478
2014-15,201985,AJ Price,PG,51,137,36,80,15,57,Center,3,Jump Shot,17.824817518248175
2007-08,201166,Aaron Brooks,PG,93,225,57,116,36,109,Center,11,Jump Shot,15.666666666666666
2008-09,201166,Aaron Brooks,PG,316,783,203,474,113,309,Center,18,Jump Shot,14.401021711366539
2009-10,201166,Aaron Brooks,PG,574,1330,366,806,208,524,Center,30,Jump Shot,14.830075187969925
2010-11,201166,Aaron Brooks,PG,220,587,150,351,70,236,Center,11,Jump Shot,15.945485519591141
2012-13,201166,Aaron Brooks,PG,143,316,93,182,50,134,Center,9,Jump Shot,15.344936708860759
2013-14,201166,Aaron Brooks,PG,233,581,137,333,96,248,Center,8,Jump Shot,14.72289156626506
2014-15,201166,Aaron Brooks,PG,344,817,223,504,121,313,Center,15,Jump Shot,13.586291309669523
2015-16,201166,Aaron Brooks,PG,188,469,122,284,66,185,Center,7,Jump Shot,14.371002132196162
2016-17,201166,Aaron Brooks,PG,121,299,73,172,48,127,Center,3,Jump Shot,16.076923076923077
2017-18,201166,Aaron Brooks,PG,28,69,17,38,11,31,Center,8,Jump Shot,17.318840579710145
2014-15,203932,Aaron Gordon,PF,93,208,80,160,13,48,Center,3,Jump Shot,9.120192307692308
2015-16,203932,Aaron Gordon,PF,274,578,232,437,42,141,Center,14,Jump Shot,10.242214532871973
2016-17,203932,Aaron Gordon,SF,393,865,316,598,77,267,Center,9,Jump Shot,12.252023121387284
2017-18,203932,Aaron Gordon,PF,375,865,260,523,115,342,Center,14,Jump Shot,14.095953757225434
2018-19,203932,Aaron Gordon,PF,470,1046,349,699,121,347,Center,18,Jump Shot,12.502868068833653
2019-20,203932,Aaron Gordon,PF,335,767,262,530,73,237,Center,16,Jump Shot,12.434159061277706
2020-21,203932,Aaron Gordon,PF,231,499,172,323,59,176,Center,5,Jump Shot,13.048096192384769
2021-22,203932,Aaron Gordon,PF,434,834,347,574,87,260,Center,15,Jump Shot,10.985611510791367
2022-23,203932,Aaron Gordon,PF,429,761,369,588,60,173,Center,9,Jump Shot,8.441524310118265
2007-08,201189,Aaron Gray,C,103,204,103,203,0,1,Center,7,Layup Shot,3.8137254901960786
2008-09,201189,Aaron Gray,C,81,167,81,166,0,1,Center,4,Layup Shot,3.125748502994012
2009-10,201189,Aaron Gray,C,42,82,42,82,0,0,Center,9,Layup Shot,3.2804878048780486
2010-11,201189,Aaron Gray,C,56,99,56,99,0,0,Center,5,Layup Shot,2.8585858585858586
2011-12,201189,Aaron Gray,C,83,161,83,161,0,0,Center,0,Layup Shot,3.6770186335403725
2012-13,201189,Aaron Gray,C,48,90,48,90,0,0,Center,1,Layup Shot,3.4555555555555557
2013-14,201189,Aaron Gray,C,27,61,27,60,0,1,Center,1,Jump Shot,5.180327868852459
2015-16,1626151,Aaron Harrison,SG,5,19,2,9,3,10,Left Side Center,1,Jump Shot,17.210526315789473
2016-17,1626151,Aaron Harrison,SG,0,4,0,2,0,2,Left Side Center,0,Jump Shot,21.75
2017-18,1626151,Aaron Harrison,SG,19,69,10,26,9,43,Left Side Center,1,Jump Shot,18.92753623188406
2021-22,1630565,Aaron Henry,SF,1,5,1,4,0,1,Center,1,Driving Floating Jump Shot,11.4
2018-19,1628988,Aaron Holiday,PG,105,262,62,135,43,127,Center,12,Jump Shot,17.263358778625953
2019-20,1628988,Aaron Holiday,PG,233,563,146,342,87,221,Center,15,Jump Shot,14.577264653641208
2020-21,1628988,Aaron Holiday,PG,170,436,103,254,67,182,Center,6,Jump Shot,14.04816513761468
2021-22,1628988,Aaron Holiday,PG,151,338,112,235,39,103,Center,9,Jump Shot,12.594674556213018
2022-23,1628988,Aaron Holiday,PG,92,220,56,132,36,88,Center,8,Jump Shot,14.236363636363636
2017-18,1628935,Aaron Jackson,PG,3,9,2,5,1,4,Center,0,Jump Shot,13.0
2003-04,243,Aaron McKie,SF,265,577,190,405,75,172,Center,13,Jump Shot,13.772963604852686
2004-05,243,Aaron McKie,SG,61,142,41,80,20,62,Right Side,0,Jump Shot,16.401408450704224
2005-06,243,Aaron McKie,PG,3,12,3,10,0,2,Left Side,0,Jump Shot,18.0
2006-07,243,Aaron McKie,SF,11,17,11,17,0,0,Left Side,1,Jump Shot,15.0
2005-06,101223,Aaron Miles,PG,6,18,6,18,0,0,Center,1,Jump Shot,9.833333333333334
2020-21,1630174,Aaron Nesmith,SF,78,178,38,70,40,108,Center,10,Jump Shot,16.629213483146067
2021-22,1630174,Aaron Nesmith,SF,72,182,41,67,31,115,Center,9,Jump Shot,17.873626373626372
2022-23,1630174,Aaron Nesmith,SF,252,590,137,276,115,314,Center,7,Jump Shot,14.998305084745763
2021-22,1630598,Aaron Wiggins,SG,156,337,114,199,42,138,Center,2,Jump Shot,12.17507418397626
2022-23,1630598,Aaron Wiggins,SG,186,363,138,241,48,122,Center,6,Jump Shot,10.129476584022038
2003-04,1425,Aaron Williams,C,172,342,171,339,1,3,Center,9,Jump Shot,5.991228070175438
2004-05,1425,Aaron Williams,C,29,63,29,63,0,0,Center,0,Jump Shot,6.507936507936508
2005-06,1425,Aaron Williams,C,91,176,91,176,0,0,Center,2,Jump Shot,5.3352272727272725
2006-07,1425,Aaron Williams,PF,29,53,29,52,0,1,Center,2,Jump Shot,7.09433962264151
2007-08,1425,Aaron Williams,C,27,55,27,55,0,0,Center,0,Jump Shot,5.327272727272727
2017-18,1627846,Abdel Nader,SF,50,149,27,84,23,65,Center,4,Jump Shot,13.53020134228188
2018-19,1627846,Abdel Nader,SF,91,215,59,115,32,100,Center,13,Jump Shot,13.125581395348837
2019-20,1627846,Abdel Nader,SF,123,263,75,135,48,128,Center,8,Jump Shot,14.307984790874524
2020-21,1627846,Abdel Nader,SF,57,116,39,73,18,43,Center,6,Jump Shot,11.267241379310345
2021-22,1627846,Abdel Nader,SF,12,35,8,21,4,14,Center,0,Jump Shot,12.457142857142857
2007-08,201151,Acie Law,PG,95,237,88,203,7,34,Center,6,Jump Shot,9.953586497890296
2008-09,201151,Acie Law,PG,51,138,43,110,8,28,Center,6,Jump Shot,11.608695652173912
2009-10,201151,Acie Law,PG,35,75,30,59,5,16,Center,4,Jump Shot,7.56
2010-11,201151,Acie Law,PG,81,186,75,150,6,36,Center,5,Jump Shot,9.96236559139785
2019-20,1629690,Adam Mokoka,SF,12,28,6,13,6,15,Center,5,Jump Shot,13.642857142857142
2020-21,1629690,Adam Mokoka,SG,7,19,6,9,1,10,Center,2,Jump Shot,13.210526315789474
2006-07,200747,Adam Morrison,PF,355,944,268,686,87,258,Center,12,Jump Shot,15.292372881355933
2008-09,200747,Adam Morrison,SF,80,223,48,127,32,96,Center,5,Jump Shot,18.19730941704036
2009-10,200747,Adam Morrison,SF,32,85,27,64,5,21,Center,8,Jump Shot,14.51764705882353
2019-20,1629678,Admiral Schofield,PF,35,92,16,31,19,61,Center,3,Jump Shot,18.119565217391305
2021-22,1629678,Admiral Schofield,SF,54,129,28,50,26,79,Center,2,Jump Shot,17.108527131782946
2022-23,1629678,Admiral Schofield,PF,55,122,31,48,24,74,Center,5,Jump Shot,15.967213114754099
2003-04,1502,Adonal Foyle,C,59,130,59,130,0,0,Center,2,Jump Shot,4.869230769230769
2004-05,1502,Adonal Foyle,C,156,311,156,311,0,0,Center,5,Jump Shot,4.083601286173633
2005-06,1502,Adonal Foyle,C,152,300,152,300,0,0,Center,4,Layup Shot,3.92
2006-07,1502,Adonal Foyle,C,48,85,48,85,0,0,Center,5,Layup Shot,3.9647058823529413
2007-08,1502,Adonal Foyle,C,70,153,70,153,0,0,Center,2,Layup Shot,2.9607843137254903
2008-09,1502,Adonal Foyle,C,7,11,7,11,0,0,Center,0,Layup Shot,4.090909090909091
2013-14,203519,Adonis Thomas,SF,6,14,5,9,1,5,Right Side,0,Jump Shot,17.214285714285715
2014-15,203940,Adreian Payne,PF,91,220,90,211,1,9,Center,3,Jump Shot,10.081818181818182
2015-16,203940,Adreian Payne,PF,53,145,44,113,9,32,Center,6,Jump Shot,12.593103448275862
2016-17,203940,Adreian Payne,PF,23,54,20,39,3,15,Center,7,Jump Shot,12.148148148148149
2017-18,203940,Adreian Payne,PF,7,10,5,7,2,3,Center,0,Jump Shot,16.2
2003-04,1559,Adrian Griffin,SG,5,18,4,16,1,2,Center,0,Jump Shot,14.055555555555555
2004-05,1559,Adrian Griffin,SF,58,161,56,152,2,9,Center,6,Jump Shot,12.006211180124224
2005-06,1559,Adrian Griffin,SG,98,204,98,202,0,2,Center,1,Jump Shot,9.299019607843137
2006-07,1559,Adrian Griffin,SF,61,129,61,123,0,6,Center,7,Jump Shot,10.248062015503876
2007-08,1559,Adrian Griffin,SG-SF,30,76,30,76,0,0,Center,6,Jump Shot,7.7368421052631575
2021-22,1629958,Ahmad Caver,SG,1,1,1,1,0,0,Center,1,Driving Finger Roll Layup Shot,1.0
2003-04,1733,Al Harrington,PF,421,909,400,832,21,77,Center,15,Jump Shot,10.202420242024202
2004-05,1733,Al Harrington,SF,453,986,437,912,16,74,Center,18,Jump Shot,8.154158215010142
2005-06,1733,Al Harrington,PF,551,1220,485,1029,66,191,Center,16,Jump Shot,10.821311475409836
2006-07,1733,Al Harrington,PF,495,1083,368,790,127,293,Center,13,Jump Shot,12.138504155124654
2007-08,1733,Al Harrington,C,401,923,248,515,153,408,Center,5,Jump Shot,15.38786565547129
2008-09,1733,Al Harrington,PF,532,1212,361,742,171,470,Center,21,Jump Shot,13.599009900990099
2009-10,1733,Al Harrington,PF,448,1030,308,621,140,409,Center,16,Jump Shot,13.350485436893203
2010-11,1733,Al Harrington,PF,281,675,164,347,117,328,Center,8,Jump Shot,14.72
2011-12,1733,Al Harrington,PF,345,773,244,470,101,303,Center,10,Jump Shot,12.961190168175937
2012-13,1733,Al Harrington,C,20,57,12,27,8,30,Center,1,Jump Shot,15.807017543859649
2013-14,1733,Al Harrington,PF,82,207,48,107,34,100,Center,0,Jump Shot,14.541062801932368
2007-08,201143,Al Horford,C,333,668,333,663,0,5,Center,8,Jump Shot,7.049401197604791
2008-09,201143,Al Horford,C,312,594,312,593,0,1,Center,10,Jump Shot,7.5606060606060606
2009-10,201143,Al Horford,C,467,847,466,846,1,1,Center,12,Jump Shot,6.9386068476977565
2010-11,201143,Al Horford,C,513,921,511,917,2,4,Center,25,Jump Shot,10.349619978284473
2011-12,201143,Al Horford,C,57,103,57,102,0,1,Center,0,Jump Shot,8.436893203883495
2012-13,201143,Al Horford,C,576,1060,573,1054,3,6,Center,23,Jump Shot,9.011320754716982
2013-14,201143,Al Horford,C,238,420,234,409,4,11,Center,10,Jump Shot,9.68095238095238
2014-15,201143,Al Horford,C,519,965,508,929,11,36,Center,16,Jump Shot,10.155440414507773
2015-16,201143,Al Horford,C,529,1048,441,792,88,256,Center,17,Jump Shot,12.26908396946565
2016-17,201143,Al Horford,C,379,801,293,559,86,242,Center,14,Jump Shot,12.987515605493133
2017-18,201143,Al Horford,C,368,753,271,527,97,226,Center,14,Jump Shot,12.836653386454183
2018-19,201143,Al Horford,C,387,723,314,520,73,203,Center,10,Jump Shot,12.753803596127248
2019-20,201143,Al Horford,C,319,709,220,426,99,283,Center,11,Jump Shot,14.956276445698167
2020-21,201143,Al Horford,C,162,360,106,208,56,152,Center,5,Jump Shot,14.738888888888889
2021-22,201143,Al Horford,C,266,569,177,304,89,265,Center,5,Jump Shot,14.864674868189807
2022-23,201143,Al Horford,C,228,479,83,154,145,325,Center,9,Jump Shot,18.329853862212943
2004-05,2744,Al Jefferson,PF,195,369,195,366,0,3,Center,11,Layup Shot,4.100271002710027
2005-06,2744,Al Jefferson,PF,189,379,189,375,0,4,Center,4,Layup Shot,3.870712401055409
2006-07,2744,Al Jefferson,C,453,882,453,881,0,1,Center,18,Jump Shot,5.086167800453515
2007-08,2744,Al Jefferson,C,721,1441,721,1436,0,5,Center,24,Jump Shot,6.568355308813324
2008-09,2744,Al Jefferson,C,485,975,485,971,0,4,Center,18,Jump Shot,6.793846153846154
2009-10,2744,Al Jefferson,C,560,1125,560,1121,0,4,Center,19,Jump Shot,7.450666666666667
2010-11,2744,Al Jefferson,C,654,1319,654,1319,0,0,Center,32,Jump Shot,7.647460197119029
2011-12,2744,Al Jefferson,C,516,1048,515,1044,1,4,Center,19,Jump Shot,8.713740458015268
2012-13,2744,Al Jefferson,C,611,1236,609,1219,2,17,Center,22,Jump Shot,9.709546925566343
2013-14,2744,Al Jefferson,C,700,1376,697,1361,3,15,Center,32,Jump Shot,8.474563953488373
2014-15,2744,Al Jefferson,C,486,1010,484,1005,2,5,Center,17,Jump Shot,7.725742574257426
2015-16,2744,Al Jefferson,C,245,505,245,505,0,0,Center,4,Jump Shot,7.851485148514851
2016-17,2744,Al Jefferson,C,235,471,235,470,0,1,Center,0,Jump Shot,7.099787685774947
2017-18,2744,Al Jefferson,C,111,208,111,205,0,3,Center,1,Jump Shot,8.298076923076923
2007-08,201154,Al Thornton,PF,374,871,331,741,43,130,Center,9,Jump Shot,12.440872560275546
2008-09,201154,Al Thornton,SF,469,1051,449,972,20,79,Center,15,Jump Shot,10.476688867745004
2009-10,201154,Al Thornton,SF,320,676,309,645,11,31,Center,14,Jump Shot,9.927514792899409
2010-11,201154,Al Thornton,SF-PF,205,431,201,405,4,26,Center,6,Jump Shot,10.605568445475638
2010-11,202329,Al-Farouq Aminu,SF,160,406,115,263,45,143,Center,11,Jump Shot,12.480295566502463
2011-12,202329,Al-Farouq Aminu,SF,150,365,137,318,13,47,Center,8,Jump Shot,9.208219178082192
2012-13,202329,Al-Farouq Aminu,SF,225,474,221,455,4,19,Center,7,Jump Shot,6.635021097046414
2013-14,202329,Al-Farouq Aminu,SF,234,494,221,446,13,48,Center,6,Jump Shot,8.17408906882591
2014-15,202329,Al-Farouq Aminu,SF,147,357,113,233,34,124,Center,6,Jump Shot,10.955182072829132
2015-16,202329,Al-Farouq Aminu,SF,299,718,173,370,126,348,Center,13,Jump Shot,14.85933147632312
2016-17,202329,Al-Farouq Aminu,PF,183,466,113,254,70,212,Center,4,Jump Shot,13.38412017167382
2017-18,202329,Al-Farouq Aminu,PF,230,582,105,243,125,339,Center,9,Jump Shot,16.47938144329897
2018-19,202329,Al-Farouq Aminu,PF,257,593,161,313,96,280,Center,11,Jump Shot,13.445193929173692
2019-20,202329,Al-Farouq Aminu,PF,25,86,16,50,9,36,Center,1,Jump Shot,12.848837209302326
2020-21,202329,Al-Farouq Aminu,PF,38,99,30,62,8,37,Center,2,Jump Shot,12.676767676767676
2005-06,101187,Alan Anderson,SF,75,181,51,123,24,58,Center,10,Jump Shot,12.209944751381215
2006-07,101187,Alan Anderson,SG,37,81,32,61,5,20,Center,2,Jump Shot,12.283950617283951
2011-12,101187,Alan Anderson,SF,55,142,31,81,24,61,Center,0,Jump Shot,16.429577464788732
2012-13,101187,Alan Anderson,SF,236,616,141,331,95,285,Center,11,Jump Shot,16.198051948051948
2013-14,101187,Alan Anderson,SF,194,485,110,237,84,248,Center,6,Jump Shot,16.529896907216497
2014-15,101187,Alan Anderson,SG,195,440,122,230,73,210,Center,6,Jump Shot,15.629545454545454
2015-16,101187,Alan Anderson,SG,21,59,9,22,12,37,Center,0,Jump Shot,18.661016949152543
2016-17,101187,Alan Anderson,SF,30,80,16,36,14,44,Center,2,Jump Shot,17.0625
2003-04,673,Alan Henderson,PF,10,21,10,21,0,0,Center,2,Jump Shot,6.333333333333333
2004-05,673,Alan Henderson,PF,116,220,116,218,0,2,Center,4,Layup Shot,3.081818181818182
2005-06,673,Alan Henderson,C,47,91,47,91,0,0,Center,4,Layup Shot,1.978021978021978
2006-07,673,Alan Henderson,PF,43,67,43,67,0,0,Center,2,Layup Shot,1.5820895522388059
2015-16,1626210,Alan Williams,PF,10,24,10,24,0,0,Center,2,Layup Shot,2.9166666666666665
2016-17,1626210,Alan Williams,C,138,267,138,266,0,1,Center,15,Layup Shot,4.168539325842697
2017-18,1626210,Alan Williams,PF,7,18,7,18,0,0,Center,0,Turnaround Hook Shot,5.111111111111111
2018-19,1626210,Alan Williams,PF,8,13,8,12,0,1,Center,1,Turnaround Hook Shot,7.153846153846154
2007-08,201169,Alando Tucker,SF,8,22,7,18,1,4,Center,2,Jump Shot,8.045454545454545
2008-09,201169,Alando Tucker,SG,52,121,44,98,8,23,Center,13,Jump Shot,9.694214876033058
2009-10,201169,Alando Tucker,SF,17,39,16,32,1,7,Center,5,Jump Shot,9.076923076923077
2011-12,202692,Alec Burks,SG,153,357,138,312,15,45,Center,11,Jump Shot,10.397759103641457
2012-13,202692,Alec Burks,SG,163,388,130,296,33,92,Center,15,Jump Shot,12.579896907216495
2013-14,202692,Alec Burks,SG,380,831,330,688,50,143,Center,27,Jump Shot,10.984356197352588
2014-15,202692,Alec Burks,SG,121,300,95,232,26,68,Center,7,Jump Shot,12.323333333333334
2015-16,202692,Alec Burks,SG,137,334,105,255,32,79,Center,11,Jump Shot,12.098802395209582
2016-17,202692,Alec Burks,SG,99,248,74,172,25,76,Center,5,Jump Shot,12.451612903225806
2017-18,202692,Alec Burks,SG,170,414,123,272,47,142,Center,11,Jump Shot,13.270531400966183
2018-19,202692,Alec Burks,SG,192,474,131,306,61,168,Center,10,Jump Shot,13.033755274261603
2019-20,202692,Alec Burks,SF-SG,321,768,205,467,116,301,Center,16,Jump Shot,14.876302083333334
2020-21,202692,Alec Burks,SG,210,500,108,254,102,246,Center,6,Jump Shot,16.326
2021-22,202692,Alec Burks,SG,285,728,128,339,157,389,Center,7,Jump Shot,16.86401098901099
2022-23,202692,Alec Burks,SG,200,459,101,220,99,239,Center,7,Pullup Jump shot,17.721132897603486
2017-18,1628409,Alec Peters,PF,28,74,10,16,18,58,Left Side Center,3,Jump Shot,20.22972972972973
2021-22,1630758,Aleem Ford,SF,6,20,4,5,2,15,Center,0,Jump Shot,18.95
2020-21,1630197,Alekesej Pokusevski,PF,139,408,81,201,58,207,Center,4,Jump Shot,17.03676470588235
2021-22,1630197,Alekesej Pokusevski,PF,186,456,129,259,57,197,Center,7,Jump Shot,14.12719298245614
2004-05,1893,Aleksandar Radojevic,C,6,19,6,19,0,0,Center,1,Layup Shot,3.9473684210526314
2022-23,1630197,Aleksej Pokusevski,PF,108,249,70,145,38,104,Center,0,Jump Shot,12.80722891566265
2019-20,1629346,Alen Smailagic,C,20,40,17,27,3,13,Center,0,Jump Shot,10.825
2020-21,1629346,Alen Smailagic,PF,11,27,7,17,4,10,Center,4,Jump Shot,11.407407407407407
2016-17,203518,Alex Abrines,SG,133,340,40,94,93,246,Center,12,Jump Shot,20.11470588235294
2017-18,203518,Alex Abrines,SG,115,291,31,70,84,221,Center,5,Jump Shot,20.378006872852232
2018-19,203518,Alex Abrines,SG,56,157,15,30,41,127,Right Side Center,1,Jump Shot,21.796178343949045
2005-06,101165,Alex Acker,SG,4,16,3,11,1,5,Center,3,Jump Shot,15.625
2008-09,101165,Alex Acker,SG,30,76,23,56,7,20,Center,11,Jump Shot,14.263157894736842
2017-18,1627936,Alex Caruso,PG,50,116,37,73,13,43,Center,6,Jump Shot,13.474137931034482
2018-19,1627936,Alex Caruso,PG,77,173,53,123,24,50,Center,7,Jump Shot,10.93063583815029
2019-20,1627936,Alex Caruso,PG,120,291,80,171,40,120,Center,1,Jump Shot,13.168384879725085
2020-21,1627936,Alex Caruso,PG,133,305,78,168,55,137,Center,6,Jump Shot,14.285245901639344
2021-22,1627936,Alex Caruso,SG,102,256,60,130,42,126,Center,4,Jump Shot,14.921875
2022-23,1627936,Alex Caruso,PG,130,286,75,135,55,151,Center,2,Jump Shot,14.506993006993007
2003-04,2682,Alex Garcia,SG,1,7,1,7,0,0,Center,0,Driving Layup Shot,6.142857142857143
2004-05,2682,Alex Garcia,SG,18,52,13,34,5,18,Center,1,Jump Shot,12.634615384615385
2014-15,203945,Alex Kirk,C,1,4,1,4,0,0,Center,0,Jump Shot,9.75
2013-14,203458,Alex Len,C,33,78,33,78,0,0,Center,4,Jump Shot,6.17948717948718
2014-15,203458,Alex Len,C,179,353,178,350,1,3,Center,1,Jump Shot,5.756373937677054
2015-16,203458,Alex Len,C,264,624,263,617,1,7,Center,11,Jump Shot,6.905448717948718
2016-17,203458,Alex Len,C,230,463,227,451,3,12,Center,2,Jump Shot,5.879049676025918
2017-18,203458,Alex Len,C,214,378,213,375,1,3,Center,10,Cutting Dunk Shot,2.6746031746031744
2018-19,203458,Alex Len,C,320,648,246,444,74,204,Center,10,Jump Shot,9.476851851851851
2019-20,203458,Alex Len,C,177,319,161,260,16,59,Center,7,Jump Shot,6.783699059561129
2020-21,203458,Alex Len,C,171,278,163,253,8,25,Center,3,Layup Shot,5.183453237410072
2021-22,203458,Alex Len,C,94,176,88,155,6,21,Center,0,Floating Jump shot,6.556818181818182
2022-23,203458,Alex Len,C,16,30,16,28,0,2,Center,1,Layup Shot,4.966666666666667
2016-17,1627816,Alex Poythress,PF,25,54,19,35,6,19,Center,3,Jump Shot,10.518518518518519
2017-18,1627816,Alex Poythress,PF,11,26,7,15,4,11,Center,6,Jump Shot,12.23076923076923
2018-19,1627816,Alex Poythress,PF,40,81,31,58,9,23,Center,2,Jump Shot,7.901234567901234
2015-16,1627293,Alex Stepheson,PF,9,27,9,27,0,0,Center,0,Tip Layup Shot,4.074074074074074
2006-07,200792,Alexander Johnson,PF,91,169,91,169,0,0,Center,4,Jump Shot,4.272189349112426
2007-08,200792,Alexander Johnson,PF,61,125,61,125,0,0,Center,3,Jump Shot,7.68
2012-13,203144,Alexey Shved,SG,236,635,151,347,85,288,Center,15,Jump Shot,16.121259842519684
2013-14,203144,Alexey Shved,SG,76,236,46,135,30,101,Center,13,Jump Shot,14.559322033898304
2014-15,203144,Alexey Shved,SG,133,335,86,196,47,139,Center,7,Jump Shot,14.035820895522388
2008-09,201582,Alexis Ajinca,PF,25,69,25,67,0,2,Center,3,Jump Shot,12.884057971014492
2009-10,201582,Alexis Ajinca,C,5,10,5,10,0,0,Center,2,Layup Shot,8.0
2010-11,201582,Alexis Ajinca,C,59,133,47,99,12,34,Center,3,Jump Shot,15.015037593984962
2013-14,201582,Alexis Ajinca,C,136,249,136,248,0,1,Center,1,Jump Shot,6.27710843373494
2014-15,201582,Alexis Ajinca,C,181,329,181,329,0,0,Center,9,Jump Shot,6.768996960486322
2015-16,201582,Alexis Ajinca,C,150,315,150,314,0,1,Center,5,Jump Shot,9.453968253968254
2016-17,201582,Alexis Ajinca,C,89,178,89,174,0,4,Center,2,Jump Shot,8.539325842696629
2017-18,1628035,Alfonzo McKinnie,SF,8,15,5,6,3,9,Center,2,Jump Shot,16.666666666666668
2018-19,1628035,Alfonzo McKinnie,SF,134,275,92,157,42,118,Center,8,Jump Shot,12.443636363636363
2019-20,1628035,Alfonzo McKinnie,SF,73,171,59,106,14,65,Center,7,Jump Shot,11.654970760233919
2020-21,1628035,Alfonzo McKinnie,SF,48,93,32,54,16,39,Center,14,Jump Shot,13.021505376344086
2021-22,1628035,Alfonzo McKinnie,SF,24,61,15,34,9,27,Center,1,Jump Shot,13.704918032786885
2018-19,1628993,Alize Johnson,PF,4,16,3,14,1,2,Center,2,Jump Shot,9.1875
2019-20,1628993,Alize Johnson,PF,12,29,9,21,3,8,Center,5,Jump Shot,9.068965517241379
2020-21,1628993,Alize Johnson,PF,40,68,39,62,1,6,Center,8,Layup Shot,5.926470588235294
2021-22,1628993,Alize Johnson,PF,17,39,17,35,0,4,Center,1,Layup Shot,5.769230769230769
2022-23,1628993,Alize Johnson,PF,3,6,3,4,0,2,Center,0,Driving Layup Shot,12.333333333333334
2003-04,275,Allan Houston,SG,340,781,253,579,87,202,Left Side,14,Jump Shot,17.0550576184379
2004-05,275,Allan Houston,SG,85,205,54,125,31,80,Left Side,2,Jump Shot,18.921951219512195
2006-07,200810,Allan Ray,SG,100,259,52,143,48,116,Center,10,Jump Shot,16.575289575289574
2013-14,203459,Allen Crabbe,SG,12,33,6,19,6,14,Center,4,Jump Shot,15.06060606060606
2014-15,203459,Allen Crabbe,SG,63,153,33,68,30,85,Center,5,Jump Shot,17.45751633986928
2015-16,203459,Allen Crabbe,SG,311,677,199,393,112,284,Center,13,Jump Shot,17.180206794682423
2016-17,203459,Allen Crabbe,SG,303,647,169,345,134,302,Center,4,Jump Shot,17.171561051004637
2017-18,203459,Allen Crabbe,SG,337,827,136,295,201,532,Center,16,Jump Shot,19.991535671100362
2018-19,203459,Allen Crabbe,SG,137,373,39,114,98,259,Center,2,Jump Shot,20.474530831099194
2019-20,203459,Allen Crabbe,SG-SF,63,177,27,58,36,119,Center,2,Jump Shot,20.192090395480225
2003-04,947,Allen Iverson,SG,435,1125,378,926,57,199,Center,16,Jump Shot,12.402666666666667
2004-05,947,Allen Iverson,PG,771,1818,667,1480,104,338,Center,20,Jump Shot,11.86908690869087
2005-06,947,Allen Iverson,PG,815,1822,743,1599,72,223,Center,27,Jump Shot,11.04390779363337
2006-07,947,Allen Iverson,SG-PG,581,1313,519,1116,62,197,Center,22,Jump Shot,11.501904036557502
2007-08,947,Allen Iverson,SG,712,1556,617,1281,95,275,Center,18,Jump Shot,11.44987146529563
2008-09,947,Allen Iverson,PG-SG,348,834,320,735,28,99,Center,16,Jump Shot,11.991606714628297
2009-10,947,Allen Iverson,SG-PG,136,316,127,291,9,25,Center,2,Jump Shot,12.810126582278482
2018-19,1629019,Allonzo Trier,SG,232,518,180,386,52,132,Center,14,Jump Shot,11.735521235521235
2019-20,1629019,Allonzo Trier,SG,51,106,32,53,19,53,Center,12,Jump Shot,16.9811320754717
2009-10,202087,Alonzo Gee,SG,28,59,21,50,7,9,Center,5,Jump Shot,6.728813559322034
2010-11,202087,Alonzo Gee,SG,121,264,104,213,17,51,Center,3,Jump Shot,8.155303030303031
2011-12,202087,Alonzo Gee,SG,227,551,183,414,44,137,Center,11,Jump Shot,10.330308529945553
2012-13,202087,Alonzo Gee,SF,305,744,236,525,69,219,Center,9,Jump Shot,11.384408602150538
2013-14,202087,Alonzo Gee,SF,98,236,79,178,19,58,Center,2,Jump Shot,10.966101694915254
2014-15,202087,Alonzo Gee,SF,87,186,74,151,13,35,Center,10,Jump Shot,7.10752688172043
2015-16,202087,Alonzo Gee,SF,132,255,115,195,17,60,Center,11,Jump Shot,8.239215686274509
2016-17,202087,Alonzo Gee,SF,3,14,3,11,0,3,Center,0,Jump Shot,9.642857142857142
2003-04,297,Alonzo Mourning,C,33,71,33,71,0,0,Center,0,Jump Shot,7.859154929577465
2004-05,297,Alonzo Mourning,C-PF,100,212,100,212,0,0,Center,5,Jump Shot,6.268867924528302
2005-06,297,Alonzo Mourning,C,188,315,188,314,0,1,Center,6,Layup Shot,3.507936507936508
2006-07,297,Alonzo Mourning,C,238,425,238,425,0,0,Center,5,Hook Shot,3.6023529411764708
2007-08,297,Alonzo Mourning,C,52,95,52,95,0,0,Center,2,Hook Shot,3.6
2021-22,1630578,Alperen Sengun,C,249,525,220,408,29,117,Center,3,Jump Shot,8.577142857142857
2022-23,1630578,Alperen Sengun,C,442,799,423,742,19,57,Center,2,Turnaround Hook Shot,5.531914893617022
2003-04,2228,Alton Ford,PF,6,11,6,11,0,0,Center,2,Jump Shot,8.363636363636363
2003-04,1541,Alvin Williams,SG,201,496,175,407,26,89,Center,11,Jump Shot,16.141129032258064
2005-06,1541,Alvin Williams,PG,0,3,0,1,0,2,Right Side,0,Jump Shot,22.666666666666668
2006-07,1541,Alvin Williams,PG,0,2,0,1,0,1,Center,0,Layup Shot,13.0
2003-04,1043,Amal McCaskill,C,47,117,47,116,0,1,Center,0,Jump Shot,6.3931623931623935
2003-04,2405,Amar'e Stoudemire,PF,411,865,410,860,1,5,Center,20,Jump Shot,6.01849710982659
2004-05,2405,Amar'e Stoudemire,C,747,1336,744,1320,3,16,Center,26,Jump Shot,6.663173652694611
2005-06,2405,Amar'e Stoudemire,C,9,27,9,26,0,1,Center,0,Jump Shot,7.481481481481482
2006-07,2405,Amar'e Stoudemire,C,607,1055,607,1052,0,3,Center,23,Jump Shot,5.432227488151659
2007-08,2405,Amar'e Stoudemire,C,714,1211,709,1180,5,31,Center,38,Jump Shot,6.745664739884393
2008-09,2405,Amar'e Stoudemire,PF,404,749,401,742,3,7,Center,11,Jump Shot,7.4485981308411215
2009-10,2405,Amar'e Stoudemire,PF,704,1264,703,1258,1,6,Center,22,Jump Shot,6.796677215189874
2010-11,2405,Amar'e Stoudemire,C,744,1482,734,1459,10,23,Center,31,Jump Shot,8.360323886639677
2011-12,2405,Amar'e Stoudemire,PF,316,654,311,633,5,21,Center,6,Jump Shot,8.327217125382264
2012-13,2405,Amar'e Stoudemire,PF,154,267,154,267,0,0,Center,4,Layup Shot,4.235955056179775
2013-14,2405,Amar'e Stoudemire,C,311,558,311,558,0,0,Center,3,Jump Shot,7.154121863799283
2014-15,2405,Amar'e Stoudemire,PF,273,490,273,486,0,4,Center,7,Jump Shot,5.344897959183673
2015-16,2405,Amar'e Stoudemire,C,125,221,125,221,0,0,Center,0,Layup Shot,4.8099547511312215
2020-21,1628578,Amida Brimah,C,5,8,5,8,0,0,Center,0,Alley Oop Dunk Shot,2.5
2018-19,1628518,Amile Jefferson,PF,10,16,10,16,0,0,Center,5,Layup Shot,2.25
2019-20,1628518,Amile Jefferson,PF,5,14,5,14,0,0,Center,4,Layup Shot,5.714285714285714
2019-20,1629599,Amir Coffey,SG,23,54,17,35,6,19,Center,3,Jump Shot,12.12962962962963
2020-21,1629599,Amir Coffey,SG,45,103,22,47,23,56,Center,4,Jump Shot,15.699029126213592
2021-22,1629599,Amir Coffey,SG,211,466,115,212,96,254,Center,11,Jump Shot,16.300429184549355
2022-23,1629599,Amir Coffey,SG,56,145,45,105,11,40,Center,6,Jump Shot,11.558620689655172
2005-06,101161,Amir Johnson,SF,7,10,5,7,2,3,Center,1,Jump Shot,8.0
2006-07,101161,Amir Johnson,PF,18,33,18,30,0,3,Center,1,Layup Shot,4.0
2007-08,101161,Amir Johnson,PF,92,165,92,165,0,0,Center,15,Layup Shot,2.6666666666666665
2008-09,101161,Amir Johnson,PF,97,163,97,163,0,0,Center,4,Layup Shot,3.957055214723926
2009-10,101161,Amir Johnson,PF,208,334,208,330,0,4,Center,2,Layup Shot,3.961077844311377
2010-11,101161,Amir Johnson,PF,281,495,281,494,0,1,Center,8,Jump Shot,5.711111111111111
2011-12,101161,Amir Johnson,PF,196,340,194,335,2,5,Center,13,Jump Shot,7.014705882352941
2012-13,101161,Amir Johnson,PF,336,606,331,593,5,13,Center,14,Jump Shot,7.0627062706270625
2013-14,101161,Amir Johnson,PF,344,612,324,546,20,66,Center,14,Jump Shot,7.3202614379084965
2014-15,101161,Amir Johnson,PF,298,519,279,473,19,46,Center,19,Jump Shot,5.46242774566474
2015-16,101161,Amir Johnson,PF,249,426,239,383,10,43,Center,3,Jump Shot,5.18075117370892
2016-17,101161,Amir Johnson,PF,213,370,186,304,27,66,Center,3,Jump Shot,6.594594594594595
2017-18,101161,Amir Johnson,C,140,260,130,228,10,32,Center,3,Layup Shot,6.496153846153846
2018-19,101161,Amir Johnson,C,79,157,67,117,12,40,Center,7,Jump Shot,9.121019108280255
2004-05,2760,Anderson Varejao,PF,99,193,99,191,0,2,Center,6,Jump Shot,6.036269430051814
2005-06,2760,Anderson Varejao,C,79,150,79,149,0,1,Center,5,Layup Shot,4.3
2006-07,2760,Anderson Varejao,C,191,401,191,392,0,9,Center,13,Layup Shot,4.750623441396509
2007-08,2760,Anderson Varejao,C,136,295,136,293,0,2,Center,6,Jump Shot,5.905084745762712
2008-09,2760,Anderson Varejao,PF,270,504,270,502,0,2,Center,3,Jump Shot,6.265873015873016
2009-10,2760,Anderson Varejao,PF,267,467,266,462,1,5,Center,6,Layup Shot,4.436830835117773
2010-11,2760,Anderson Varejao,C,114,216,114,214,0,2,Center,5,Layup Shot,4.75
2011-12,2760,Anderson Varejao,C,114,222,114,218,0,4,Center,15,Layup Shot,4.545045045045045
2012-13,2760,Anderson Varejao,C,138,289,138,284,0,5,Center,7,Jump Shot,6.809688581314879
2013-14,2760,Anderson Varejao,C,227,459,227,452,0,7,Center,13,Jump Shot,7.79520697167756
2014-15,2760,Anderson Varejao,C,111,200,111,198,0,2,Center,0,Jump Shot,6.385
2015-16,2760,Anderson Varejao,C,53,124,53,123,0,1,Center,1,Jump Shot,8.209677419354838
2016-17,2760,Anderson Varejao,C,5,14,5,14,0,0,Center,2,Tip Layup Shot,4.5
2020-21,2760,Anderson Varejao,C,4,16,4,15,0,1,Center,0,Jump Shot,8.625
2005-06,101154,Andray Blatche,PF,26,67,23,54,3,13,Center,5,Jump Shot,12.761194029850746
2006-07,101154,Andray Blatche,PF,86,197,82,170,4,27,Center,9,Jump Shot,8.761421319796954
2007-08,101154,Andray Blatche,PF,254,536,251,523,3,13,Center,11,Jump Shot,7.050373134328358
2008-09,101154,Andray Blatche,C,297,630,292,609,5,21,Center,8,Jump Shot,8.133333333333333
2009-10,101154,Andray Blatche,PF,478,999,465,955,13,44,Center,12,Jump Shot,9.257257257257256
2010-11,101154,Andray Blatche,PF,426,957,422,939,4,18,Center,16,Jump Shot,8.44096133751306
2011-12,101154,Andray Blatche,PF,93,245,91,238,2,7,Center,2,Jump Shot,10.710204081632654
2012-13,101154,Andray Blatche,C,346,676,343,654,3,22,Center,14,Jump Shot,7.097633136094674
2013-14,101154,Andray Blatche,PF,321,674,306,620,15,54,Center,7,Jump Shot,9.70919881305638
2004-05,2857,Andre Barrett,PG,45,124,31,72,14,52,Center,8,Jump Shot,16.330645161290324
2005-06,2857,Andre Barrett,PG,38,104,36,90,2,14,Center,4,Jump Shot,12.365384615384615
2006-07,2857,Andre Barrett,PG,4,8,4,8,0,0,Center,2,Jump Shot,7.375
2007-08,2857,Andre Barrett,PG,2,5,1,2,1,3,Right Side Center,0,Jump Shot,21.8
2006-07,2810,Andre Brown,PF,42,74,42,73,0,1,Center,7,Jump Shot,4.5
2007-08,2810,Andre Brown,PF,39,78,39,78,0,0,Center,6,Jump Shot,4.6923076923076925
2008-09,2810,Andre Brown,PF,1,7,1,7,0,0,Center,0,Layup Shot,3.2857142857142856
2014-15,203958,Andre Dawkins,SG,1,6,0,0,1,6,Right Side Center,0,Jump Shot,24.333333333333332
2012-13,203083,Andre Drummond,C,208,342,207,340,1,2,Center,8,Layup Shot,1.7573099415204678
2013-14,203083,Andre Drummond,C,479,769,479,767,0,2,Center,14,Layup Shot,1.4499349804941482
2014-15,203083,Andre Drummond,C,494,961,494,959,0,2,Center,21,Layup Shot,2.4110301768990636
2015-16,203083,Andre Drummond,C,552,1060,550,1054,2,6,Center,15,Hook Shot,3.121698113207547
2016-17,203083,Andre Drummond,C,483,911,481,904,2,7,Center,7,Hook Shot,4.0
2017-18,203083,Andre Drummond,C,466,881,466,870,0,11,Center,16,Layup Shot,3.1748013620885356
2018-19,203083,Andre Drummond,C,561,1052,556,1014,5,38,Center,23,Layup Shot,3.6463878326996197
2019-20,203083,Andre Drummond,C,418,784,413,749,5,35,Center,11,Layup Shot,3.8405612244897958
2020-21,203083,Andre Drummond,C,282,572,282,564,0,8,Center,5,Driving Layup Shot,3.173076923076923
2021-22,203083,Andre Drummond,C,247,433,247,430,0,3,Center,6,Tip Layup Shot,2.4341801385681294
2022-23,203083,Andre Drummond,C,166,274,166,271,0,3,Center,0,Tip Layup Shot,1.927007299270073
2004-05,2765,Andre Emmett,SG,2,6,2,6,0,0,Center,1,Jump Shot,7.166666666666667
2011-12,2765,Andre Emmett,SF,4,7,4,6,0,1,Center,1,Jump Shot,8.142857142857142
2004-05,2738,Andre Iguodala,SG,269,546,222,404,47,142,Center,9,Jump Shot,10.054945054945055
2005-06,2738,Andre Iguodala,SF,344,688,288,530,56,158,Center,17,Jump Shot,9.206395348837209
2006-07,2738,Andre Iguodala,SG,443,991,395,836,48,155,Center,18,Jump Shot,11.55297679112008
2007-08,2738,Andre Iguodala,SF,582,1277,481,970,101,307,Center,24,Jump Shot,13.786217697729052
2008-09,2738,Andre Iguodala,SF,542,1147,462,886,80,261,Center,26,Jump Shot,12.632083696599826
2009-10,2738,Andre Iguodala,SF,496,1120,402,817,94,303,Center,21,Jump Shot,14.110714285714286
2010-11,2738,Andre Iguodala,SF,338,759,277,578,61,181,Center,18,Jump Shot,13.938076416337285
2011-12,2738,Andre Iguodala,SF,287,632,211,439,76,193,Center,10,Jump Shot,15.069620253164556
2012-13,2738,Andre Iguodala,SG,396,879,305,592,91,287,Center,16,Jump Shot,13.379977246871444
2013-14,2738,Andre Iguodala,SF,220,458,158,283,62,175,Center,9,Jump Shot,13.716157205240174
2014-15,2738,Andre Iguodala,SF,231,496,157,284,74,212,Center,9,Jump Shot,14.766129032258064
2015-16,2738,Andre Iguodala,SF,176,368,122,214,54,154,Center,7,Jump Shot,14.46195652173913
2016-17,2738,Andre Iguodala,SF,219,415,155,238,64,177,Center,6,Jump Shot,13.686746987951807
2017-18,2738,Andre Iguodala,SF,148,320,115,203,33,117,Center,3,Jump Shot,13.721875
2018-19,2738,Andre Iguodala,SF,151,302,103,158,48,144,Center,6,Jump Shot,14.427152317880795
2019-20,2738,Andre Iguodala,SF,38,88,24,41,14,47,Center,1,Jump Shot,15.852272727272727
2020-21,2738,Andre Iguodala,SF,95,248,35,66,60,182,Center,3,Jump Shot,19.798387096774192
2021-22,2738,Andre Iguodala,SF,46,121,29,47,17,74,Center,1,Jump Shot,17.578512396694215
2022-23,2738,Andre Iguodala,SF,7,15,6,6,1,9,Center,0,Jump Shot,15.466666666666667
2017-18,201281,Andre Ingram,SG,8,17,3,8,5,9,Center,1,Jump Shot,18.941176470588236
2018-19,201281,Andre Ingram,SG,0,6,0,3,0,3,Left Side,0,Jump Shot,17.666666666666668
2003-04,1889,Andre Miller,PG,430,941,418,876,12,65,Center,13,Jump Shot,8.737513283740702
2004-05,1889,Andre Miller,PG,427,895,421,856,6,39,Center,17,Jump Shot,9.662569832402234
2005-06,1889,Andre Miller,PG,404,872,399,845,5,27,Center,16,Jump Shot,9.131880733944953
2006-07,1889,Andre Miller,PG,424,909,419,874,5,35,Center,17,Jump Shot,10.05940594059406
2007-08,1889,Andre Miller,PG,569,1156,566,1122,3,34,Center,10,Jump Shot,9.881487889273357
2008-09,1889,Andre Miller,PG,492,1041,477,988,15,53,Center,15,Jump Shot,8.934678194044189
2009-10,1889,Andre Miller,PG,404,908,388,828,16,80,Center,7,Jump Shot,10.018722466960352
2010-11,1889,Andre Miller,PG,388,844,384,807,4,37,Center,15,Jump Shot,10.105450236966824
2011-12,1889,Andre Miller,SG,242,552,224,469,18,83,Center,4,Jump Shot,10.039855072463768
2012-13,1889,Andre Miller,PG,303,632,286,568,17,64,Center,21,Jump Shot,8.223101265822784
2013-14,1889,Andre Miller,SG,106,231,95,210,11,21,Center,2,Jump Shot,8.554112554112555
2014-15,1889,Andre Miller,PG,145,290,138,256,7,34,Center,3,Jump Shot,8.76551724137931
2015-16,1889,Andre Miller,PG,59,106,57,98,2,8,Center,1,Jump Shot,8.424528301886792
2005-06,101261,Andre Owens,PG,27,74,24,58,3,16,Center,1,Jump Shot,13.91891891891892
2007-08,101261,Andre Owens,PG,40,107,22,67,18,40,Center,4,Jump Shot,14.785046728971963
2013-14,203460,Andre Roberson,SG,33,68,31,55,2,13,Center,6,Jump Shot,6.367647058823529
2014-15,203460,Andre Roberson,SG,92,201,71,116,21,85,Center,4,Jump Shot,10.965174129353233
2015-16,203460,Andre Roberson,SG,136,273,104,171,32,102,Center,4,Jump Shot,9.754578754578755
2016-17,203460,Andre Roberson,SF,215,463,170,279,45,184,Center,7,Jump Shot,10.479481641468682
2017-18,203460,Andre Roberson,SG,87,162,79,126,8,36,Center,3,Jump Shot,6.135802469135802
2019-20,203460,Andre Roberson,SF,8,29,5,15,3,14,Center,0,Jump Shot,14.068965517241379
2020-21,203460,Andre Roberson,SG,2,14,1,6,1,8,Center,0,Jump Shot,14.214285714285714
2006-07,200745,Andrea Bargnani,PF,267,625,167,357,100,268,Center,7,Jump Shot,16.6736
2007-08,200745,Andrea Bargnani,PF,280,725,190,464,90,261,Center,4,Jump Shot,16.24
2008-09,200745,Andrea Bargnani,PF,431,958,312,667,119,291,Center,13,Jump Shot,14.708768267223382
2009-10,200745,Andrea Bargnani,PF,537,1143,416,818,121,325,Center,16,Jump Shot,14.26771653543307
2010-11,200745,Andrea Bargnani,C,525,1173,448,950,77,223,Center,21,Jump Shot,13.414322250639387
2011-12,200745,Andrea Bargnani,C,209,484,175,369,34,115,Center,10,Jump Shot,14.411157024793388
2012-13,200745,Andrea Bargnani,PF,170,426,132,303,38,123,Center,2,Jump Shot,15.664319248826292
2013-14,200745,Andrea Bargnani,C,222,502,192,394,30,108,Center,4,Jump Shot,13.197211155378486
2014-15,200745,Andrea Bargnani,C,164,361,149,320,15,41,Center,5,Jump Shot,13.033240997229917
2015-16,200745,Andrea Bargnani,C,127,279,124,263,3,16,Center,2,Jump Shot,13.931899641577061
2006-07,2601,Andreas Glyniadakis,C,8,17,8,17,0,0,Center,0,Jump Shot,7.176470588235294
2003-04,1905,Andrei Kirilenko,PF,412,931,344,730,68,201,Center,17,Jump Shot,9.070891514500538
2004-05,1905,Andrei Kirilenko,PF,207,420,184,343,23,77,Center,3,Jump Shot,9.892857142857142
2005-06,1905,Andrei Kirilenko,SF,336,730,300,613,36,117,Center,12,Jump Shot,9.139726027397261
2006-07,1905,Andrei Kirilenko,SF,197,418,181,343,16,75,Center,4,Jump Shot,9.444976076555024
2007-08,1905,Andrei Kirilenko,SF,275,544,231,428,44,116,Center,8,Jump Shot,11.091911764705882
2008-09,1905,Andrei Kirilenko,PF,256,570,236,497,20,73,Center,8,Jump Shot,9.971929824561403
2009-10,1905,Andrei Kirilenko,SF,244,482,218,393,26,89,Center,9,Jump Shot,10.703319502074688
2010-11,1905,Andrei Kirilenko,SF,253,542,217,444,36,98,Center,7,Jump Shot,10.710332103321033
2012-13,1905,Andrei Kirilenko,SF,284,560,249,440,35,120,Center,13,Jump Shot,9.157142857142857
2013-14,1905,Andrei Kirilenko,PF,82,160,81,155,1,5,Center,0,Layup Shot,5.325
2014-15,1905,Andrei Kirilenko,SF,0,5,0,5,0,0,Center,0,Layup Shot,2.0
2004-05,2804,Andres Nocioni,SF,241,601,216,504,25,97,Center,5,Jump Shot,11.04991680532446
2005-06,2804,Andres Nocioni,PF,383,831,290,593,93,238,Center,21,Jump Shot,12.495788206979542
2006-07,2804,Andres Nocioni,PF,273,584,193,375,80,209,Center,12,Jump Shot,14.345890410958905
2007-08,2804,Andres Nocioni,SF,379,877,253,531,126,346,Center,17,Jump Shot,15.631698973774231
2008-09,2804,Andres Nocioni,PF-SF,299,701,175,390,124,311,Center,6,Jump Shot,15.375178316690443
2009-10,2804,Andres Nocioni,SF,234,587,138,338,96,249,Center,6,Jump Shot,15.02725724020443
2010-11,2804,Andres Nocioni,SF,118,277,76,159,42,118,Center,9,Jump Shot,15.032490974729242
2011-12,2804,Andres Nocioni,SF,5,20,4,14,1,6,Center,1,Jump Shot,13.9
2005-06,101106,Andrew Bogut,PF,323,606,323,603,0,3,Center,10,Layup Shot,3.240924092409241
2006-07,101106,Andrew Bogut,C,348,629,347,624,1,5,Center,10,Layup Shot,4.141494435612083
2007-08,101106,Andrew Bogut,C,465,910,465,903,0,7,Center,14,Layup Shot,3.6417582417582417
2008-09,101106,Andrew Bogut,C,183,317,183,317,0,0,Center,3,Layup Shot,3.2365930599369084
2009-10,101106,Andrew Bogut,C,473,910,473,908,0,2,Center,8,Hook Shot,3.9802197802197803
2010-11,101106,Andrew Bogut,C,367,742,367,738,0,4,Center,7,Hook Shot,4.311320754716981
2011-12,101106,Andrew Bogut,C,61,136,61,135,0,1,Center,1,Hook Shot,5.536764705882353
2012-13,101106,Andrew Bogut,C,83,184,82,183,1,1,Center,3,Jump Shot,4.217391304347826
2013-14,101106,Andrew Bogut,C,235,375,235,375,0,0,Center,2,Tip Shot,2.5893333333333333
2014-15,101106,Andrew Bogut,C,200,355,200,355,0,0,Center,2,Layup Shot,3.307042253521127
2015-16,101106,Andrew Bogut,C,175,279,174,278,1,1,Center,1,Alley Oop Dunk Shot,2.7347670250896057
2016-17,101106,Andrew Bogut,C,38,81,38,80,0,1,Center,0,Tip Layup Shot,3.9135802469135803
2017-18,101106,Andrew Bogut,C,17,25,17,25,0,0,Center,0,Tip Layup Shot,2.76
2018-19,101106,Andrew Bogut,C,18,36,18,36,0,0,Center,0,Tip Layup Shot,3.75
2005-06,101115,Andrew Bynum,C,33,82,33,82,0,0,Center,5,Layup Shot,3.158536585365854
2006-07,101115,Andrew Bynum,C,247,443,247,440,0,3,Center,4,Layup Shot,3.128668171557562
2007-08,101115,Andrew Bynum,C,189,297,189,297,0,0,Center,4,Layup Shot,2.2323232323232323
2008-09,101115,Andrew Bynum,C,281,502,281,502,0,0,Center,5,Jump Shot,3.946215139442231
2009-10,101115,Andrew Bynum,C,392,688,392,687,0,1,Center,1,Layup Shot,3.758720930232558
2010-11,101115,Andrew Bynum,C,237,413,237,413,0,0,Center,4,Jump Shot,3.4213075060532687
2011-12,101115,Andrew Bynum,C,444,796,443,791,1,5,Center,16,Jump Shot,4.101758793969849
2013-14,101115,Andrew Bynum,C,94,225,94,225,0,0,Center,0,Jump Shot,6.586666666666667
2003-04,692,Andrew DeClercq,C,93,195,93,195,0,0,Center,3,Layup Shot,2.830769230769231
2004-05,692,Andrew DeClercq,C,4,9,4,9,0,0,Center,0,Layup Shot,1.1111111111111112
2011-12,202726,Andrew Goudelock,SG,68,174,40,99,28,75,Center,5,Jump Shot,18.43103448275862
2012-13,202726,Andrew Goudelock,SG,0,2,0,2,0,0,Left Side Center,0,Jump Shot,15.0
2015-16,202726,Andrew Goudelock,PG,9,20,8,11,1,9,Center,1,Pullup Jump shot,17.95
2016-17,1626150,Andrew Harrison,PG,117,360,74,204,43,156,Center,7,Jump Shot,15.141666666666667
2017-18,1626150,Andrew Harrison,PG,181,429,134,287,47,142,Center,9,Jump Shot,13.223776223776223
2018-19,1626150,Andrew Harrison,PG,16,53,11,28,5,25,Center,1,Jump Shot,16.433962264150942
2022-23,1629614,Andrew Nembhard,SG,284,644,192,381,92,263,Center,12,Jump Shot,14.903726708074535
2012-13,203094,Andrew Nicholson,PF,256,486,256,486,0,0,Center,14,Jump Shot,9.681069958847736
2013-14,203094,Andrew Nicholson,PF,180,420,152,331,28,89,Center,7,Jump Shot,13.992857142857142
2014-15,203094,Andrew Nicholson,PF,83,190,70,149,13,41,Center,5,Jump Shot,14.005263157894737
2015-16,203094,Andrew Nicholson,PF,146,310,105,196,41,114,Center,5,Jump Shot,12.796774193548387
2016-17,203094,Andrew Nicholson,PF,43,111,38,84,5,27,Center,5,Jump Shot,11.657657657657658
2017-18,1628510,Andrew White III,SF,25,73,7,24,18,49,Left Side Center,2,Jump Shot,19.410958904109588
2014-15,203952,Andrew Wiggins,SF,497,1137,458,1011,39,126,Center,16,Jump Shot,10.248900615655232
2015-16,203952,Andrew Wiggins,SF,594,1294,537,1104,57,190,Center,25,Jump Shot,10.942812982998454
2016-17,203952,Andrew Wiggins,SF,709,1570,606,1281,103,289,Center,40,Jump Shot,12.103184713375796
2017-18,203952,Andrew Wiggins,SF,569,1300,457,962,112,338,Center,21,Jump Shot,13.096923076923076
2018-19,203952,Andrew Wiggins,SF,498,1209,380,861,118,348,Center,9,Jump Shot,13.224979321753516
2019-20,203952,Andrew Wiggins,SF,437,978,326,644,111,334,Center,22,Jump Shot,13.065439672801636
2020-21,203952,Andrew Wiggins,PF,505,1058,365,690,140,368,Center,11,Jump Shot,13.758034026465028
2021-22,203952,Andrew Wiggins,SF,475,1019,318,620,157,399,Center,12,Jump Shot,14.41315014720314
2022-23,203952,Andrew Wiggins,SF,250,529,161,304,89,225,Center,7,Jump Shot,14.92249527410208
2004-05,2740,Andris Biedrins,C,45,78,45,77,0,1,Center,1,Layup Shot,2.358974358974359
2005-06,2740,Andris Biedrins,C,118,185,118,185,0,0,Center,5,Layup Shot,1.6702702702702703
2006-07,2740,Andris Biedrins,C,348,581,348,581,0,0,Center,5,Layup Shot,1.6144578313253013
2007-08,2740,Andris Biedrins,C,340,543,340,543,0,0,Center,15,Layup Shot,1.3720073664825045
2008-09,2740,Andris Biedrins,C,308,533,308,532,0,1,Center,4,Layup Shot,1.6510318949343339
2009-10,2740,Andris Biedrins,C,81,137,81,137,0,0,Center,0,Jump Shot,2.291970802919708
2010-11,2740,Andris Biedrins,C,142,266,142,266,0,0,Center,1,Layup Shot,3.2142857142857144
2011-12,2740,Andris Biedrins,C,39,64,39,64,0,0,Center,0,Layup Shot,2.953125
2012-13,2740,Andris Biedrins,C,10,21,10,21,0,0,Center,0,Layup Shot,2.380952380952381
2013-14,2740,Andris Biedrins,C,1,1,1,1,0,0,Center,0,Hook Shot,3.0
2010-11,202360,Andy Rautins,SG,3,7,2,3,1,4,Right Side Center,1,Jump Shot,20.142857142857142
2003-04,358,Anfernee Hardaway,SG,279,679,249,600,30,79,Center,13,Jump Shot,13.297496318114876
2004-05,358,Anfernee Hardaway,SF,110,260,95,210,15,50,Center,4,Jump Shot,14.434615384615384
2005-06,358,Anfernee Hardaway,SF,4,14,4,13,0,1,Right Side,0,Jump Shot,14.785714285714286
2007-08,358,Anfernee Hardaway,SF,22,60,14,41,8,19,Center,1,Jump Shot,15.266666666666667
2018-19,1629014,Anfernee Simons,SG,28,63,18,34,10,29,Center,8,Jump Shot,15.714285714285714
2019-20,1629014,Anfernee Simons,SG,214,536,139,310,75,226,Center,9,Jump Shot,15.388059701492537
2020-21,1629014,Anfernee Simons,SG,168,401,48,119,120,282,Center,10,Jump Shot,20.16209476309227
2021-22,1629014,Anfernee Simons,SG,353,797,174,355,179,442,Center,11,Jump Shot,18.490589711417815
2022-23,1629014,Anfernee Simons,SG,467,1045,255,483,212,562,Center,17,Jump Shot,17.44688995215311
2018-19,1629116,Angel Delgado,C,1,5,1,5,0,0,Center,0,Driving Reverse Layup Shot,1.4
2003-04,1738,Ansu Sesay,SF,81,178,75,157,6,21,Center,11,Jump Shot,11.067415730337078
2004-05,1738,Ansu Sesay,SF,17,42,15,34,2,8,Center,3,Jump Shot,11.357142857142858
2003-04,1712,Antawn Jamison,SF,488,913,472,873,16,40,Center,19,Jump Shot,6.813800657174151
2004-05,1712,Antawn Jamison,PF,519,1189,448,981,71,208,Center,18,Jump Shot,12.581160639192598
2005-06,1712,Antawn Jamison,SF,660,1494,513,1121,147,373,Center,23,Jump Shot,13.558232931726907
2006-07,1712,Antawn Jamison,PF,512,1139,374,760,138,379,Center,15,Jump Shot,13.726953467954345
2007-08,1712,Antawn Jamison,PF,618,1417,498,1063,120,354,Center,24,Jump Shot,12.497529992942837
2008-09,1712,Antawn Jamison,PF,674,1441,562,1122,112,319,Center,20,Jump Shot,11.496877168632894
2009-10,1712,Antawn Jamison,PF,478,1036,393,789,85,247,Center,12,Jump Shot,11.727799227799228
2010-11,1712,Antawn Jamison,PF,374,876,283,613,91,263,Center,12,Jump Shot,13.988584474885844
2011-12,1712,Antawn Jamison,PF,421,1044,330,777,91,267,Center,8,Jump Shot,12.741379310344827
2012-13,1712,Antawn Jamison,PF,267,573,183,342,84,231,Center,6,Jump Shot,12.738219895287958
2013-14,1712,Antawn Jamison,PF,29,92,21,51,8,41,Center,1,Jump Shot,15.26086956521739
2017-18,1627790,Ante Zizic,C,49,67,49,67,0,0,Center,10,Layup Shot,3.4029850746268657
2018-19,1627790,Ante Zizic,C,183,331,183,331,0,0,Center,14,Layup Shot,3.9667673716012084
2019-20,1627790,Ante Zizic,C,41,72,41,72,0,0,Center,7,Layup Shot,3.7222222222222223
2013-14,203461,Anthony Bennett,PF,80,225,67,172,13,53,Center,6,Jump Shot,12.782222222222222
2014-15,203461,Anthony Bennett,PF,125,297,118,274,7,23,Center,1,Jump Shot,12.27946127946128
2015-16,203461,Anthony Bennett,PF,8,27,5,13,3,14,Center,4,Jump Shot,14.851851851851851
2016-17,203461,Anthony Bennett,PF,38,92,25,44,13,48,Center,4,Jump Shot,13.5
2015-16,1626148,Anthony Brown,SF,39,126,19,56,20,70,Center,4,Jump Shot,18.055555555555557
2016-17,1626148,Anthony Brown,SF,18,50,11,23,7,27,Left Side Center,4,Jump Shot,17.84
2017-18,1626148,Anthony Brown,SF,1,1,0,0,1,1,Left Side,1,Jump Shot,22.0
2003-04,1853,Anthony Carter,PG,11,37,11,34,0,3,Center,1,Jump Shot,13.567567567567568
2004-05,1853,Anthony Carter,PG,72,177,70,160,2,17,Center,5,Jump Shot,13.045197740112995
2005-06,1853,Anthony Carter,PG,53,137,49,122,4,15,Center,2,Jump Shot,12.963503649635037
2006-07,1853,Anthony Carter,PG,3,8,3,6,0,2,Center,0,Jump Shot,24.125
2007-08,1853,Anthony Carter,PG,218,476,173,347,45,129,Center,9,Jump Shot,13.951680672268907
2008-09,1853,Anthony Carter,PG,167,386,146,298,21,88,Center,6,Jump Shot,14.238341968911918
2009-10,1853,Anthony Carter,PG,76,181,59,118,17,63,Center,5,Jump Shot,14.508287292817679
2010-11,1853,Anthony Carter,PG,45,105,33,66,12,39,Center,1,Jump Shot,15.561904761904762
2011-12,1853,Anthony Carter,PG,17,53,12,36,5,17,Center,2,Jump Shot,18.92452830188679
2012-13,203076,Anthony Davis,PF,349,676,349,670,0,6,Center,18,Jump Shot,7.267751479289941
2013-14,203076,Anthony Davis,PF,522,1005,520,996,2,9,Center,22,Jump Shot,7.838805970149254
2014-15,203076,Anthony Davis,PF,642,1199,641,1187,1,12,Center,34,Jump Shot,9.054211843202669
2015-16,203076,Anthony Davis,C,560,1136,525,1028,35,108,Center,25,Jump Shot,10.352112676056338
2016-17,203076,Anthony Davis,C,770,1526,730,1392,40,134,Center,43,Jump Shot,10.145478374836173
2017-18,203076,Anthony Davis,PF,780,1462,725,1300,55,162,Center,23,Jump Shot,9.20109439124487
2018-19,203076,Anthony Davis,C,530,1026,482,881,48,145,Center,10,Jump Shot,9.280701754385966
2019-20,203076,Anthony Davis,PF,551,1096,479,878,72,218,Center,14,Jump Shot,10.653284671532846
2020-21,203076,Anthony Davis,PF,301,613,275,513,26,100,Center,9,Jump Shot,11.275693311582382
2021-22,203076,Anthony Davis,C,370,695,357,625,13,70,Center,5,Jump Shot,9.146762589928057
2022-23,203076,Anthony Davis,C,542,962,523,888,19,74,Center,16,Jump Shot,7.788981288981289
2020-21,1630162,Anthony Edwards,SG,505,1211,334,691,171,520,Center,28,Jump Shot,13.761354252683732
2021-22,1630162,Anthony Edwards,SG,549,1245,334,643,215,602,Center,19,Jump Shot,14.674698795180722
2022-23,1630162,Anthony Edwards,SG,707,1541,494,963,213,578,Center,33,Pullup Jump shot,13.414016872160934
2020-21,1630264,Anthony Gill,PF,30,60,23,36,7,24,Center,6,Jump Shot,11.95
2021-22,1630264,Anthony Gill,PF,62,109,48,83,14,26,Center,7,Jump Shot,8.706422018348624
2022-23,1630264,Anthony Gill,PF,71,132,67,103,4,29,Center,8,Jump Shot,8.257575757575758
2003-04,924,Anthony Goldwire,PG,7,22,5,14,2,8,Left Side Center,3,Jump Shot,18.136363636363637
2004-05,924,Anthony Goldwire,PG,57,136,25,56,32,80,Center,7,Jump Shot,18.96323529411765
2005-06,924,Anthony Goldwire,PG,1,7,1,5,0,2,Center,1,Jump Shot,21.0
2005-06,101219,Anthony Grundy,SG,19,38,14,23,5,15,Center,1,Jump Shot,12.263157894736842
2003-04,1533,Anthony Johnson,PG,167,411,126,289,41,122,Center,5,Jump Shot,16.043795620437955
2004-05,1533,Anthony Johnson,PG,203,456,162,348,41,108,Center,12,Jump Shot,13.339912280701755
2005-06,1533,Anthony Johnson,PG,267,603,216,448,51,155,Center,10,Jump Shot,13.990049751243781
2006-07,1533,Anthony Johnson,PG,142,343,117,270,25,73,Center,10,Jump Shot,14.60058309037901
2007-08,1533,Anthony Johnson,PG,155,355,113,262,42,93,Center,5,Jump Shot,13.684507042253522
2008-09,1533,Anthony Johnson,PG,154,381,102,248,52,133,Center,3,Jump Shot,15.501312335958005
2009-10,1533,Anthony Johnson,PG,49,111,36,72,13,39,Center,4,Jump Shot,14.08108108108108
2020-21,1630237,Anthony Lamb,SF,46,118,23,47,23,71,Center,1,Jump Shot,16.084745762711865
2021-22,1630237,Anthony Lamb,SF,0,2,0,0,0,2,Left Side Center,0,Jump Shot,26.5
2022-23,1630237,Anthony Lamb,SF,148,314,75,115,73,199,Center,5,Jump Shot,17.340764331210192
2004-05,292,Anthony Miller,PF,2,3,2,3,0,0,Center,2,Layup Shot,0.0
2008-09,201627,Anthony Morrow,SG,255,534,169,350,86,184,Center,14,Jump Shot,16.822097378277153
2009-10,201627,Anthony Morrow,SG,329,703,189,396,140,307,Center,17,Jump Shot,16.682788051209105
2010-11,201627,Anthony Morrow,SG,279,620,169,360,110,260,Center,11,Jump Shot,17.18709677419355
2011-12,201627,Anthony Morrow,SG,272,658,166,372,106,286,Right Side,21,Jump Shot,18.153495440729483
2012-13,201627,Anthony Morrow,SG,64,145,48,102,16,43,Center,8,Jump Shot,15.572413793103449
2013-14,201627,Anthony Morrow,SG,238,520,150,325,88,195,Center,18,Jump Shot,16.28846153846154
2014-15,201627,Anthony Morrow,SG,285,615,144,290,141,325,Center,12,Jump Shot,17.665040650406503
2015-16,201627,Anthony Morrow,SG,136,333,57,129,79,204,Center,7,Jump Shot,19.05105105105105
2016-17,201627,Anthony Morrow,SG,98,252,57,119,41,133,Center,6,Jump Shot,17.503968253968253
2006-07,1515,Anthony Parker,SG,328,687,213,426,115,261,Center,10,Jump Shot,15.54585152838428
2007-08,1515,Anthony Parker,SG,395,829,262,525,133,304,Center,12,Jump Shot,16.240048250904703
2008-09,1515,Anthony Parker,SG,321,754,227,513,94,241,Center,19,Jump Shot,16.20291777188329
2009-10,1515,Anthony Parker,SG,206,475,98,214,108,261,Right Side,7,Jump Shot,18.566315789473684
2010-11,1515,Anthony Parker,SF,220,552,134,325,86,227,Right Side,8,Jump Shot,18.027173913043477
2011-12,1515,Anthony Parker,SF,141,326,91,188,50,138,Right Side,5,Jump Shot,18.25153374233129
2003-04,324,Anthony Peeler,SG,156,348,88,207,68,141,Center,5,Jump Shot,17.53735632183908
2004-05,324,Anthony Peeler,SG,56,150,31,85,25,65,Right Side Center,0,Jump Shot,18.346666666666668
2008-09,201576,Anthony Randolph,PF,199,431,199,427,0,4,Center,11,Jump Shot,7.716937354988399
2009-10,201576,Anthony Randolph,C,137,309,136,304,1,5,Center,4,Jump Shot,8.559870550161813
2010-11,201576,Anthony Randolph,C-PF,123,264,122,260,1,4,Center,8,Jump Shot,8.700757575757576
2011-12,201576,Anthony Randolph,PF,94,200,94,199,0,1,Center,8,Jump Shot,7.51
2012-13,201576,Anthony Randolph,PF,56,114,56,106,0,8,Center,8,Jump Shot,5.184210526315789
2013-14,201576,Anthony Randolph,PF,68,176,50,115,18,61,Center,5,Jump Shot,13.954545454545455
2005-06,101194,Anthony Roberson,PG,14,31,9,21,5,10,Center,6,Jump Shot,15.806451612903226
2006-07,101194,Anthony Roberson,PG,44,104,23,49,21,55,Left Side,1,Jump Shot,18.884615384615383
2008-09,101194,Anthony Roberson,PG,44,120,18,39,26,81,Left Side Center,11,Jump Shot,20.316666666666666
2008-09,201229,Anthony Tolliver,PF,19,65,10,24,9,41,Center,1,Jump Shot,19.246153846153845
2009-10,201229,Anthony Tolliver,PF,193,449,143,297,50,152,Center,5,Jump Shot,14.54120267260579
2010-11,201229,Anthony Tolliver,SF,141,313,94,198,47,115,Center,15,Jump Shot,14.182108626198083
2011-12,201229,Anthony Tolliver,SF,71,182,46,81,25,101,Center,4,Jump Shot,16.04945054945055
2012-13,201229,Anthony Tolliver,SF,82,216,37,83,45,133,Right Side,3,Jump Shot,18.666666666666668
2013-14,201229,Anthony Tolliver,PF,129,307,27,60,102,247,Right Side Center,7,Jump Shot,21.205211726384366
2014-15,201229,Anthony Tolliver,PF,161,393,55,103,106,290,Center,8,Jump Shot,19.53435114503817
2015-16,201229,Anthony Tolliver,PF,128,331,30,60,98,271,Right Side Center,10,Jump Shot,21.274924471299094
2016-17,201229,Anthony Tolliver,PF,154,349,65,121,89,228,Center,4,Jump Shot,18.091690544412607
2017-18,201229,Anthony Tolliver,PF,219,472,60,107,159,365,Center,7,Jump Shot,20.084745762711865
2018-19,201229,Anthony Tolliver,PF,99,259,18,44,81,215,Center,8,Jump Shot,21.571428571428573
2019-20,201229,Anthony Tolliver,PF,65,182,16,37,49,145,Center,3,Jump Shot,20.802197802197803
2020-21,201229,Anthony Tolliver,PF,4,17,0,3,4,14,Right Side Center,0,Jump Shot,22.58823529411765
2003-04,952,Antoine Walker,PF,483,1129,401,824,82,305,Center,16,Jump Shot,9.483613817537645
2004-05,952,Antoine Walker,PF,581,1377,471,1036,110,341,Center,21,Jump Shot,9.209150326797385
2005-06,952,Antoine Walker,PF,391,898,254,515,137,383,Center,21,Jump Shot,12.430957683741648
2006-07,952,Antoine Walker,PF,265,668,181,363,84,305,Center,6,Jump Shot,13.12125748502994
2007-08,952,Antoine Walker,PF,136,375,75,187,61,188,Center,7,Jump Shot,14.256
2005-06,101120,Antoine Wright,SG,29,81,28,66,1,15,Center,2,Jump Shot,9.098765432098766
2006-07,101120,Antoine Wright,SG,110,251,91,192,19,59,Center,4,Jump Shot,10.613545816733067
2007-08,101120,Antoine Wright,SG,136,329,104,219,32,110,Center,13,Jump Shot,12.72644376899696
2008-09,101120,Antoine Wright,SF,179,431,134,282,45,149,Center,3,Jump Shot,12.450116009280743
2009-10,101120,Antoine Wright,SF,162,399,104,226,58,173,Center,3,Jump Shot,15.62907268170426
2010-11,101120,Antoine Wright,SG,1,8,1,4,0,4,Left Side,0,Jump Shot,17.375
2009-10,202079,Antonio Anderson,SF,1,3,1,3,0,0,Left Side,0,Jump Shot,18.0
2017-18,1628469,Antonio Blakeney,SG,53,143,38,91,15,52,Center,5,Jump Shot,15.566433566433567
2018-19,1628469,Antonio Blakeney,SG,166,396,130,305,36,91,Center,24,Jump Shot,13.6489898989899
2004-05,2766,Antonio Burks,PG,28,60,25,49,3,11,Center,1,Jump Shot,14.766666666666667
2005-06,2766,Antonio Burks,PG,51,144,50,138,1,6,Center,5,Jump Shot,11.930555555555555
2003-04,1498,Antonio Daniels,PG,187,398,145,282,42,116,Center,8,Jump Shot,13.010050251256281
2004-05,1498,Antonio Daniels,PG,273,623,224,458,49,165,Center,11,Jump Shot,13.423756019261637
2005-06,1498,Antonio Daniels,SG,230,550,207,449,23,101,Center,11,Jump Shot,11.49090909090909
2006-07,1498,Antonio Daniels,SG,172,389,153,326,19,63,Center,8,Jump Shot,11.54241645244216
2007-08,1498,Antonio Daniels,PG,205,447,188,373,17,74,Center,11,Jump Shot,10.881431767337808
2008-09,1498,Antonio Daniels,PG,99,236,77,176,22,60,Center,6,Jump Shot,12.745762711864407
2010-11,1498,Antonio Daniels,PG,2,5,2,3,0,2,Center,0,Jump Shot,16.8
2003-04,213,Antonio Davis,C,266,660,266,660,0,0,Center,11,Jump Shot,8.463636363636363
2004-05,213,Antonio Davis,PF,193,419,193,419,0,0,Center,6,Jump Shot,8.100238663484486
2005-06,213,Antonio Davis,PF-C,82,190,82,189,0,1,Center,3,Jump Shot,6.752631578947368
2003-04,686,Antonio McDyess,PF,126,268,126,268,0,0,Center,5,Jump Shot,9.955223880597014
2004-05,686,Antonio McDyess,PF,307,598,307,597,0,1,Center,3,Jump Shot,9.160535117056856
2005-06,686,Antonio McDyess,PF,285,560,285,558,0,2,Left Side,2,Jump Shot,11.535714285714286
2006-07,686,Antonio McDyess,PF,284,540,284,540,0,0,Center,7,Jump Shot,10.488888888888889
2007-08,686,Antonio McDyess,PF,293,600,293,598,0,2,Center,3,Jump Shot,12.246666666666666
2008-09,686,Antonio McDyess,PF,268,525,268,525,0,0,Center,9,Jump Shot,12.96
2009-10,686,Antonio McDyess,PF,205,428,205,426,0,2,Center,3,Jump Shot,12.83177570093458
2010-11,686,Antonio McDyess,PF,169,344,169,343,0,1,Center,6,Jump Shot,12.351744186046512
2017-18,1628499,Antonius Cleveland,SG,8,21,5,17,3,4,Center,1,Jump Shot,14.142857142857142
2019-20,1628499,Antonius Cleveland,SG,4,14,4,11,0,3,Center,1,Fadeaway Jump Shot,9.071428571428571
2019-20,1628394,Anzejs Pasecniks,C,61,116,61,113,0,3,Center,2,Jump Shot,5.224137931034483
2020-21,1628394,Anzejs Pasecniks,C,0,1,0,0,0,1,Center,0,Jump Shot,25.0
2013-14,203462,Archie Goodwin,SG,76,167,71,131,5,36,Center,4,Jump Shot,7.976047904191617
2014-15,203462,Archie Goodwin,SG,79,201,67,160,12,41,Center,7,Jump Shot,9.213930348258707
2015-16,203462,Archie Goodwin,PG,176,421,153,323,23,98,Center,18,Jump Shot,8.843230403800476
2016-17,203462,Archie Goodwin,SG,36,66,31,51,5,15,Center,4,Driving Layup Shot,8.257575757575758
2013-14,202620,Arinze Onuaku,PF,1,5,1,5,0,0,Center,0,Layup Shot,1.4
2014-15,202620,Arinze Onuaku,C,12,14,12,14,0,0,Center,4,Jump Hook Shot,2.0
2016-17,202620,Arinze Onuaku,C,2,4,2,4,0,0,Center,2,Hook Shot,7.75
2010-11,202356,Armon Johnson,PG,46,101,41,89,5,12,Center,6,Jump Shot,9.950495049504951
2011-12,202356,Armon Johnson,PG,20,43,19,40,1,3,Center,4,Jump Shot,7.534883720930233
2020-21,1629717,Armoni Brooks,SG,78,192,18,35,60,157,Left Side Center,10,Jump Shot,21.598958333333332
2021-22,1629717,Armoni Brooks,SG-PG,98,289,24,40,74,249,Left Side Center,8,Jump Shot,22.885813148788927
2012-13,203102,Arnett Moultrie,PF,78,134,78,134,0,0,Center,5,Jump Shot,6.082089552238806
2013-14,203102,Arnett Moultrie,PF,16,38,16,38,0,0,Center,2,Jump Shot,9.763157894736842
2021-22,1629083,Arnoldas Kulboka,SF,0,1,0,0,0,1,Right Side,0,Jump Shot,23.0
2012-13,203382,Aron Baynes,C,18,36,18,35,0,1,Center,4,Jump Shot,6.0
2013-14,203382,Aron Baynes,C,71,163,71,163,0,0,Center,8,Jump Shot,5.533742331288344
2014-15,203382,Aron Baynes,C,185,327,184,323,1,4,Center,7,Jump Shot,4.636085626911315
2015-16,203382,Aron Baynes,C,194,384,194,382,0,2,Center,12,Jump Shot,5.411458333333333
2016-17,203382,Aron Baynes,C,143,279,143,279,0,0,Center,1,Jump Shot,5.182795698924731
2017-18,203382,Aron Baynes,C,210,446,207,425,3,21,Center,1,Jump Shot,7.943946188340807
2018-19,203382,Aron Baynes,C,105,223,84,162,21,61,Center,0,Jump Shot,9.434977578475337
2019-20,203382,Aron Baynes,C,183,381,124,213,59,168,Center,6,Jump Shot,12.800524934383201
2020-21,203382,Aron Baynes,C,134,304,107,201,27,103,Center,0,Jump Shot,11.006578947368421
2007-08,201167,Arron Afflalo,SG,99,241,89,193,10,48,Center,11,Jump Shot,12.390041493775934
2008-09,201167,Arron Afflalo,SG,131,300,88,193,43,107,Left Side,6,Jump Shot,15.403333333333334
2009-10,201167,Arron Afflalo,SG,272,585,164,336,108,249,Center,17,Jump Shot,14.972649572649573
2010-11,201167,Arron Afflalo,SG,311,624,207,379,104,245,Center,16,Jump Shot,14.29647435897436
2011-12,201167,Arron Afflalo,SG,329,698,241,478,88,220,Center,16,Jump Shot,13.038681948424069
2012-13,201167,Arron Afflalo,SF,397,905,325,665,72,240,Center,18,Jump Shot,14.332596685082873
2013-14,201167,Arron Afflalo,SG,464,1010,336,711,128,299,Center,28,Jump Shot,15.637623762376238
2014-15,201167,Arron Afflalo,SG,375,884,257,551,118,333,Center,14,Jump Shot,15.850678733031675
2015-16,201167,Arron Afflalo,SG,354,797,263,561,91,236,Center,20,Jump Shot,14.819322459222082
2016-17,201167,Arron Afflalo,SG,185,420,123,269,62,151,Center,2,Jump Shot,16.39047619047619
2017-18,201167,Arron Afflalo,SG,65,162,38,92,27,70,Center,4,Jump Shot,17.12962962962963
2005-06,101178,Arvydas Macijauskas,SG,14,41,11,29,3,12,Center,4,Jump Shot,15.829268292682928
2003-04,1506,Austin Croshere,PF,119,307,63,163,56,144,Center,4,Jump Shot,15.110749185667752
2004-05,1506,Austin Croshere,PF,188,497,143,323,45,174,Center,7,Jump Shot,13.311871227364184
2005-06,1506,Austin Croshere,PF,132,285,78,145,54,140,Center,9,Jump Shot,16.256140350877192
2006-07,1506,Austin Croshere,PF,78,222,52,131,26,91,Center,5,Jump Shot,14.427927927927929
2007-08,1506,Austin Croshere,PF,61,137,39,76,22,61,Center,5,Jump Shot,15.262773722627736
2008-09,1506,Austin Croshere,PF,14,39,9,24,5,15,Center,4,Jump Shot,12.717948717948717
2009-10,201948,Austin Daye,SF,136,294,108,200,28,94,Center,10,Jump Shot,13.874149659863946
2010-11,201948,Austin Daye,SF,193,471,124,299,69,172,Center,15,Jump Shot,14.959660297239916
2011-12,201948,Austin Daye,SF,73,227,60,165,13,62,Center,12,Jump Shot,15.524229074889869
2012-13,201948,Austin Daye,SF,90,208,49,110,41,98,Center,7,Jump Shot,17.908653846153847
2013-14,201948,Austin Daye,SF,24,68,12,31,12,37,Center,5,Jump Shot,17.470588235294116
2014-15,201948,Austin Daye,SF,50,141,26,70,24,71,Center,8,Jump Shot,17.404255319148938
2021-22,1630559,Austin Reaves,SG,146,318,93,151,53,167,Center,12,Jump Shot,16.154088050314467
2022-23,1630559,Austin Reaves,SG,259,490,173,274,86,216,Center,13,Jump Shot,14.887755102040817
2012-13,203085,Austin Rivers,SG,145,390,117,304,28,86,Center,8,Jump Shot,10.48974358974359
2013-14,203085,Austin Rivers,PG,192,474,156,375,36,99,Center,12,Jump Shot,9.257383966244726
2014-15,203085,Austin Rivers,PG-SG,203,495,164,365,39,130,Center,8,Jump Shot,11.32929292929293
2015-16,203085,Austin Rivers,SG,226,514,164,331,62,183,Center,13,Jump Shot,13.311284046692608
2016-17,203085,Austin Rivers,SG,323,729,212,432,111,297,Center,13,Jump Shot,13.078189300411523
2017-18,203085,Austin Rivers,SG,341,805,205,445,136,360,Center,14,Jump Shot,13.652173913043478
2018-19,203085,Austin Rivers,SG,232,572,128,245,104,327,Center,10,Jump Shot,15.914335664335665
2019-20,203085,Austin Rivers,SG,211,501,115,231,96,270,Center,4,Jump Shot,14.968063872255488
2020-21,203085,Austin Rivers,SG,104,245,49,96,55,149,Center,4,Jump Shot,17.03265306122449
2021-22,203085,Austin Rivers,SG,146,350,67,119,79,231,Center,4,Jump Shot,17.437142857142856
2022-23,203085,Austin Rivers,SG,91,209,48,86,43,123,Center,7,Jump Shot,15.148325358851675
2010-11,202340,Avery Bradley,PG,23,67,23,62,0,5,Center,6,Jump Shot,12.611940298507463
2011-12,202340,Avery Bradley,PG,200,402,178,348,22,54,Center,7,Jump Shot,10.582089552238806
2012-13,202340,Avery Bradley,PG,192,478,152,352,40,126,Center,5,Jump Shot,13.44979079497908
2013-14,202340,Avery Bradley,SG,361,824,282,625,79,199,Center,10,Jump Shot,15.343446601941748
2014-15,202340,Avery Bradley,SG,434,1012,310,661,124,351,Center,25,Jump Shot,16.798418972332016
2015-16,202340,Avery Bradley,SG,456,1018,309,612,147,406,Center,21,Jump Shot,16.36444007858546
2016-17,202340,Avery Bradley,SG,359,775,251,498,108,277,Center,15,Jump Shot,14.68
2017-18,202340,Avery Bradley,SG,259,625,184,422,75,203,Center,17,Jump Shot,14.3344
2018-19,202340,Avery Bradley,SG,248,608,162,363,86,245,Center,2,Jump Shot,16.523026315789473
2019-20,202340,Avery Bradley,SG,170,383,107,210,63,173,Center,4,Jump Shot,16.451697127937337
2020-21,202340,Avery Bradley,SG,64,171,31,70,33,101,Center,2,Jump Shot,17.748538011695906
2021-22,202340,Avery Bradley,SG,148,350,66,140,82,210,Center,1,Jump Shot,17.574285714285715
2003-04,422,Avery Johnson,PG,80,199,80,196,0,3,Center,5,Jump Shot,5.864321608040201
2004-05,2852,Awvee Storey,SG,3,10,2,8,1,2,Center,3,Jump Shot,13.7
2005-06,2852,Awvee Storey,SF,16,41,13,34,3,7,Center,5,Jump Shot,14.926829268292684
2007-08,2852,Awvee Storey,SG,39,89,39,82,0,7,Center,7,Jump Shot,9.96629213483146
2015-16,1626253,Axel Toupane,SF,25,70,12,30,13,40,Right Side,3,Jump Shot,16.52857142857143
2016-17,1626253,Axel Toupane,SF,5,9,4,5,1,4,Right Side,0,Jump Shot,19.22222222222222
2020-21,1626253,Axel Toupane,SF,4,11,3,9,1,2,Center,1,Cutting Layup Shot,9.909090909090908
2021-22,1630245,Ayo Dosunmu,SG,278,535,208,349,70,186,Center,14,Jump Shot,11.809345794392524
2022-23,1630245,Ayo Dosunmu,SG,281,570,222,381,59,189,Center,13,Jump Shot,10.710526315789474
2018-19,1629168,BJ Johnson,SF,9,18,6,11,3,7,Center,1,Jump Shot,16.11111111111111
2019-20,1629168,BJ Johnson,SF,9,32,6,23,3,9,Center,0,Pullup Jump shot,13.65625
2021-22,1629168,BJ Johnson,SF,11,25,7,15,4,10,Center,0,Jump Shot,16.4
2017-18,1628389,Bam Adebayo,C,174,340,174,333,0,7,Center,3,Jump Shot,4.320588235294117
2018-19,1628389,Bam Adebayo,C,280,486,277,471,3,15,Center,15,Jump Shot,4.689300411522634
2019-20,1628389,Bam Adebayo,PF,440,790,438,776,2,14,Center,18,Jump Shot,5.2873417721518985
2020-21,1628389,Bam Adebayo,C,456,800,454,792,2,8,Center,26,Jump Shot,7.08
2021-22,1628389,Bam Adebayo,C,406,729,406,723,0,6,Center,15,Jump Shot,6.491083676268861
2022-23,1628389,Bam Adebayo,C,602,1114,601,1102,1,12,Center,20,Jump Shot,6.901256732495511
2003-04,1884,Baron Davis,PG,554,1402,367,820,187,582,Center,17,Jump Shot,14.663338088445078
2004-05,1884,Baron Davis,PG,291,752,173,398,118,354,Center,16,Jump Shot,15.860372340425531
2005-06,1884,Baron Davis,PG,335,861,233,537,102,324,Center,17,Jump Shot,14.511033681765388
2006-07,1884,Baron Davis,PG,452,1030,367,750,85,280,Center,19,Jump Shot,12.094174757281554
2007-08,1884,Baron Davis,PG,650,1526,477,1001,173,525,Center,33,Jump Shot,13.353211009174313
2008-09,1884,Baron Davis,PG,355,959,256,631,99,328,Center,18,Jump Shot,13.956204379562044
2009-10,1884,Baron Davis,PG,412,1015,330,719,82,296,Center,20,Jump Shot,12.918226600985221
2010-11,1884,Baron Davis,PG,289,693,208,454,81,239,Center,9,Jump Shot,13.751803751803752
2011-12,1884,Baron Davis,PG,68,184,42,99,26,85,Center,0,Jump Shot,16.16304347826087
2016-17,1627791,Ben Bentil,PF,0,3,0,2,0,1,Left Side,0,Jump Shot,15.0
2004-05,2732,Ben Gordon,SG,434,1056,300,725,134,331,Center,33,Jump Shot,15.303977272727273
2005-06,2732,Ben Gordon,SG,486,1152,320,770,166,382,Center,36,Jump Shot,16.26736111111111
2006-07,2732,Ben Gordon,SG,609,1338,454,963,155,375,Center,31,Jump Shot,16.105381165919283
2007-08,2732,Ben Gordon,SG,464,1069,322,723,142,346,Center,17,Jump Shot,16.426566884939195
2008-09,2732,Ben Gordon,SG,598,1315,425,893,173,422,Center,34,Jump Shot,15.525475285171103
2009-10,2732,Ben Gordon,SG,291,699,216,465,75,234,Center,14,Jump Shot,15.848354792560801
2010-11,2732,Ben Gordon,SG,339,770,232,504,107,266,Center,9,Jump Shot,16.5987012987013
2011-12,2732,Ben Gordon,SG,234,530,171,383,63,147,Center,8,Jump Shot,16.28490566037736
2012-13,2732,Ben Gordon,SG,310,760,197,468,113,292,Center,6,Jump Shot,15.921052631578947
2013-14,2732,Ben Gordon,SG,37,107,29,79,8,28,Center,0,Jump Shot,14.69158878504673
2014-15,2732,Ben Gordon,SG,129,295,94,198,35,97,Center,3,Jump Shot,16.308474576271188
2003-04,1052,Ben Handlogten,C,25,47,25,47,0,0,Center,1,Layup Shot,1.702127659574468
2004-05,1052,Ben Handlogten,C,43,83,43,82,0,1,Center,3,Layup Shot,5.626506024096385
2012-13,203162,Ben Hansbrough,PG,15,45,9,22,6,23,Center,6,Jump Shot,17.977777777777778
2013-14,203463,Ben McLemore,SG,255,679,160,382,95,297,Center,16,Jump Shot,16.078055964653903
2014-15,203463,Ben McLemore,SG,363,831,223,440,140,391,Center,13,Jump Shot,15.651022864019254
2015-16,203463,Ben McLemore,SG,195,455,128,270,67,185,Center,8,Jump Shot,14.197802197802197
2016-17,203463,Ben McLemore,SG,179,418,115,249,64,169,Center,9,Jump Shot,15.5
2017-18,203463,Ben McLemore,SG,157,373,102,214,55,159,Center,3,Jump Shot,14.84450402144772
2018-19,203463,Ben McLemore,SG,25,64,8,23,17,41,Center,3,Jump Shot,19.640625
2019-20,203463,Ben McLemore,SF,242,545,61,93,181,452,Left Side Center,4,Jump Shot,21.020183486238533
2020-21,203463,Ben McLemore,SG,135,365,38,85,97,280,Center,8,Jump Shot,21.161643835616438
2021-22,203463,Ben McLemore,SG,216,539,65,122,151,417,Center,7,Jump Shot,21.424860853432282
2017-18,1627732,Ben Simmons,PG,544,998,544,987,0,11,Center,19,Driving Layup Shot,5.56312625250501
2018-19,1627732,Ben Simmons,PG,540,960,540,954,0,6,Center,17,Driving Layup Shot,3.6635416666666667
2019-20,1627732,Ben Simmons,PG,375,647,373,640,2,7,Center,6,Driving Layup Shot,3.1452859350850075
2020-21,1627732,Ben Simmons,PG,325,583,322,573,3,10,Center,5,Driving Layup Shot,3.8010291595197256
2022-23,1627732,Ben Simmons,PG,133,235,133,233,0,2,Center,0,Turnaround Hook Shot,4.361702127659575
2010-11,202386,Ben Uzoh,PG,61,144,58,136,3,8,Center,15,Jump Shot,7.097222222222222
2011-12,202386,Ben Uzoh,PG,35,99,35,98,0,1,Center,4,Jump Shot,6.8686868686868685
2003-04,1112,Ben Wallace,C,315,748,314,740,1,8,Center,8,Layup Shot,4.672459893048129
2004-05,1112,Ben Wallace,C,295,651,294,642,1,9,Center,7,Layup Shot,4.179723502304148
2005-06,1112,Ben Wallace,C,237,465,237,461,0,4,Center,11,Layup Shot,2.8666666666666667
2006-07,1112,Ben Wallace,C,192,424,191,419,1,5,Center,6,Layup Shot,3.483490566037736
2007-08,1112,Ben Wallace,C-PF,138,352,138,348,0,4,Center,3,Layup Shot,3.6107954545454546
2008-09,1112,Ben Wallace,PF,69,155,69,155,0,0,Center,1,Layup Shot,3.464516129032258
2009-10,1112,Ben Wallace,C,158,292,158,290,0,2,Center,5,Layup Shot,2.017123287671233
2010-11,1112,Ben Wallace,C,67,149,66,147,1,2,Center,2,Layup Shot,2.563758389261745
2011-12,1112,Ben Wallace,C,34,86,33,82,1,4,Center,1,Layup Shot,5.430232558139535
2022-23,1631097,Bennedict Mathurin,SF,413,951,313,641,100,310,Center,21,Jump Shot,11.70136698212408
2004-05,2757,Beno Udrih,PG,173,390,115,248,58,142,Center,7,Jump Shot,14.756410256410257
2005-06,2757,Beno Udrih,PG,106,233,82,163,24,70,Center,14,Jump Shot,12.313304721030043
2006-07,2757,Beno Udrih,PG,127,344,94,229,33,115,Center,12,Jump Shot,15.668604651162791
2007-08,2757,Beno Udrih,PG,328,708,275,571,53,137,Center,21,Jump Shot,12.036723163841808
2008-09,2757,Beno Udrih,PG,321,696,286,583,35,113,Center,14,Jump Shot,11.895114942528735
2009-10,2757,Beno Udrih,PG,415,841,340,642,75,199,Center,17,Jump Shot,14.271105826397147
2010-11,2757,Beno Udrih,PG,412,824,347,642,65,182,Center,11,Jump Shot,13.839805825242719
2011-12,2757,Beno Udrih,SG,145,331,129,273,16,58,Center,8,Jump Shot,13.299093655589123
2012-13,2757,Beno Udrih,SG-PG,210,476,176,374,34,102,Center,9,Jump Shot,14.739495798319327
2013-14,2757,Beno Udrih,SG,78,178,59,136,19,42,Center,6,Jump Shot,14.061797752808989
2014-15,2757,Beno Udrih,PG,246,505,220,408,26,97,Center,6,Jump Shot,13.702970297029703
2015-16,2757,Beno Udrih,PG,86,197,71,154,15,43,Center,5,Jump Shot,14.609137055837563
2016-17,2757,Beno Udrih,PG,92,197,81,165,11,32,Center,4,Jump Shot,13.568527918781726
2012-13,203108,Bernard James,C,53,103,53,101,0,2,Center,1,Layup Shot,3.3106796116504853
2013-14,203108,Bernard James,C,11,23,11,22,0,1,Center,3,Layup Shot,4.304347826086956
2014-15,203108,Bernard James,C,12,27,12,27,0,0,Center,4,Layup Shot,1.2962962962962963
2004-05,2774,Bernard Robinson,SG,36,81,33,73,3,8,Center,2,Jump Shot,8.679012345679013
2005-06,2774,Bernard Robinson,SF,157,365,155,344,2,21,Center,15,Jump Shot,6.712328767123288
2006-07,2774,Bernard Robinson,SG-SF,19,62,19,60,0,2,Center,1,Jump Shot,7.709677419354839
2018-19,1628656,Billy Garrett,SG,11,27,11,19,0,8,Center,0,Jump Shot,14.962962962962964
2004-05,2873,Billy Thomas,SF,34,94,17,38,17,56,Left Side,3,Jump Shot,18.73404255319149
2005-06,2873,Billy Thomas,SG,13,40,3,10,10,30,Left Side,2,Jump Shot,23.2
2007-08,2873,Billy Thomas,SF,4,17,0,1,4,16,Left Side Center,0,Jump Shot,23.41176470588235
2003-04,902,Bimbo Coles,PG,12,34,12,34,0,0,Left Side,0,Jump Shot,13.058823529411764
2011-12,202687,Bismack Biyombo,C,129,278,129,278,0,0,Center,7,Layup Shot,4.176258992805756
2012-13,202687,Bismack Biyombo,C,156,346,156,346,0,0,Center,9,Layup Shot,3.5838150289017343
2013-14,202687,Bismack Biyombo,C,88,144,88,144,0,0,Center,1,Layup Shot,2.951388888888889
2014-15,202687,Bismack Biyombo,C,101,186,101,186,0,0,Center,1,Layup Shot,2.043010752688172
2015-16,202687,Bismack Biyombo,C,156,288,156,287,0,1,Center,4,Layup Shot,3.5416666666666665
2016-17,202687,Bismack Biyombo,C,179,339,179,339,0,0,Center,5,Layup Shot,3.6253687315634218
2017-18,202687,Bismack Biyombo,C,183,352,183,351,0,1,Center,4,Layup Shot,4.482954545454546
2018-19,202687,Bismack Biyombo,C,89,156,89,156,0,0,Center,3,Layup Shot,3.7371794871794872
2019-20,202687,Bismack Biyombo,C,151,278,151,278,0,0,Center,1,Hook Shot,3.161870503597122
2020-21,202687,Bismack Biyombo,C,142,242,142,241,0,1,Center,0,Layup Shot,2.2892561983471076
2021-22,202687,Bismack Biyombo,C,86,145,86,145,0,0,Center,11,Hook Shot,3.820689655172414
2022-23,202687,Bismack Biyombo,C,119,206,119,206,0,0,Center,5,Hook Shot,3.9757281553398056
2007-08,201336,Blake Ahearn,PG,15,57,5,23,10,34,Center,0,Jump Shot,18.12280701754386
2008-09,201336,Blake Ahearn,PG,2,6,0,2,2,4,Center,0,Jump Shot,17.833333333333332
2011-12,201336,Blake Ahearn,PG,4,14,2,5,2,9,Left Side,0,Jump Shot,20.428571428571427
2010-11,201933,Blake Griffin,PF,696,1376,689,1352,7,24,Center,31,Jump Shot,6.71875
2011-12,201933,Blake Griffin,PF,561,1022,559,1006,2,16,Center,18,Jump Shot,7.23385518590998
2012-13,201933,Blake Griffin,PF,577,1072,572,1044,5,28,Center,12,Jump Shot,7.84794776119403
2013-14,201933,Blake Griffin,PF,718,1359,706,1315,12,44,Center,17,Jump Shot,8.32008830022075
2014-15,201933,Blake Griffin,PF,574,1144,564,1119,10,25,Center,9,Jump Shot,9.965034965034965
2015-16,201933,Blake Griffin,PF,301,603,295,585,6,18,Center,15,Jump Shot,11.175787728026535
2016-17,201933,Blake Griffin,PF,479,970,441,858,38,112,Center,9,Jump Shot,10.184536082474226
2017-18,201933,Blake Griffin,PF,436,996,325,674,111,322,Center,18,Jump Shot,12.476907630522089
2018-19,201933,Blake Griffin,PF,619,1341,430,819,189,522,Center,28,Jump Shot,12.596569724086503
2019-20,201933,Blake Griffin,PF,88,250,61,139,27,111,Center,4,Jump Shot,13.264
2020-21,201933,Blake Griffin,PF,174,411,104,206,70,205,Center,3,Jump Shot,14.591240875912408
2021-22,201933,Blake Griffin,C,133,313,95,168,38,145,Center,3,Jump Shot,13.035143769968052
2022-23,201933,Blake Griffin,C,63,130,40,64,23,66,Center,2,Jump Shot,13.584615384615384
2022-23,1631104,Blake Wesley,SG,69,215,49,163,20,52,Center,4,Jump Shot,11.35813953488372
2003-04,448,Bo Outlaw,PF,159,312,159,308,0,4,Center,7,Layup Shot,3.3365384615384617
2004-05,448,Bo Outlaw,PF,12,34,12,34,0,0,Center,0,Jump Shot,8.147058823529411
2005-06,448,Bo Outlaw,PF,35,58,35,58,0,0,Center,2,Layup Shot,2.5172413793103448
2006-07,448,Bo Outlaw,PF,34,51,34,51,0,0,Center,4,Layup Shot,0.8235294117647058
2007-08,448,Bo Outlaw,PF,2,3,2,3,0,0,Center,0,Alley Oop Layup shot,3.3333333333333335
2003-04,682,Bob Sura,SG,202,485,181,406,21,79,Center,11,Jump Shot,8.529896907216495
2004-05,682,Bob Sura,PG,215,504,160,349,55,155,Center,12,Jump Shot,12.194444444444445
2015-16,1626246,Boban Marjanovic,C,105,174,105,174,0,0,Center,17,Jump Shot,4.603448275862069
2016-17,1626246,Boban Marjanovic,C,72,132,72,132,0,0,Center,15,Jump Shot,4.348484848484849
2017-18,1626246,Boban Marjanovic,C,79,148,79,148,0,0,Center,8,Layup Shot,4.033783783783784
2018-19,1626246,Boban Marjanovic,C,160,260,156,250,4,10,Center,5,Layup Shot,4.792307692307692
2019-20,1626246,Boban Marjanovic,C,121,211,117,194,4,17,Center,11,Jump Shot,6.104265402843602
2020-21,1626246,Boban Marjanovic,C,62,122,61,114,1,8,Center,4,Jump Shot,5.901639344262295
2021-22,1626246,Boban Marjanovic,C,42,70,41,66,1,4,Center,1,Turnaround Jump Shot,6.6
2022-23,1626246,Boban Marjanovic,C,41,60,41,59,0,1,Center,11,Layup Shot,4.516666666666667
2008-09,201628,Bobby Brown,SG-PG,141,360,96,230,45,130,Center,15,Jump Shot,16.51388888888889
2009-10,201628,Bobby Brown,PG,88,237,62,139,26,98,Center,9,Jump Shot,17.054852320675106
2016-17,201628,Bobby Brown,PG,23,60,9,25,14,35,Center,10,Jump Shot,19.533333333333335
2017-18,201628,Bobby Brown,PG,19,58,8,18,11,40,Center,10,Jump Shot,20.844827586206897
2003-04,1517,Bobby Jackson,SG,263,592,182,373,81,219,Center,11,Jump Shot,15.190878378378379
2004-05,1517,Bobby Jackson,SG,109,255,76,159,33,96,Center,3,Jump Shot,15.086274509803921
2005-06,1517,Bobby Jackson,PG,286,748,157,416,129,332,Center,11,Jump Shot,15.836898395721924
2006-07,1517,Bobby Jackson,SG,204,518,150,353,54,165,Center,10,Jump Shot,13.318532818532818
2007-08,1517,Bobby Jackson,SG-PG,204,506,123,280,81,226,Center,4,Jump Shot,17.156126482213438
2008-09,1517,Bobby Jackson,PG,193,484,133,288,60,196,Center,13,Jump Shot,16.115702479338843
2006-07,200784,Bobby Jones,SF,43,93,42,84,1,9,Center,4,Jump Shot,8.946236559139784
2007-08,200784,Bobby Jones,SF,60,140,42,87,18,53,Center,11,Jump Shot,12.042857142857143
2015-16,1626171,Bobby Portis,PF,186,436,170,384,16,52,Center,11,Jump Shot,10.541284403669724
2016-17,1626171,Bobby Portis,PF,183,375,151,279,32,96,Center,12,Jump Shot,12.704
2017-18,1626171,Bobby Portis,PF,382,811,302,588,80,223,Center,5,Jump Shot,11.903822441430332
2018-19,1626171,Bobby Portis,PF,279,628,204,437,75,191,Center,9,Jump Shot,12.138535031847134
2019-20,1626171,Bobby Portis,PF,265,589,198,402,67,187,Center,10,Jump Shot,13.419354838709678
2020-21,1626171,Bobby Portis,C,313,598,239,441,74,157,Center,9,Jump Shot,11.921404682274247
2021-22,1626171,Bobby Portis,C,417,871,284,533,133,338,Center,5,Jump Shot,13.988518943742823
2022-23,1626171,Bobby Portis,PF,398,803,303,546,95,257,Center,3,Jump Shot,12.840597758405977
2003-04,2250,Bobby Simmons,SF,147,373,145,361,2,12,Center,10,Jump Shot,9.541554959785524
2004-05,2250,Bobby Simmons,SF,474,1017,424,902,50,115,Center,26,Jump Shot,14.932153392330383
2005-06,2250,Bobby Simmons,SF,366,808,261,558,105,250,Center,15,Jump Shot,14.846534653465346
2007-08,2250,Bobby Simmons,SF,209,496,149,325,60,171,Center,12,Jump Shot,16.18951612903226
2008-09,2250,Bobby Simmons,SF,198,441,81,179,117,262,Left Side,6,Jump Shot,17.961451247165535
2009-10,2250,Bobby Simmons,PF,42,117,22,54,20,63,Center,1,Jump Shot,18.692307692307693
2010-11,2250,Bobby Simmons,SF,0,3,0,0,0,3,Right Side Center,0,Jump Shot,23.666666666666668
2011-12,2250,Bobby Simmons,SF,28,90,8,30,20,60,Right Side,1,Jump Shot,19.27777777777778
2017-18,203992,Bogdan Bogdanovic,SG,344,772,215,443,129,329,Center,13,Jump Shot,16.726683937823836
2018-19,203992,Bogdan Bogdanovic,SG,361,863,227,491,134,372,Center,13,Jump Shot,15.705677867902665
2019-20,203992,Bogdan Bogdanovic,SG,337,766,173,325,164,441,Center,10,Jump Shot,18.02219321148825
2020-21,203992,Bogdan Bogdanovic,SG,267,565,121,232,146,333,Center,8,Jump Shot,18.212389380530972
2021-22,203992,Bogdan Bogdanovic,SG,342,794,173,335,169,459,Center,11,Jump Shot,18.138539042821158
2022-23,203992,Bogdan Bogdanovic,SG,273,611,127,251,146,360,Center,3,Jump Shot,18.57937806873977
2014-15,202711,Bojan Bogdanovic,SF,261,576,170,320,91,256,Center,5,Jump Shot,14.06076388888889
2015-16,202711,Bojan Bogdanovic,SF,324,748,195,411,129,337,Center,14,Jump Shot,14.27139037433155
2016-17,202711,Bojan Bogdanovic,SF,375,844,232,453,143,391,Center,20,Jump Shot,14.604265402843602
2017-18,202711,Bojan Bogdanovic,SF,404,852,249,466,155,386,Center,12,Jump Shot,14.656103286384976
2018-19,202711,Bojan Bogdanovic,SF,522,1051,358,665,164,386,Center,17,Jump Shot,12.987630827783065
2019-20,202711,Bojan Bogdanovic,SF,418,935,229,478,189,457,Center,20,Jump Shot,14.911229946524065
2020-21,202711,Bojan Bogdanovic,SF,406,925,226,464,180,461,Center,5,Jump Shot,14.865945945945946
2021-22,202711,Bojan Bogdanovic,PF,422,928,241,460,181,468,Center,14,Jump Shot,15.112068965517242
2022-23,202711,Bojan Bogdanovic,PF,430,882,285,529,145,353,Center,16,Jump Shot,14.723356009070296
2019-20,1629626,Bol Bol,PF,14,28,10,19,4,9,Center,2,Jump Shot,11.607142857142858
2020-21,1629626,Bol Bol,PF,25,58,16,34,9,24,Center,10,Jump Shot,15.586206896551724
2021-22,1629626,Bol Bol,PF,15,27,14,23,1,4,Center,3,Jump Shot,10.0
2022-23,1629626,Bol Bol,PF,261,478,231,365,30,113,Center,8,Jump Shot,10.186192468619247
2021-22,1630538,Bones Hyland,SG,230,571,99,213,131,358,Center,5,Jump Shot,18.90017513134851
2022-23,1630538,Bones Hyland,PG,228,571,111,256,117,315,Center,5,Jump Shot,17.07355516637478
2005-06,101238,Boniface Ndong,C,22,53,22,52,0,1,Center,3,Jump Shot,9.735849056603774
2003-04,1719,Bonzi Wells,SG,363,850,341,781,22,69,Center,13,Jump Shot,10.323529411764707
2004-05,1719,Bonzi Wells,SG,272,617,236,513,36,104,Center,4,Jump Shot,10.230145867098866
2005-06,1719,Bonzi Wells,SG,284,613,274,568,10,45,Center,11,Jump Shot,7.7765089722675365
2006-07,1719,Bonzi Wells,SF,85,207,84,200,1,7,Center,0,Jump Shot,7.874396135265701
2007-08,1719,Bonzi Wells,SG,252,569,240,519,12,50,Center,10,Jump Shot,8.778558875219684
2018-19,1629045,Bonzie Colson,SF,13,39,8,18,5,21,Center,1,Jump Shot,15.717948717948717
2003-04,2564,Boris Diaw,SG,140,313,134,287,6,26,Center,2,Jump Shot,8.172523961661343
2004-05,2564,Boris Diaw,SG,124,294,115,244,9,50,Center,11,Jump Shot,11.608843537414966
2005-06,2564,Boris Diaw,PF,449,853,441,823,8,30,Center,9,Jump Shot,8.05978898007034
2006-07,2564,Boris Diaw,PF,306,569,291,524,15,45,Center,14,Jump Shot,9.516695957820739
2007-08,2564,Boris Diaw,PF,308,646,295,605,13,41,Center,5,Jump Shot,10.297213622291022
2008-09,2564,Boris Diaw,PF,448,884,373,703,75,181,Center,13,Jump Shot,10.085972850678733
2009-10,2564,Boris Diaw,PF,373,773,307,567,66,206,Center,15,Jump Shot,11.260025873221217
2010-11,2564,Boris Diaw,PF,381,774,303,548,78,226,Center,13,Jump Shot,12.241602067183463
2011-12,2564,Boris Diaw,PF,156,351,125,252,31,99,Center,5,Jump Shot,12.131054131054132
2012-13,2564,Boris Diaw,PF,179,332,149,254,30,78,Center,4,Jump Shot,10.768072289156626
2013-14,2564,Boris Diaw,PF,302,580,257,468,45,112,Center,9,Jump Shot,10.23793103448276
2014-15,2564,Boris Diaw,PF,291,631,237,463,54,168,Center,3,Jump Shot,11.088748019017432
2015-16,2564,Boris Diaw,PF,202,383,177,314,25,69,Center,2,Jump Shot,8.671018276762402
2016-17,2564,Boris Diaw,PF,146,327,126,246,20,81,Center,3,Jump Shot,11.042813455657493
2003-04,2411,Bostjan Nachbar,SF,47,132,24,69,23,63,Center,6,Jump Shot,15.507575757575758
2004-05,2411,Bostjan Nachbar,PF-SF,161,411,86,215,75,196,Center,8,Jump Shot,15.873479318734793
2005-06,2411,Bostjan Nachbar,PF-SF,54,156,35,85,19,71,Center,2,Jump Shot,15.903846153846153
2006-07,2411,Bostjan Nachbar,SF,226,495,114,230,112,265,Center,7,Jump Shot,15.985858585858585
2007-08,2411,Bostjan Nachbar,PF,245,609,151,347,94,262,Center,18,Jump Shot,14.55336617405583
2005-06,101152,Bracey Wright,SG,21,51,15,34,6,17,Center,2,Jump Shot,16.705882352941178
2006-07,101152,Bracey Wright,SG,24,60,18,40,6,20,Left Side,4,Jump Shot,16.683333333333334
2003-04,1802,Brad Miller,PF,373,731,361,693,12,38,Center,10,Jump Shot,9.655266757865936
2004-05,1802,Brad Miller,C,319,609,314,590,5,19,Center,12,Jump Shot,9.16256157635468
2005-06,1802,Brad Miller,C,434,877,400,789,34,88,Center,14,Jump Shot,12.898517673888255
2006-07,1802,Brad Miller,C,224,494,219,461,5,33,Center,7,Jump Shot,13.105263157894736
2007-08,1802,Brad Miller,C,337,728,309,638,28,90,Center,6,Jump Shot,11.678571428571429
2008-09,1802,Brad Miller,C,292,614,269,558,23,56,Center,8,Jump Shot,10.213355048859935
2009-10,1802,Brad Miller,C,250,581,213,449,37,132,Center,4,Jump Shot,12.23407917383821
2010-11,1802,Brad Miller,C,132,296,92,189,40,107,Center,5,Jump Shot,14.364864864864865
2011-12,1802,Brad Miller,C,9,27,2,12,7,15,Center,0,Jump Shot,18.296296296296298
2018-19,202954,Brad Wanamaker,PG,50,105,34,66,16,39,Center,5,Jump Shot,14.761904761904763
2019-20,202954,Brad Wanamaker,PG,162,362,125,260,37,102,Center,9,Jump Shot,11.743093922651934
2020-21,202954,Brad Wanamaker,PG,115,299,99,214,16,85,Center,3,Driving Layup Shot,11.789297658862877
2021-22,202954,Brad Wanamaker,PG,28,77,24,60,4,17,Center,0,Pullup Jump shot,12.909090909090908
2012-13,203078,Bradley Beal,SG,282,687,191,451,91,236,Center,17,Jump Shot,16.068413391557495
2013-14,203078,Bradley Beal,SG,481,1149,343,806,138,343,Center,15,Jump Shot,16.16971279373368
2014-15,203078,Bradley Beal,SG,363,851,257,592,106,259,Center,17,Jump Shot,14.949471210340775
2015-16,203078,Bradley Beal,SG,359,798,254,528,105,270,Center,9,Jump Shot,14.523809523809524
2016-17,203078,Bradley Beal,SG,636,1320,414,770,222,550,Center,29,Jump Shot,15.324242424242424
2017-18,203078,Bradley Beal,SG,683,1484,484,954,199,530,Center,28,Jump Shot,15.194070080862534
2018-19,203078,Bradley Beal,SG,764,1609,555,1013,209,596,Center,33,Jump Shot,14.245494095711623
2019-20,203078,Bradley Beal,SG,593,1303,423,822,170,481,Center,20,Jump Shot,14.18188795088258
2020-21,203078,Bradley Beal,SG,670,1382,540,1009,130,373,Center,24,Jump Shot,12.811866859623734
2021-22,203078,Bradley Beal,SG,348,771,285,561,63,210,Center,6,Pullup Jump shot,12.543450064850843
2022-23,203078,Bradley Beal,SG,444,878,364,659,80,219,Center,20,Pullup Jump shot,12.38610478359909
2007-08,201148,Brandan Wright,PF,62,112,62,112,0,0,Center,3,Jump Shot,4.964285714285714
2008-09,201148,Brandan Wright,PF,130,246,130,242,0,4,Center,1,Jump Shot,5.085365853658536
2010-11,201148,Brandan Wright,PF,60,117,60,117,0,0,Center,3,Jump Shot,5.111111111111111
2011-12,201148,Brandan Wright,C,144,233,144,232,0,1,Center,14,Jump Shot,3.4721030042918457
2012-13,201148,Brandan Wright,C,241,404,241,401,0,3,Center,10,Jump Shot,5.836633663366337
2013-14,201148,Brandan Wright,C,224,331,224,331,0,0,Center,9,Jump Shot,3.471299093655589
2014-15,201148,Brandan Wright,PF,233,363,233,360,0,3,Center,7,Jump Shot,3.349862258953168
2015-16,201148,Brandan Wright,PF,35,52,35,52,0,0,Center,2,Jump Shot,4.230769230769231
2016-17,201148,Brandan Wright,PF,83,135,83,134,0,1,Center,6,Jump Shot,3.437037037037037
2017-18,201148,Brandan Wright,PF,59,102,59,102,0,0,Center,1,Hook Shot,3.2450980392156863
2015-16,1626183,Branden Dawson,PF,2,5,2,5,0,0,Center,0,Layup Shot,2.8
2004-05,2688,Brandin Knight,PG,0,1,0,1,0,0,Center,0,Layup Shot,0.0
2003-04,2220,Brandon Armstrong,SG,65,175,46,123,19,52,Center,14,Jump Shot,16.908571428571427
2005-06,101138,Brandon Bass,PF,28,70,28,70,0,0,Center,5,Jump Shot,6.357142857142857
2006-07,101138,Brandon Bass,PF,15,44,15,43,0,1,Center,5,Jump Shot,7.386363636363637
2007-08,101138,Brandon Bass,C,246,493,246,489,0,4,Center,4,Jump Shot,8.720081135902637
2008-09,101138,Brandon Bass,C,252,508,252,502,0,6,Center,6,Jump Shot,8.736220472440944
2009-10,101138,Brandon Bass,PF,119,233,119,233,0,0,Center,7,Jump Shot,8.334763948497853
2010-11,101138,Brandon Bass,PF,332,645,332,643,0,2,Center,6,Jump Shot,9.944186046511629
2011-12,101138,Brandon Bass,PF,303,632,303,632,0,0,Center,5,Jump Shot,11.270569620253164
2012-13,101138,Brandon Bass,PF,286,589,286,587,0,2,Center,9,Jump Shot,10.826825127334466
2013-14,101138,Brandon Bass,PF,352,725,350,719,2,6,Center,8,Jump Shot,8.815172413793103
2014-15,101138,Brandon Bass,PF,344,683,335,651,9,32,Center,9,Jump Shot,9.159590043923865
2015-16,101138,Brandon Bass,PF,174,317,174,315,0,2,Center,13,Jump Shot,5.116719242902208
2016-17,101138,Brandon Bass,PF,107,186,106,183,1,3,Center,8,Jump Shot,6.424731182795699
2021-22,1630527,Brandon Boston,SG,125,325,91,214,34,111,Center,12,Pullup Jump shot,14.236923076923077
2022-23,1630527,Brandon Boston Jr.,SG,51,122,39,93,12,29,Center,13,Pullup Jump shot,12.098360655737705
2019-20,1629634,Brandon Clarke,PF,296,479,273,415,23,64,Center,12,Jump Shot,7.127348643006263
2020-21,1629634,Brandon Clarke,PF,256,495,236,418,20,77,Center,8,Jump Shot,7.537373737373738
2021-22,1629634,Brandon Clarke,PF,288,447,283,425,5,22,Center,8,Floating Jump shot,5.029082774049217
2022-23,1629634,Brandon Clarke,PF,229,349,228,343,1,6,Center,4,Floating Jump shot,4.66189111747851
2013-14,203561,Brandon Davies,PF,54,128,52,118,2,10,Center,2,Jump Shot,7.03125
2014-15,203561,Brandon Davies,PF,55,137,47,103,8,34,Center,1,Jump Shot,11.072992700729927
2018-19,1629164,Brandon Goodwin,PG,6,23,4,17,2,6,Center,5,Jump Shot,11.652173913043478
2019-20,1629164,Brandon Goodwin,PG,76,190,50,103,26,87,Center,9,Jump Shot,15.3
2020-21,1629164,Brandon Goodwin,PG,84,223,52,120,32,103,Center,9,Jump Shot,15.61883408071749
2021-22,1629164,Brandon Goodwin,PG,64,154,45,99,19,55,Center,5,Jump Shot,13.383116883116884
2003-04,2599,Brandon Hunter,PF,53,116,53,113,0,3,Center,9,Layup Shot,4.5344827586206895
2004-05,2599,Brandon Hunter,PF,37,73,37,73,0,0,Center,11,Layup Shot,3.5616438356164384
2016-17,1627742,Brandon Ingram,SF,275,681,221,499,54,182,Center,6,Jump Shot,12.374449339207048
2017-18,1627742,Brandon Ingram,SF,358,761,317,656,41,105,Center,14,Jump Shot,10.074901445466491
2018-19,1627742,Brandon Ingram,SF,362,729,331,635,31,94,Center,5,Jump Shot,9.62002743484225
2019-20,1627742,Brandon Ingram,PF,507,1096,357,712,150,384,Center,24,Jump Shot,13.674270072992702
2020-21,1627742,Brandon Ingram,SF,513,1101,370,726,143,375,Center,19,Jump Shot,15.420526793823797
2021-22,1627742,Brandon Ingram,SF,453,983,379,757,74,226,Center,21,Jump Shot,14.15971515768057
2022-23,1627742,Brandon Ingram,SF,404,835,340,671,64,164,Center,19,Pullup Jump shot,13.21197604790419
2009-10,201943,Brandon Jennings,PG,451,1216,306,828,145,388,Center,21,Jump Shot,14.449013157894736
2010-11,201943,Brandon Jennings,PG,361,926,263,623,98,303,Center,7,Jump Shot,13.755939524838013
2011-12,201943,Brandon Jennings,PG,468,1120,340,733,128,387,Center,21,Jump Shot,13.516964285714286
2012-13,201943,Brandon Jennings,PG,497,1247,324,786,173,461,Center,16,Jump Shot,14.643143544506817
2013-14,201943,Brandon Jennings,PG,423,1135,269,678,154,457,Center,20,Jump Shot,15.420264317180617
2014-15,201943,Brandon Jennings,PG,218,543,142,332,76,211,Center,8,Jump Shot,14.082872928176796
2015-16,201943,Brandon Jennings,PG,112,304,61,149,51,155,Center,11,Jump Shot,17.37828947368421
2016-17,201943,Brandon Jennings,PG,192,535,113,283,79,252,Center,5,Jump Shot,15.91214953271028
2017-18,201943,Brandon Jennings,PG,27,72,18,39,9,33,Center,1,Jump Shot,16.88888888888889
2011-12,202688,Brandon Knight,PG,319,769,214,493,105,276,Center,17,Jump Shot,14.057217165149545
2012-13,202688,Brandon Knight,PG,357,878,237,551,120,327,Center,16,Jump Shot,13.809794988610479
2013-14,202688,Brandon Knight,PG,461,1092,351,754,110,338,Center,26,Jump Shot,13.195054945054945
2014-15,202688,Brandon Knight,PG-SG,375,888,250,567,125,321,Center,25,Jump Shot,14.635135135135135
2015-16,202688,Brandon Knight,SG,371,894,251,544,120,350,Center,14,Jump Shot,15.48993288590604
2016-17,202688,Brandon Knight,SG,209,525,164,386,45,139,Center,3,Jump Shot,13.219047619047618
2018-19,202688,Brandon Knight,PG,99,260,58,131,41,129,Center,0,Jump Shot,17.076923076923077
2019-20,202688,Brandon Knight,SG-PG,59,167,14,36,45,131,Center,5,Jump Shot,21.580838323353294
2021-22,202688,Brandon Knight,PG,10,25,6,8,4,17,Center,1,Jump Shot,18.8
2017-18,203464,Brandon Paul,SG,55,127,40,73,15,54,Center,12,Jump Shot,14.094488188976378
2006-07,200750,Brandon Roy,SG,349,765,294,619,55,146,Center,15,Jump Shot,11.934640522875817
2007-08,200750,Brandon Roy,SG,531,1170,458,955,73,215,Center,17,Jump Shot,12.722222222222221
2008-09,200750,Brandon Roy,SG,633,1318,550,1098,83,220,Center,37,Jump Shot,11.166160849772382
2009-10,200750,Brandon Roy,SG,491,1038,418,817,73,221,Center,30,Jump Shot,13.228323699421965
2010-11,200750,Brandon Roy,SG,208,522,171,409,37,113,Center,10,Jump Shot,13.555555555555555
2012-13,200750,Brandon Roy,SG,11,35,11,26,0,9,Center,0,Jump Shot,14.542857142857143
2008-09,201575,Brandon Rush,SG,243,575,165,366,78,209,Center,8,Jump Shot,15.474782608695651
2009-10,201575,Brandon Rush,SG,297,702,173,400,124,302,Center,11,Jump Shot,15.964387464387464
2010-11,201575,Brandon Rush,SG,217,515,124,292,93,223,Center,8,Jump Shot,16.737864077669904
2011-12,201575,Brandon Rush,SF,235,469,136,250,99,219,Center,7,Jump Shot,15.603411513859275
2012-13,201575,Brandon Rush,SF,6,9,6,7,0,2,Center,0,Jump Shot,10.666666666666666
2013-14,201575,Brandon Rush,SG,30,90,14,43,16,47,Center,3,Jump Shot,18.522222222222222
2014-15,201575,Brandon Rush,SG,11,54,8,27,3,27,Center,3,Jump Shot,17.48148148148148
2015-16,201575,Brandon Rush,SG,110,259,46,103,64,156,Center,7,Jump Shot,17.575289575289574
2016-17,201575,Brandon Rush,SG,70,187,26,73,44,114,Left Side,0,Jump Shot,17.566844919786096
2018-19,1629102,Brandon Sampson,SG,28,60,17,31,11,29,Center,5,Jump Shot,14.083333333333334
2021-22,1630314,Brandon Williams,PG,105,282,74,176,31,106,Center,4,Jump Shot,13.53191489361702
2021-22,1630296,Braxton Key,SF,33,72,27,51,6,21,Center,0,Jump Shot,10.555555555555555
2022-23,1630296,Braxton Key,SF,1,1,1,1,0,0,Right Side,0,Pullup Jump shot,14.0
2003-04,2217,Brendan Haywood,C,200,388,200,387,0,1,Center,4,Jump Shot,4.234536082474227
2004-05,2217,Brendan Haywood,C,239,427,239,427,0,0,Center,2,Jump Shot,3.4028103044496487
2005-06,2217,Brendan Haywood,C,222,432,222,432,0,0,Center,5,Layup Shot,3.3449074074074074
2006-07,2217,Brendan Haywood,C,198,355,198,355,0,0,Center,1,Layup Shot,2.9971830985915493
2007-08,2217,Brendan Haywood,C,316,599,316,599,0,0,Center,8,Jump Shot,3.993322203672788
2008-09,2217,Brendan Haywood,C,24,50,24,50,0,0,Center,0,Layup Shot,3.74
2009-10,2217,Brendan Haywood,C,276,491,276,490,0,1,Center,10,Layup Shot,2.5987780040733197
2010-11,2217,Brendan Haywood,C,128,223,128,222,0,1,Center,1,Layup Shot,3.1210762331838566
2011-12,2217,Brendan Haywood,C,118,228,118,228,0,0,Center,1,Jump Shot,3.267543859649123
2012-13,2217,Brendan Haywood,C,93,216,93,215,0,1,Center,2,Jump Shot,5.527777777777778
2014-15,2217,Brendan Haywood,C,14,30,14,30,0,0,Center,6,Jump Shot,6.233333333333333
2003-04,699,Brent Barry,SG,215,427,101,175,114,252,Center,3,Jump Shot,17.407494145199063
2004-05,699,Brent Barry,SG,194,459,94,179,100,280,Center,9,Jump Shot,17.823529411764707
2005-06,699,Brent Barry,SG,156,345,76,143,80,202,Center,8,Jump Shot,17.594202898550726
2006-07,699,Brent Barry,SG,202,425,74,138,128,287,Center,9,Jump Shot,19.291764705882354
2007-08,699,Brent Barry,SF,77,160,29,48,48,112,Center,3,Jump Shot,19.95625
2008-09,699,Brent Barry,SG,70,172,21,41,49,131,Right Side Center,2,Jump Shot,20.674418604651162
2003-04,1510,Brevin Knight,PG,105,246,103,238,2,8,Center,4,Jump Shot,12.869918699186991
2004-05,1510,Brevin Knight,PG,248,587,245,567,3,20,Center,13,Jump Shot,12.739352640545144
2005-06,1510,Brevin Knight,PG,308,772,305,759,3,13,Center,15,Jump Shot,11.843264248704664
2006-07,1510,Brevin Knight,PG,152,363,151,345,1,18,Center,5,Jump Shot,14.735537190082646
2007-08,1510,Brevin Knight,PG,138,342,138,336,0,6,Center,2,Jump Shot,15.260233918128655
2008-09,1510,Brevin Knight,PG,66,189,66,183,0,6,Center,4,Jump Shot,15.291005291005291
2019-20,1628968,Brian Bowen II,SF,3,10,3,8,0,2,Center,3,Jump Shot,9.5
2020-21,1628968,Brian Bowen II,SF,1,4,1,3,0,1,Center,0,Jump Shot,16.25
2003-04,2073,Brian Cardinal,PF,220,466,165,342,55,124,Center,10,Jump Shot,13.358369098712446
2004-05,2073,Brian Cardinal,PF,160,432,116,307,44,125,Center,3,Jump Shot,14.152777777777779
2005-06,2073,Brian Cardinal,PF,46,111,33,82,13,29,Center,2,Jump Shot,14.54054054054054
2006-07,2073,Brian Cardinal,PF,42,85,24,41,18,44,Center,1,Jump Shot,17.44705882352941
2007-08,2073,Brian Cardinal,PF,43,126,18,45,25,81,Center,4,Jump Shot,18.571428571428573
2008-09,2073,Brian Cardinal,PF,65,169,35,77,30,92,Center,2,Jump Shot,18.236686390532544
2009-10,2073,Brian Cardinal,PF,14,36,11,27,3,9,Center,0,Jump Shot,15.86111111111111
2010-11,2073,Brian Cardinal,SF,43,100,1,13,42,87,Left Side,0,Jump Shot,21.87
2011-12,2073,Brian Cardinal,SF,14,55,4,6,10,49,Right Side,1,Jump Shot,22.12727272727273
2003-04,2567,Brian Cook,C,67,141,67,136,0,5,Center,5,Jump Shot,12.46808510638298
2004-05,2567,Brian Cook,C,176,422,98,223,78,199,Center,12,Jump Shot,17.518957345971565
2005-06,2567,Brian Cook,PF,261,511,225,427,36,84,Center,8,Jump Shot,13.720156555772995
2006-07,2567,Brian Cook,PF,185,408,139,293,46,115,Center,2,Jump Shot,15.269607843137255
2007-08,2567,Brian Cook,PF,88,234,45,119,43,115,Center,1,Jump Shot,17.299145299145298
2008-09,2567,Brian Cook,PF,28,76,15,46,13,30,Center,6,Jump Shot,16.842105263157894
2009-10,2567,Brian Cook,PF,7,23,5,14,2,9,Center,5,Jump Shot,15.304347826086957
2010-11,2567,Brian Cook,PF,72,170,38,91,34,79,Center,8,Jump Shot,16.941176470588236
2011-12,2567,Brian Cook,PF,31,98,21,48,10,50,Center,5,Jump Shot,18.377551020408163
2003-04,258,Brian Grant,C,289,613,289,612,0,1,Center,9,Jump Shot,10.880913539967374
2004-05,258,Brian Grant,C,103,209,103,209,0,0,Center,2,Jump Shot,8.24401913875598
2005-06,258,Brian Grant,C,27,65,27,65,0,0,Center,0,Jump Shot,13.153846153846153
2012-13,203148,Brian Roberts,PG,213,511,154,358,59,153,Center,20,Jump Shot,15.818003913894325
2013-14,203148,Brian Roberts,PG,244,581,180,403,64,178,Center,20,Jump Shot,16.03958691910499
2014-15,203148,Brian Roberts,PG,176,452,114,259,62,193,Center,9,Jump Shot,18.055309734513273
2015-16,203148,Brian Roberts,PG,74,165,59,123,15,42,Center,12,Jump Shot,14.860606060606061
2016-17,203148,Brian Roberts,PG,46,122,29,78,17,44,Center,6,Jump Shot,15.71311475409836
2003-04,2243,Brian Scalabrine,PF,86,218,76,177,10,41,Center,7,Jump Shot,13.426605504587156
2004-05,2243,Brian Scalabrine,PF,132,332,110,264,22,68,Center,6,Jump Shot,12.162650602409638
2005-06,2243,Brian Scalabrine,PF,74,193,43,106,31,87,Center,6,Jump Shot,17.17616580310881
2006-07,2243,Brian Scalabrine,PF,77,191,33,81,44,110,Center,0,Jump Shot,19.240837696335078
2007-08,2243,Brian Scalabrine,PF,29,94,14,48,15,46,Center,4,Jump Shot,16.606382978723403
2008-09,2243,Brian Scalabrine,C,48,114,24,53,24,61,Left Side,4,Jump Shot,18.482456140350877
2009-10,2243,Brian Scalabrine,PF,29,85,13,36,16,49,Right Side,2,Jump Shot,19.235294117647058
2010-11,2243,Brian Scalabrine,PF,10,19,10,14,0,5,Right Side,3,Jump Shot,18.05263157894737
2011-12,2243,Brian Scalabrine,PF,14,30,13,23,1,7,Center,9,Jump Shot,12.466666666666667
2003-04,1730,Brian Skinner,C,255,513,255,513,0,0,Center,2,Jump Shot,5.734892787524366
2004-05,1730,Brian Skinner,C-PF,104,205,104,204,0,1,Center,0,Jump Shot,4.4487804878048784
2005-06,1730,Brian Skinner,PF-C,82,160,82,160,0,0,Center,4,Layup Shot,4.6875
2006-07,1730,Brian Skinner,PF,124,253,124,253,0,0,Center,1,Layup Shot,4.5770750988142295
2007-08,1730,Brian Skinner,C,92,198,90,195,2,3,Center,0,Jump Shot,9.853535353535353
2008-09,1730,Brian Skinner,PF,92,205,92,203,0,2,Center,0,Jump Shot,7.35609756097561
2009-10,1730,Brian Skinner,PF,10,25,10,25,0,0,Center,0,Jump Shot,7.08
2011-12,1730,Brian Skinner,C,0,1,0,1,0,0,Center,0,Turnaround Bank shot,7.0
2015-16,1627362,Briante Weber,PG,14,39,14,34,0,5,Center,3,Jump Shot,13.23076923076923
2016-17,1627362,Briante Weber,PG,25,60,24,50,1,10,Center,6,Jump Shot,10.766666666666667
2017-18,1627362,Briante Weber,PG,19,43,15,32,4,11,Center,1,Pullup Jump shot,11.767441860465116
2016-17,1627744,Brice Johnson,PF,2,7,2,7,0,0,Center,2,Layup Shot,5.142857142857143
2017-18,1627744,Brice Johnson,PF,20,42,20,41,0,1,Center,7,Jump Shot,8.976190476190476
2003-04,2639,Britton Johnsen,C,17,59,16,47,1,12,Center,1,Jump Shot,11.932203389830509
2004-05,2639,Britton Johnsen,SF,6,22,6,18,0,4,Center,1,Jump Shot,13.5
2020-21,1630271,Brodric Thomas,SG,39,108,23,49,16,59,Center,4,Jump Shot,16.962962962962962
2021-22,1630271,Brodric Thomas,SG,8,18,6,9,2,9,Center,2,Jump Shot,14.0
2008-09,201572,Brook Lopez,C,448,844,448,842,0,2,Center,17,Jump Shot,5.420616113744076
2009-10,201572,Brook Lopez,C,563,1129,563,1127,0,2,Center,18,Jump Shot,6.348981399468556
2010-11,201572,Brook Lopez,C,644,1309,644,1308,0,1,Center,20,Jump Shot,7.860198624904507
2011-12,201572,Brook Lopez,C,38,77,38,77,0,0,Center,0,Jump Shot,7.064935064935065
2012-13,201572,Brook Lopez,C,570,1094,570,1093,0,1,Center,16,Jump Shot,6.89945155393053
2013-14,201572,Brook Lopez,C,129,229,129,228,0,1,Center,1,Jump Shot,7.296943231441048
2014-15,201572,Brook Lopez,C,506,987,505,977,1,10,Center,10,Jump Shot,7.938196555217832
2015-16,201572,Brook Lopez,C,591,1157,589,1143,2,14,Center,17,Jump Shot,7.802938634399308
2016-17,201572,Brook Lopez,C,555,1172,421,785,134,387,Center,17,Jump Shot,12.150170648464163
2017-18,201572,Brook Lopez,C,369,793,257,468,112,325,Center,3,Jump Shot,14.189155107187894
2018-19,201572,Brook Lopez,C,355,786,168,274,187,512,Center,5,Jump Shot,18.701017811704833
2019-20,201572,Brook Lopez,C,292,671,190,346,102,325,Center,4,Jump Shot,15.068554396423249
2020-21,201572,Brook Lopez,C,322,640,227,359,95,281,Center,11,Jump Shot,13.784375
2021-22,201572,Brook Lopez,C,61,131,42,78,19,53,Center,0,Jump Shot,12.763358778625955
2022-23,201572,Brook Lopez,C,477,899,341,535,136,364,Center,13,Jump Shot,13.567296996662959
2003-04,1477,Bruce Bowen,SF,211,502,134,290,77,212,Left Side,6,Jump Shot,14.615537848605578
2004-05,1477,Bruce Bowen,SF,251,598,149,345,102,253,Left Side,3,Jump Shot,15.535117056856187
2005-06,1477,Bruce Bowen,SF,232,536,128,291,104,245,Left Side,7,Jump Shot,16.421641791044777
2006-07,1477,Bruce Bowen,SF,189,467,100,235,89,232,Left Side,7,Jump Shot,17.719486081370448
2007-08,1477,Bruce Bowen,SF,174,428,84,213,90,215,Left Side,3,Jump Shot,17.873831775700936
2008-09,1477,Bruce Bowen,SF,78,186,37,89,41,97,Right Side,1,Jump Shot,17.543010752688172
2018-19,1628971,Bruce Brown,SG,125,314,101,221,24,93,Center,6,Jump Shot,9.703821656050955
2019-20,1628971,Bruce Brown,PG,198,447,165,351,33,96,Center,5,Jump Shot,7.993288590604027
2020-21,1628971,Bruce Brown,PG,235,423,218,364,17,59,Center,10,Jump Shot,5.93144208037825
2021-22,1628971,Bruce Brown,SF,256,506,218,412,38,94,Center,9,Jump Shot,7.954545454545454
2022-23,1628971,Bruce Brown,SG,358,741,267,487,91,254,Center,11,Jump Shot,11.73549257759784
2014-15,203998,Bruno Caboclo,SF,4,12,2,9,2,3,Center,1,Jump Shot,10.25
2015-16,203998,Bruno Caboclo,SF,1,12,0,5,1,7,Left Side,0,Jump Shot,18.916666666666668
2016-17,203998,Bruno Caboclo,SF,6,16,4,10,2,6,Center,2,Jump Shot,13.3125
2017-18,203998,Bruno Caboclo,SF,9,31,6,14,3,17,Center,1,Jump Shot,16.580645161290324
2018-19,203998,Bruno Caboclo,PF,96,225,48,95,48,130,Center,4,Jump Shot,15.266666666666667
2019-20,203998,Bruno Caboclo,C,38,89,32,56,6,33,Center,4,Jump Shot,11.370786516853933
2020-21,203998,Bruno Caboclo,PF,8,17,8,12,0,5,Center,6,Layup Shot,9.235294117647058
2019-20,1628981,Bruno Fernando,C,103,199,98,162,5,37,Center,5,Jump Shot,6.567839195979899
2020-21,1628981,Bruno Fernando,C,18,44,18,42,0,2,Center,2,Reverse Layup Shot,4.0227272727272725
2021-22,1628981,Bruno Fernando,C,36,55,35,53,1,2,Center,8,Layup Shot,3.4727272727272727
2022-23,1628981,Bruno Fernando,C,59,112,59,108,0,4,Center,3,Tip Layup Shot,3.8125
2003-04,1743,Bruno Sundov,C,4,10,4,10,0,0,Center,1,Jump Shot,8.1
2004-05,1743,Bruno Sundov,C,11,37,10,34,1,3,Center,4,Jump Shot,13.864864864864865
2014-15,203955,Bryce Cotton,PG,29,69,22,49,7,20,Center,4,Jump Shot,15.826086956521738
2015-16,203955,Bryce Cotton,PG,4,10,4,7,0,3,Center,2,Jump Shot,15.5
2015-16,1626214,Bryce Dejean-Jones,SG,28,69,16,37,12,32,Center,1,Jump Shot,15.27536231884058
2003-04,1724,Bryce Drew,PG,4,18,3,11,1,7,Left Side,2,Jump Shot,17.944444444444443
2022-23,1631121,Bryce McGowens,SG,80,202,54,122,26,80,Center,3,Jump Shot,12.490099009900991
2016-17,1627854,Bryn Forbes,SG,36,99,19,46,17,53,Left Side Center,2,Jump Shot,19.78787878787879
2017-18,1627854,Bryn Forbes,SG,209,497,120,269,89,228,Center,6,Jump Shot,17.452716297786722
2018-19,1627854,Bryn Forbes,SG,361,791,185,378,176,413,Center,12,Jump Shot,18.214917825537295
2019-20,1627854,Bryn Forbes,SG,242,581,94,200,148,381,Center,12,Jump Shot,20.50602409638554
2020-21,1627854,Bryn Forbes,SG,250,529,96,188,154,341,Center,10,Jump Shot,20.46124763705104
2021-22,1627854,Bryn Forbes,SG,231,539,109,244,122,295,Center,14,Jump Shot,18.98330241187384
2022-23,1627854,Bryn Forbes,SG,30,83,16,37,14,46,Center,3,Jump Shot,18.44578313253012
2003-04,935,Bryon Russell,SF,98,244,55,132,43,112,Center,11,Jump Shot,18.59016393442623
2004-05,935,Bryon Russell,SF,95,252,39,103,56,149,Center,6,Jump Shot,18.841269841269842
2022-23,1631205,Buddy Boeheim,PG,5,27,1,2,4,25,Right Side Center,1,Jump Shot,23.48148148148148
2016-17,1627741,Buddy Hield,SG,326,766,179,388,147,378,Center,18,Jump Shot,16.385117493472585
2017-18,1627741,Buddy Hield,SG,416,933,240,525,176,408,Center,26,Jump Shot,16.437299035369776
2018-19,1627741,Buddy Hield,SG,623,1360,345,709,278,651,Center,17,Jump Shot,16.472058823529412
2019-20,1627741,Buddy Hield,SG,498,1162,227,474,271,688,Center,25,Jump Shot,18.592943201376936
2020-21,1627741,Buddy Hield,SG,403,992,121,271,282,721,Center,13,Jump Shot,20.664314516129032
2021-22,1627741,Buddy Hield,SG,446,1098,184,382,262,716,Center,18,Jump Shot,19.18488160291439
2022-23,1627741,Buddy Hield,SF,475,1038,187,361,288,677,Center,20,Jump Shot,18.918111753371868
2009-10,201957,Byron Mullens,PF,7,19,7,19,0,0,Center,1,Jump Shot,9.526315789473685
2010-11,201957,Byron Mullens,PF,9,28,9,28,0,0,Center,2,Jump Shot,8.392857142857142
2011-12,201957,Byron Mullens,C,251,591,239,540,12,51,Center,11,Jump Shot,12.346869712351946
2012-13,201957,Byron Mullens,PF,217,563,151,355,66,208,Center,8,Jump Shot,15.381882770870337
2013-14,201957,Byron Mullens,C,73,165,40,76,33,89,Center,13,Jump Shot,16.824242424242424
2007-08,201228,C.J. Watson,PG,43,101,34,75,9,26,Center,3,Jump Shot,13.900990099009901
2008-09,201228,C.J. Watson,PG,257,562,209,442,48,120,Center,15,Jump Shot,14.325622775800712
2009-10,201228,C.J. Watson,PG,247,528,202,383,45,145,Center,14,Jump Shot,14.68560606060606
2010-11,201228,C.J. Watson,PG,146,394,102,282,44,112,Center,7,Jump Shot,16.378172588832488
2011-12,201228,C.J. Watson,PG,161,437,93,264,68,173,Center,10,Jump Shot,17.006864988558352
2012-13,201228,C.J. Watson,PG,192,459,104,245,88,214,Center,7,Jump Shot,16.55773420479303
2013-14,201228,C.J. Watson,PG,146,334,93,189,53,145,Center,1,Jump Shot,15.98502994011976
2014-15,201228,C.J. Watson,PG,181,417,111,242,70,175,Center,10,Jump Shot,16.575539568345324
2015-16,201228,C.J. Watson,PG,47,137,33,89,14,48,Center,2,Jump Shot,15.846715328467154
2016-17,201228,C.J. Watson,PG,96,248,64,143,32,105,Center,7,Jump Shot,16.608870967741936
2014-15,203912,C.J. Wilcox,SG,16,38,9,19,7,19,Left Side Center,3,Jump Shot,18.92105263157895
2015-16,203912,C.J. Wilcox,SG,26,65,17,43,9,22,Center,10,Jump Shot,16.8
2016-17,203912,C.J. Wilcox,SG,8,31,5,16,3,15,Right Side Center,3,Jump Shot,18.967741935483872
2017-18,203710,C.J. Williams,SG,87,197,65,119,22,78,Center,4,Jump Shot,14.192893401015228
2018-19,203710,C.J. Williams,SG,17,35,12,19,5,16,Center,0,Jump Shot,15.657142857142857
2020-21,1629604,CJ Elleby,SF,25,66,18,32,7,34,Center,10,Jump Shot,15.878787878787879
2021-22,1629604,CJ Elleby,SF,121,308,84,182,37,126,Center,7,Jump Shot,12.883116883116884
2013-14,203468,CJ McCollum,SG,74,178,44,98,30,80,Center,9,Jump Shot,16.786516853932586
2014-15,203468,CJ McCollum,SG,159,365,104,226,55,139,Center,13,Jump Shot,14.805479452054794
2015-16,203468,CJ McCollum,SG,641,1431,444,959,197,472,Center,24,Jump Shot,14.673654786862334
2016-17,203468,CJ McCollum,SG,692,1441,507,1002,185,439,Center,27,Jump Shot,14.610687022900763
2017-18,203468,CJ McCollum,SG,667,1505,478,1029,189,476,Center,35,Jump Shot,14.440531561461794
2018-19,203468,CJ McCollum,SG,571,1243,404,798,167,445,Center,22,Jump Shot,14.850362027353178
2019-20,203468,CJ McCollum,SG,611,1356,417,844,194,512,Center,16,Pullup Jump shot,15.02802359882006
2020-21,203468,CJ McCollum,SG,405,884,236,464,169,420,Center,13,Pullup Jump shot,17.023755656108598
2021-22,203468,CJ McCollum,SG,536,1164,354,695,182,469,Center,18,Pullup Jump shot,15.730240549828178
2022-23,203468,CJ McCollum,SG,587,1344,376,801,211,543,Center,17,Jump Shot,15.657738095238095
2005-06,101139,CJ Miles,PG,28,76,23,56,5,20,Center,7,Jump Shot,15.644736842105264
2006-07,101139,CJ Miles,SG,40,116,33,84,7,32,Center,6,Jump Shot,14.568965517241379
2007-08,101139,CJ Miles,SG,113,236,83,159,30,77,Center,11,Jump Shot,14.072033898305085
2008-09,101139,CJ Miles,SG,258,562,195,383,63,179,Center,3,Jump Shot,13.604982206405694
2009-10,101139,CJ Miles,SF,241,562,167,345,74,217,Center,10,Jump Shot,14.823843416370106
2010-11,101139,CJ Miles,SF,366,899,257,560,109,339,Center,12,Jump Shot,14.845383759733037
2011-12,101139,CJ Miles,SG,177,465,131,315,46,150,Center,8,Jump Shot,13.84731182795699
2012-13,101139,CJ Miles,SF,255,614,129,286,126,328,Center,5,Jump Shot,17.485342019543975
2013-14,101139,CJ Miles,SG,178,408,95,198,83,210,Center,2,Jump Shot,17.110294117647058
2014-15,101139,CJ Miles,SG,329,827,175,381,154,446,Center,14,Jump Shot,18.34582829504232
2015-16,101139,CJ Miles,SF,259,634,117,247,142,387,Center,3,Jump Shot,18.462145110410095
2016-17,101139,CJ Miles,SF,277,643,112,238,165,405,Center,13,Jump Shot,19.091757387247277
2017-18,101139,CJ Miles,SF,227,599,63,145,164,454,Center,7,Jump Shot,20.808013355592653
2018-19,101139,CJ Miles,SF,112,311,45,108,67,203,Center,4,Jump Shot,19.141479099678456
2019-20,101139,CJ Miles,SF,19,59,8,24,11,35,Center,1,Jump Shot,17.491525423728813
2021-22,1630595,Cade Cunningham,SG,429,1031,315,668,114,363,Center,21,Jump Shot,13.35984481086324
2022-23,1630595,Cade Cunningham,PG,93,224,76,163,17,61,Center,0,Pullup Jump shot,13.660714285714286
2003-04,384,Calbert Cheaney,SF,278,578,278,568,0,10,Center,12,Jump Shot,11.375432525951558
2004-05,384,Calbert Cheaney,SG,113,265,113,262,0,3,Center,4,Jump Shot,12.064150943396227
2005-06,384,Calbert Cheaney,SF,42,108,42,100,0,8,Left Side,1,Jump Shot,14.824074074074074
2022-23,1631216,Caleb Houstan,SF,66,182,20,46,46,136,Center,5,Jump Shot,19.653846153846153
2019-20,1628997,Caleb Martin,SF,37,84,17,47,20,37,Center,3,Jump Shot,13.857142857142858
2020-21,1628997,Caleb Martin,SF,96,256,65,131,31,125,Center,3,Jump Shot,15.515625
2021-22,1628997,Caleb Martin,SF,208,410,144,255,64,155,Center,15,Jump Shot,12.112195121951219
2022-23,1628997,Caleb Martin,PF,254,548,170,312,84,236,Center,7,Jump Shot,14.55109489051095
2017-18,1628403,Caleb Swanigan,PF,24,60,23,52,1,8,Center,4,Layup Shot,7.466666666666667
2018-19,1628403,Caleb Swanigan,PF,18,53,17,46,1,7,Center,2,Jump Shot,8.433962264150944
2019-20,1628403,Caleb Swanigan,PF-C,28,47,28,45,0,2,Center,6,Cutting Layup Shot,4.914893617021277
2003-04,1916,Calvin Booth,C,135,290,135,288,0,2,Center,3,Jump Shot,8.13448275862069
2004-05,1916,Calvin Booth,C,49,108,49,107,0,1,Center,8,Jump Shot,9.824074074074074
2005-06,1916,Calvin Booth,C,20,47,19,45,1,2,Center,2,Jump Shot,10.425531914893616
2006-07,1916,Calvin Booth,C,31,66,30,64,1,2,Center,2,Jump Shot,10.257575757575758
2007-08,1916,Calvin Booth,C,9,27,9,27,0,0,Center,0,Jump Shot,10.444444444444445
2008-09,1916,Calvin Booth,C,5,10,5,10,0,0,Center,0,Jump Shot,10.3
2019-20,1629629,Cam Reddish,SF,213,554,130,304,83,250,Center,8,Jump Shot,14.911552346570398
2020-21,1629629,Cam Reddish,SF,96,263,63,137,33,126,Center,6,Jump Shot,14.638783269961976
2021-22,1629629,Cam Reddish,SF,165,408,99,224,66,184,Center,5,Jump Shot,15.174019607843137
2022-23,1629629,Cam Reddish,SF,139,312,94,168,45,144,Center,4,Jump Shot,13.528846153846153
2018-19,1629244,Cam Reynolds,,33,78,12,27,21,51,Center,5,Jump Shot,18.5
2020-21,1629244,Cam Reynolds,,6,18,3,6,3,12,Left Side,1,Jump Shot,18.38888888888889
2021-22,1630560,Cam Thomas,SG,218,503,171,329,47,174,Center,10,Pullup Jump shot,15.550695825049702
2022-23,1630560,Cam Thomas,SG,201,456,150,323,51,133,Center,21,Pullup Jump shot,14.131578947368421
2014-15,203946,Cameron Bairstow,PF,3,14,3,14,0,0,Center,1,Jump Shot,9.928571428571429
2015-16,203946,Cameron Bairstow,C,13,40,12,35,1,5,Center,7,Jump Shot,10.325
2019-20,1629661,Cameron Johnson,PF,176,405,70,133,106,272,Center,6,Jump Shot,18.224691358024693
2020-21,1629661,Cameron Johnson,PF,203,483,86,148,117,335,Center,2,Jump Shot,19.03933747412008
2021-22,1629661,Cameron Johnson,PF,279,607,113,216,166,391,Center,13,Jump Shot,18.084019769357496
2022-23,1629661,Cameron Johnson,PF,223,474,120,219,103,255,Center,5,Jump Shot,16.459915611814345
2021-22,1630787,Cameron McGriff,SF,5,14,3,8,2,6,Center,3,Jump Shot,12.714285714285714
2020-21,1628419,Cameron Oliver,SF,19,33,15,20,4,13,Center,1,Jump Shot,12.181818181818182
2021-22,1628419,Cameron Oliver,SF,10,15,9,12,1,3,Center,0,Jump Shot,7.4
2015-16,1626166,Cameron Payne,PG,114,278,78,167,36,111,Center,8,Jump Shot,15.248201438848922
2016-17,1626166,Cameron Payne,PG,64,193,37,107,27,86,Center,3,Jump Shot,16.59585492227979
2017-18,1626166,Cameron Payne,PG,87,215,52,124,35,91,Center,8,Jump Shot,15.111627906976745
2018-19,1626166,Cameron Payne,PG,96,223,71,139,25,84,Center,4,Jump Shot,13.766816143497758
2019-20,1626166,Cameron Payne,SG,33,68,18,39,15,29,Center,3,Jump Shot,15.470588235294118
2020-21,1626166,Cameron Payne,PG,191,395,118,229,73,166,Center,5,Jump Shot,14.60253164556962
2021-22,1626166,Cameron Payne,PG,240,587,169,376,71,211,Center,7,Jump Shot,13.264054514480408
2022-23,1626166,Cameron Payne,PG,188,453,120,268,68,185,Center,6,Jump Shot,15.309050772626932
2016-17,1627747,Caris LeVert,SF,171,380,112,196,59,184,Center,10,Jump Shot,14.705263157894738
2017-18,1627747,Caris LeVert,SF,320,735,235,490,85,245,Center,13,Jump Shot,12.093877551020409
2018-19,1627747,Caris LeVert,SF,207,483,159,329,48,154,Center,8,Jump Shot,11.250517598343686
2019-20,1627747,Caris LeVert,SG,311,732,231,512,80,220,Center,8,Pullup Jump shot,12.012295081967213
2020-21,1627747,Caris LeVert,SG,359,814,275,556,84,258,Center,16,Pullup Jump shot,12.92997542997543
2021-22,1627747,Caris LeVert,SG,379,854,297,598,82,256,Center,23,Pullup Jump shot,12.35480093676815
2022-23,1627747,Caris LeVert,SG,320,742,193,418,127,324,Center,3,Jump Shot,14.167115902964959
2007-08,201171,Carl Landry,PF,135,219,135,218,0,1,Center,5,Jump Shot,4.954337899543379
2008-09,201171,Carl Landry,PF,240,418,239,415,1,3,Center,5,Jump Shot,6.662679425837321
2009-10,201171,Carl Landry,PF,499,931,498,928,1,3,Center,21,Jump Shot,6.968850698174006
2010-11,201171,Carl Landry,PF,345,687,345,683,0,4,Center,6,Jump Shot,9.074235807860262
2011-12,201171,Carl Landry,PF,182,362,182,359,0,3,Center,8,Jump Shot,7.790055248618785
2012-13,201171,Carl Landry,PF,325,602,324,599,1,3,Center,8,Jump Shot,7.343853820598007
2013-14,201171,Carl Landry,PF,31,60,31,60,0,0,Center,3,Jump Shot,10.2
2014-15,201171,Carl Landry,PF,190,369,190,369,0,0,Center,3,Jump Shot,8.799457994579946
2015-16,201171,Carl Landry,PF,139,250,133,237,6,13,Center,10,Jump Shot,10.288
2011-12,201291,Carldell Johnson,PG,11,35,7,20,4,15,Center,0,Jump Shot,14.82857142857143
2021-22,1630637,Carlik Jones,PG,1,9,1,8,0,1,Center,1,Pullup Jump shot,9.666666666666666
2022-23,1630637,Carlik Jones,PG,6,15,3,9,3,6,Center,1,Jump Shot,15.533333333333333
2003-04,2306,Carlos Arroyo,PG,339,768,301,651,38,117,Center,20,Jump Shot,14.122395833333334
2004-05,2306,Carlos Arroyo,PG,167,429,159,399,8,30,Center,15,Jump Shot,12.414918414918414
2005-06,2306,Carlos Arroyo,PG-SG,168,378,161,358,7,20,Center,8,Jump Shot,11.936507936507937
2006-07,2306,Carlos Arroyo,PG,203,478,189,427,14,51,Center,6,Jump Shot,13.399581589958158
2007-08,2306,Carlos Arroyo,PG,157,348,128,264,29,84,Center,11,Jump Shot,14.635057471264368
2009-10,2306,Carlos Arroyo,PG,178,375,171,350,7,25,Right Side,10,Jump Shot,15.565333333333333
2010-11,2306,Carlos Arroyo,PG,120,273,89,204,31,69,Right Side,1,Jump Shot,17.926739926739927
2003-04,2430,Carlos Boozer,PF,471,900,470,894,1,6,Center,16,Jump Shot,7.014444444444444
2004-05,2430,Carlos Boozer,PF,361,693,361,692,0,1,Center,14,Jump Shot,7.4646464646464645
2005-06,2430,Carlos Boozer,PF,219,399,219,399,0,0,Center,10,Jump Shot,7.205513784461153
2006-07,2430,Carlos Boozer,PF,647,1154,647,1154,0,0,Center,24,Jump Shot,6.621317157712305
2007-08,2430,Carlos Boozer,PF,709,1297,709,1296,0,1,Center,31,Jump Shot,7.508095605242868
2008-09,2430,Carlos Boozer,PF,251,512,251,512,0,0,Center,9,Jump Shot,6.953125
2009-10,2430,Carlos Boozer,PF,617,1098,617,1098,0,0,Center,23,Jump Shot,6.5136612021857925
2010-11,2430,Carlos Boozer,C,431,845,431,845,0,0,Center,18,Jump Shot,6.953846153846154
2011-12,2430,Carlos Boozer,PF,448,842,448,841,0,1,Center,14,Jump Shot,9.446555819477435
2012-13,2430,Carlos Boozer,PF,544,1140,544,1138,0,2,Center,13,Jump Shot,8.414035087719299
2013-14,2430,Carlos Boozer,PF,447,980,447,978,0,2,Center,13,Jump Shot,9.033673469387756
2014-15,2430,Carlos Boozer,PF,371,743,371,743,0,0,Center,6,Jump Shot,8.138627187079408
2004-05,2568,Carlos Delfino,SG,42,117,33,82,9,35,Center,1,Jump Shot,13.128205128205128
2005-06,2568,Carlos Delfino,SG,91,226,71,166,20,60,Center,7,Jump Shot,13.190265486725664
2006-07,2568,Carlos Delfino,SG,156,376,110,238,46,138,Center,9,Jump Shot,12.707446808510639
2007-08,2568,Carlos Delfino,SG,251,632,131,318,120,314,Center,8,Jump Shot,16.045886075949365
2009-10,2568,Carlos Delfino,SF,299,731,165,367,134,364,Center,6,Jump Shot,16.6922024623803
2010-11,2568,Carlos Delfino,SF,200,513,95,229,105,284,Center,12,Jump Shot,17.608187134502923
2011-12,2568,Carlos Delfino,SF,180,450,96,214,84,236,Center,4,Jump Shot,16.782222222222224
2012-13,2568,Carlos Delfino,SF,251,619,93,199,158,420,Center,12,Jump Shot,19.62843295638126
2003-04,2546,Carmelo Anthony,SF,624,1465,555,1251,69,214,Center,24,Jump Shot,10.031399317406143
2004-05,2546,Carmelo Anthony,SF,530,1230,488,1072,42,158,Center,17,Jump Shot,10.208130081300814
2005-06,2546,Carmelo Anthony,SF,756,1572,719,1420,37,152,Center,21,Jump Shot,10.1558524173028
2006-07,2546,Carmelo Anthony,SF,691,1453,651,1304,40,149,Center,20,Jump Shot,9.695801789401239
2007-08,2546,Carmelo Anthony,SF,728,1481,670,1317,58,164,Center,24,Jump Shot,10.61174881836597
2008-09,2546,Carmelo Anthony,SF,535,1207,472,1037,63,170,Center,20,Jump Shot,11.171499585749793
2009-10,2546,Carmelo Anthony,SF,688,1502,629,1315,59,187,Center,19,Jump Shot,10.725699067909455
2010-11,2546,Carmelo Anthony,SF,684,1503,589,1252,95,251,Center,31,Jump Shot,11.950099800399201
2011-12,2546,Carmelo Anthony,SF,441,1025,373,822,68,203,Center,29,Jump Shot,12.352195121951219
2012-13,2546,Carmelo Anthony,PF,669,1489,512,1075,157,414,Center,21,Jump Shot,13.791134989926125
2013-14,2546,Carmelo Anthony,PF,743,1643,576,1228,167,415,Center,22,Jump Shot,14.681071211199026
2014-15,2546,Carmelo Anthony,SF,358,806,297,627,61,179,Center,23,Jump Shot,13.942928039702233
2015-16,2546,Carmelo Anthony,SF,567,1307,462,997,105,310,Center,24,Jump Shot,14.030604437643458
2016-17,2546,Carmelo Anthony,SF,602,1389,451,968,151,421,Center,28,Jump Shot,16.103671706263498
2017-18,2546,Carmelo Anthony,PF,472,1168,303,694,169,474,Center,14,Jump Shot,17.136130136986303
2018-19,2546,Carmelo Anthony,PF,49,121,28,57,21,64,Center,2,Jump Shot,18.06611570247934
2019-20,2546,Carmelo Anthony,PF,336,782,249,556,87,226,Center,9,Jump Shot,13.9846547314578
2020-21,2546,Carmelo Anthony,PF,327,777,194,452,133,325,Right Side,6,Jump Shot,17.65122265122265
2021-22,2546,Carmelo Anthony,PF,319,723,170,326,149,397,Center,11,Jump Shot,18.568464730290458
2003-04,2406,Caron Butler,SF,240,631,230,589,10,42,Center,5,Jump Shot,11.809825673534073
2004-05,2406,Caron Butler,SF,441,991,403,866,38,125,Center,24,Jump Shot,10.174571140262362
2005-06,2406,Caron Butler,SF,494,1086,453,966,41,120,Center,23,Jump Shot,12.218232044198896
2006-07,2406,Caron Butler,SF,451,975,433,903,18,72,Center,17,Jump Shot,11.31076923076923
2007-08,2406,Caron Butler,SF,439,943,373,758,66,185,Center,19,Jump Shot,13.432661717921526
2008-09,2406,Caron Butler,SG,491,1085,426,875,65,210,Center,23,Jump Shot,13.027649769585253
2009-10,2406,Caron Butler,SF-SG,450,1051,408,906,42,145,Center,24,Jump Shot,13.27117031398668
2010-11,2406,Caron Butler,SF,170,378,142,313,28,65,Center,5,Jump Shot,14.671957671957673
2011-12,2406,Caron Butler,SF,285,703,195,448,90,255,Center,3,Jump Shot,16.64153627311522
2012-13,2406,Caron Butler,SF,305,719,177,390,128,329,Center,4,Jump Shot,17.751043115438108
2013-14,2406,Caron Butler,SF,213,539,115,291,98,248,Left Side,5,Jump Shot,18.88126159554731
2014-15,2406,Caron Butler,SF,161,396,78,177,83,219,Right Side Center,4,Jump Shot,20.373737373737374
2015-16,2406,Caron Butler,SF,25,59,22,41,3,18,Left Side Center,0,Jump Shot,18.847457627118644
2013-14,203467,Carrick Felix,SG,7,14,5,9,2,5,Center,3,Jump Shot,12.214285714285714
2019-20,1629035,Carsen Edwards,SG,42,128,18,52,24,76,Center,5,Jump Shot,18.9140625
2020-21,1629035,Carsen Edwards,SG,47,111,29,48,18,63,Center,5,Jump Shot,17.225225225225227
2021-22,1629035,Carsen Edwards,SG,9,30,5,14,4,16,Center,0,Pullup Jump shot,17.1
2008-09,201858,Cartier Martin,SF,28,77,18,44,10,33,Center,2,Jump Shot,14.519480519480519
2009-10,201858,Cartier Martin,SF,50,136,33,87,17,49,Center,3,Jump Shot,14.426470588235293
2010-11,201858,Cartier Martin,SF,71,182,32,83,39,99,Center,12,Jump Shot,18.5989010989011
2011-12,201858,Cartier Martin,SF,58,133,30,59,28,74,Center,3,Jump Shot,18.49624060150376
2012-13,201858,Cartier Martin,SF,96,252,38,106,58,146,Center,11,Jump Shot,19.456349206349206
2013-14,201858,Cartier Martin,SF,111,264,52,113,59,151,Center,8,Jump Shot,18.015151515151516
2014-15,201858,Cartier Martin,SF,15,53,9,20,6,33,Center,1,Jump Shot,20.37735849056604
2003-04,2418,Casey Jacobsen,SF,150,360,75,180,75,180,Center,4,Jump Shot,15.544444444444444
2004-05,2418,Casey Jacobsen,SG-SF,165,408,99,231,66,177,Center,11,Jump Shot,13.659313725490197
2007-08,2418,Casey Jacobsen,SG,39,115,23,43,16,72,Center,4,Jump Shot,16.48695652173913
2013-14,203810,Casper Ware,PG,18,42,11,21,7,21,Center,1,Jump Shot,16.547619047619047
2020-21,1630199,Cassius Stanley,SG,13,43,10,30,3,13,Center,7,Jump Shot,9.86046511627907
2021-22,1630199,Cassius Stanley,SG,19,46,15,29,4,17,Center,1,Jump Shot,11.934782608695652
2020-21,1630216,Cassius Winston,PG,14,33,6,16,8,17,Right Side Center,5,Jump Shot,19.09090909090909
2021-22,1630216,Cassius Winston,PG,4,11,2,5,2,6,Center,0,Jump Shot,18.636363636363637
2021-22,1627760,Cat Barber,PG,0,4,0,4,0,0,Center,0,Driving Layup Shot,9.0
2017-18,1626224,Cedi Osman,SF,90,186,58,99,32,87,Center,6,Jump Shot,15.381720430107526
2018-19,1626224,Cedi Osman,SF,360,844,230,470,130,374,Center,12,Jump Shot,14.33175355450237
2019-20,1626224,Cedi Osman,SF,266,609,143,288,123,321,Center,8,Jump Shot,15.270935960591133
2020-21,1626224,Cedi Osman,SF,219,586,120,262,99,324,Center,4,Jump Shot,15.812286689419794
2021-22,1626224,Cedi Osman,SF,247,572,119,213,128,359,Center,6,Jump Shot,17.361888111888113
2022-23,1626224,Cedi Osman,SF,239,530,123,218,116,312,Center,4,Jump Shot,16.358490566037737
2006-07,200841,Cedric Bozeman,SG,11,39,9,26,2,13,Center,2,Jump Shot,11.384615384615385
2009-10,202132,Cedric Jackson,PG,6,20,5,14,1,6,Center,3,Jump Shot,11.7
2006-07,200759,Cedric Simmons,PF,55,132,55,132,0,0,Center,1,Jump Shot,8.022727272727273
2007-08,200759,Cedric Simmons,PF,4,14,4,14,0,0,Center,1,Jump Shot,6.285714285714286
2008-09,200759,Cedric Simmons,PF,11,25,11,25,0,0,Center,3,Jump Shot,4.16
2003-04,2456,Cezary Trybanski,C,0,4,0,4,0,0,Right Side,0,Jump Shot,11.25
2022-23,1628435,Chance Comanche,,3,5,3,5,0,0,Center,0,Jump Shot,12.4
2018-19,1628990,Chandler Hutchison,SF,96,209,82,159,14,50,Center,7,Jump Shot,9.129186602870814
2019-20,1628990,Chandler Hutchison,SF,80,175,68,137,12,38,Center,3,Jump Shot,7.56
2020-21,1628990,Chandler Hutchison,SF,39,103,31,81,8,22,Center,1,Jump Shot,8.951456310679612
2021-22,1628990,Chandler Hutchison,SF,1,2,1,2,0,0,Center,1,Cutting Layup Shot,4.5
2011-12,202718,Chandler Parsons,SF,248,549,188,371,60,178,Center,14,Jump Shot,11.630236794171221
2012-13,202718,Chandler Parsons,SF,456,939,304,544,152,395,Center,16,Jump Shot,13.201277955271566
2013-14,202718,Chandler Parsons,SF,464,985,336,636,128,349,Center,13,Jump Shot,12.063959390862944
2014-15,202718,Chandler Parsons,SF,383,829,251,482,132,347,Center,8,Jump Shot,13.138721351025332
2015-16,202718,Chandler Parsons,SF,320,651,216,400,104,251,Center,3,Jump Shot,13.611367127496159
2016-17,202718,Chandler Parsons,SF,75,222,50,129,25,93,Center,0,Jump Shot,14.554054054054054
2017-18,202718,Chandler Parsons,SF,108,234,57,113,51,121,Center,1,Jump Shot,17.688034188034187
2018-19,202718,Chandler Parsons,SF,68,182,39,88,29,94,Center,0,Jump Shot,16.52747252747253
2019-20,202718,Chandler Parsons,PF,5,18,1,4,4,14,Center,0,Jump Shot,21.833333333333332
2005-06,101112,Channing Frye,C,305,640,302,631,3,9,Center,14,Jump Shot,9.9171875
2006-07,101112,Channing Frye,PF,298,689,295,671,3,18,Center,8,Jump Shot,12.911465892597969
2007-08,101112,Channing Frye,C,221,453,218,443,3,10,Center,6,Jump Shot,13.147902869757175
2008-09,101112,Channing Frye,PF,113,267,102,234,11,33,Center,7,Jump Shot,15.51685393258427
2009-10,101112,Channing Frye,C,317,703,145,311,172,392,Center,6,Jump Shot,19.219061166429587
2010-11,101112,Channing Frye,PF,358,829,187,390,171,439,Right Side Center,13,Jump Shot,19.24487334137515
2011-12,101112,Channing Frye,PF,255,613,164,350,91,263,Center,9,Jump Shot,17.145187601957584
2013-14,101112,Channing Frye,PF,336,778,176,346,160,432,Center,7,Jump Shot,18.457583547557842
2014-15,101112,Channing Frye,PF,191,487,55,141,136,346,Center,4,Jump Shot,21.418891170431213
2015-16,101112,Channing Frye,PF-C,152,347,61,112,91,235,Center,1,Jump Shot,19.334293948126803
2016-17,101112,Channing Frye,C,238,520,101,185,137,335,Center,4,Jump Shot,18.801923076923078
2017-18,101112,Channing Frye,C,104,212,65,97,39,115,Center,9,Jump Shot,17.962264150943398
2018-19,101112,Channing Frye,C,43,117,11,38,32,79,Right Side Center,7,Jump Shot,21.17094017094017
2021-22,1629646,Charles Bassey,C,30,47,30,43,0,4,Center,6,Floating Jump shot,5.212765957446808
2022-23,1629646,Charles Bassey,C,87,135,84,127,3,8,Center,5,Jump Shot,4.948148148148148
2017-18,1628429,Charles Cooke,SG,2,14,1,6,1,8,Center,2,Jump Shot,18.0
2011-12,202724,Charles Jenkins,PG,130,291,127,271,3,20,Center,5,Jump Shot,13.807560137457045
2012-13,202724,Charles Jenkins,SG-PG,49,121,48,119,1,2,Center,5,Jump Shot,14.322314049586776
2003-04,891,Charles Oakley,PF,2,6,2,6,0,0,Center,0,Jump Shot,10.666666666666666
2005-06,1520,Charles Smith,SG,30,72,15,34,15,38,Center,1,Jump Shot,17.180555555555557
2005-06,2294,Charlie Bell,SG,180,410,109,242,71,168,Center,5,Jump Shot,15.37560975609756
2006-07,2294,Charlie Bell,SG,426,974,299,613,127,361,Center,15,Jump Shot,14.863449691991786
2007-08,2294,Charlie Bell,SG,185,486,111,269,74,217,Center,11,Jump Shot,16.944444444444443
2008-09,2294,Charlie Bell,SG,217,524,130,284,87,240,Center,16,Jump Shot,18.07442748091603
2009-10,2294,Charlie Bell,SG,169,443,96,243,73,200,Center,9,Jump Shot,16.869074492099323
2010-11,2294,Charlie Bell,SG,12,43,6,22,6,21,Left Side,1,Jump Shot,19.209302325581394
2019-20,1629718,Charlie Brown Jr.,,6,19,3,10,3,9,Center,4,Jump Shot,13.842105263157896
2020-21,1629718,Charlie Brown Jr.,,13,43,8,22,5,21,Center,4,Jump Shot,16.069767441860463
2021-22,1629718,Charlie Brown Jr.,,10,39,9,27,1,12,Center,1,Jump Shot,10.538461538461538
2005-06,101111,Charlie Villanueva,PF,435,940,365,726,70,214,Center,17,Jump Shot,10.363829787234042
2006-07,101111,Charlie Villanueva,PF,180,383,151,297,29,86,Center,4,Jump Shot,11.093994778067884
2007-08,101111,Charlie Villanueva,PF,354,814,299,629,55,185,Center,5,Jump Shot,11.212530712530713
2008-09,101111,Charlie Villanueva,PF,487,1089,398,831,89,258,Center,19,Jump Shot,12.132231404958677
2009-10,101111,Charlie Villanueva,PF,362,826,264,545,98,281,Center,12,Jump Shot,13.878934624697337
2010-11,101111,Charlie Villanueva,PF,312,707,188,385,124,322,Center,11,Jump Shot,15.65063649222065
2011-12,101111,Charlie Villanueva,PF,35,91,20,46,15,45,Center,1,Jump Shot,15.307692307692308
2012-13,101111,Charlie Villanueva,PF,175,464,85,205,90,259,Center,9,Jump Shot,16.773706896551722
2013-14,101111,Charlie Villanueva,PF,35,92,21,36,14,56,Center,1,Jump Shot,17.358695652173914
2014-15,101111,Charlie Villanueva,PF,150,362,67,141,83,221,Center,20,Jump Shot,17.323204419889503
2015-16,101111,Charlie Villanueva,PF,124,326,78,155,46,171,Center,8,Jump Shot,15.368098159509202
2003-04,369,Charlie Ward,PG,160,390,76,184,84,206,Center,10,Jump Shot,16.712820512820514
2004-05,369,Charlie Ward,PG,24,77,8,26,16,51,Center,1,Jump Shot,18.675324675324674
2009-10,201978,Chase Budinger,SF,249,564,157,316,92,248,Center,7,Jump Shot,14.836879432624114
2010-11,201978,Chase Budinger,SF,278,654,190,382,88,272,Center,8,Jump Shot,14.498470948012232
2011-12,201978,Chase Budinger,SF,208,470,120,252,88,218,Center,6,Jump Shot,15.168085106382978
2012-13,201978,Chase Budinger,SF,79,191,53,110,26,81,Center,6,Jump Shot,15.120418848167539
2013-14,201978,Chase Budinger,SF,100,254,58,134,42,120,Center,3,Jump Shot,16.10236220472441
2014-15,201978,Chase Budinger,SF,169,390,117,247,52,143,Center,6,Jump Shot,13.53076923076923
2015-16,201978,Chase Budinger,SF,104,239,80,153,24,86,Center,10,Jump Shot,11.912133891213388
2016-17,1626184,Chasson Randle,PG,40,98,24,51,16,47,Center,5,Jump Shot,13.959183673469388
2018-19,1626184,Chasson Randle,PG,91,217,45,102,46,115,Center,8,Jump Shot,15.433179723502304
2019-20,1626184,Chasson Randle,PG,0,4,0,2,0,2,Left Side Center,0,Pullup Jump shot,19.25
2020-21,1626184,Chasson Randle,PG,92,237,48,107,44,130,Center,4,Jump Shot,16.953586497890296
2003-04,1497,Chauncey Billups,PG,392,996,262,661,130,335,Center,21,Jump Shot,14.793172690763052
2004-05,1497,Chauncey Billups,PG,404,913,239,526,165,387,Center,19,Jump Shot,16.36801752464403
2005-06,1497,Chauncey Billups,PG,423,1012,239,587,184,425,Center,16,Jump Shot,16.558300395256918
2006-07,1497,Chauncey Billups,PG,348,815,239,499,109,316,Center,24,Jump Shot,16.445398773006136
2007-08,1497,Chauncey Billups,PG,393,877,256,535,137,342,Center,13,Jump Shot,16.96237172177879
2008-09,1497,Chauncey Billups,PG,410,980,248,583,162,397,Center,10,Jump Shot,16.40612244897959
2009-10,1497,Chauncey Billups,PG,402,962,245,555,157,407,Center,13,Jump Shot,16.063409563409564
2010-11,1497,Chauncey Billups,PG,339,794,193,431,146,363,Center,21,Jump Shot,17.45088161209068
2011-12,1497,Chauncey Billups,SG,83,227,35,103,48,124,Center,4,Jump Shot,19.101321585903083
2012-13,1497,Chauncey Billups,SG,53,132,20,42,33,90,Right Side Center,0,Jump Shot,20.78787878787879
2013-14,1497,Chauncey Billups,SG,24,79,10,31,14,48,Center,0,Jump Shot,20.582278481012658
2021-22,1630602,Chaundee Brown Jr.,SG-SF,10,32,4,14,6,18,Center,0,Jump Shot,17.4375
2016-17,1627767,Cheick Diallo,PF,36,76,36,76,0,0,Center,3,Jump Shot,9.81578947368421
2017-18,1627767,Cheick Diallo,PF,102,176,102,176,0,0,Center,13,Jump Shot,5.869318181818182
2018-19,1627767,Cheick Diallo,PF,168,271,167,267,1,4,Center,7,Jump Shot,5.77859778597786
2019-20,1627767,Cheick Diallo,C,92,142,91,139,1,3,Center,10,Layup Shot,4.556338028169014
2021-22,1627767,Cheick Diallo,C,3,8,3,8,0,0,Center,0,Putback Layup Shot,2.75
2007-08,200798,Cheikh Samb,C,3,4,3,4,0,0,Left Side Center,0,Jump Shot,11.5
2008-09,200798,Cheikh Samb,C,6,32,6,29,0,3,Center,1,Jump Shot,13.84375
2003-04,685,Cherokee Parks,C,4,10,4,10,0,0,Center,0,Layup Shot,6.3
2022-23,1631320,Chima Moneke,SF,1,2,1,2,0,0,Center,1,Alley Oop Layup shot,1.5
2018-19,1629002,Chimezie Metu,PF,19,58,19,56,0,2,Center,3,Jump Shot,9.068965517241379
2019-20,1629002,Chimezie Metu,C,24,42,24,40,0,2,Center,9,Jump Shot,8.476190476190476
2020-21,1629002,Chimezie Metu,C,91,179,78,142,13,37,Center,5,Jump Shot,10.497206703910615
2021-22,1629002,Chimezie Metu,C,203,449,146,263,57,186,Center,12,Jump Shot,13.492204899777283
2022-23,1629002,Chimezie Metu,C,129,219,120,181,9,38,Center,8,Jump Shot,7.041095890410959
2016-17,1627778,Chinanu Onuaku,C,5,7,5,7,0,0,Center,0,Cutting Dunk Shot,1.7142857142857142
2017-18,1627778,Chinanu Onuaku,C,2,5,2,5,0,0,Center,0,Layup Shot,7.0
2003-04,2365,Chris Andersen,PF,90,203,90,202,0,1,Center,0,Jump Shot,6.231527093596059
2004-05,2365,Chris Andersen,C,191,358,191,355,0,3,Center,10,Jump Shot,5.941340782122905
2005-06,2365,Chris Andersen,C,56,98,56,98,0,0,Center,1,Layup Shot,2.5408163265306123
2007-08,2365,Chris Andersen,C,2,7,2,7,0,0,Center,1,Jump Shot,3.4285714285714284
2008-09,2365,Chris Andersen,C,160,292,158,282,2,10,Center,3,Jump Shot,3.537671232876712
2009-10,2365,Chris Andersen,PF,142,251,142,248,0,3,Center,1,Jump Shot,3.852589641434263
2010-11,2365,Chris Andersen,C,82,137,82,136,0,1,Center,1,Layup Shot,3.7445255474452557
2011-12,2365,Chris Andersen,C,59,108,59,108,0,0,Center,1,Layup Shot,4.611111111111111
2012-13,2365,Chris Andersen,C,71,123,69,120,2,3,Center,1,Layup Shot,3.024390243902439
2013-14,2365,Chris Andersen,C,177,275,174,263,3,12,Center,3,Layup Shot,3.629090909090909
2014-15,2365,Chris Andersen,C,120,207,116,194,4,13,Center,2,Jump Shot,5.231884057971015
2015-16,2365,Chris Andersen,C,38,72,34,58,4,14,Center,2,Jump Shot,7.638888888888889
2016-17,2365,Chris Andersen,C,9,22,9,19,0,3,Center,2,Jump Shot,7.0
2013-14,203569,Chris Babb,SG,8,30,2,3,6,27,Right Side Center,1,Jump Shot,22.966666666666665
2003-04,2547,Chris Bosh,C,327,712,322,698,5,14,Center,14,Jump Shot,8.662921348314606
2004-05,2547,Chris Bosh,PF,473,1005,470,995,3,10,Center,13,Jump Shot,8.551243781094527
2005-06,2547,Chris Bosh,C,549,1087,549,1074,0,13,Center,16,Jump Shot,9.35050597976081
2006-07,2547,Chris Bosh,C,543,1094,531,1059,12,35,Center,22,Jump Shot,9.350091407678246
2007-08,2547,Chris Bosh,C,507,1027,497,1002,10,25,Center,21,Jump Shot,9.5365141187926
2008-09,2547,Chris Bosh,C,615,1263,603,1214,12,49,Center,11,Jump Shot,10.265241488519399
2009-10,2547,Chris Bosh,C,600,1158,592,1136,8,22,Center,24,Jump Shot,8.442141623488773
2010-11,2547,Chris Bosh,PF,524,1056,518,1031,6,25,Center,9,Jump Shot,10.87689393939394
2011-12,2547,Chris Bosh,PF,393,807,383,772,10,35,Center,13,Jump Shot,10.053283767038414
2012-13,2547,Chris Bosh,C,485,907,464,833,21,74,Center,19,Jump Shot,11.275633958103638
2013-14,2547,Chris Bosh,C,492,953,418,735,74,218,Center,21,Jump Shot,12.913955928646379
2014-15,2547,Chris Bosh,C,343,745,280,577,63,168,Center,10,Jump Shot,14.30738255033557
2015-16,2547,Chris Bosh,PF,358,767,277,545,81,222,Center,11,Jump Shot,14.435462842242503
2017-18,1628449,Chris Boucher,PF,0,1,0,0,0,1,Left Side,0,Jump Shot,22.0
2018-19,1628449,Chris Boucher,PF,34,76,22,39,12,37,Center,11,Jump Shot,12.842105263157896
2019-20,1628449,Chris Boucher,C,141,299,103,181,38,118,Center,10,Jump Shot,11.31772575250836
2020-21,1628449,Chris Boucher,C,288,560,198,325,90,235,Center,12,Jump Shot,12.35
2021-22,1628449,Chris Boucher,SF,268,577,200,348,68,229,Center,8,Jump Shot,11.672443674176776
2022-23,1628449,Chris Boucher,PF,261,529,199,340,62,189,Center,5,Jump Shot,10.786389413988658
2018-19,1629185,Chris Chiozza,PG,2,8,0,3,2,5,Center,0,Jump Shot,18.625
2019-20,1629185,Chris Chiozza,PG,55,140,28,68,27,72,Center,4,Jump Shot,15.642857142857142
2020-21,1629185,Chris Chiozza,PG,31,88,18,46,13,42,Center,3,Pullup Jump shot,15.875
2021-22,1629185,Chris Chiozza,PG,24,81,7,28,17,53,Center,4,Jump Shot,18.950617283950617
2019-20,1629598,Chris Clemons,SG,57,142,20,35,37,107,Center,14,Jump Shot,21.0
2012-13,203142,Chris Copeland,PF,182,380,123,240,59,140,Center,22,Jump Shot,13.160526315789474
2013-14,203142,Chris Copeland,SF,55,117,22,38,33,79,Center,11,Jump Shot,18.324786324786324
2014-15,203142,Chris Copeland,SF,112,310,60,143,52,167,Center,5,Jump Shot,15.974193548387097
2015-16,203142,Chris Copeland,PF,17,51,7,15,10,36,Center,3,Jump Shot,19.19607843137255
2003-04,1544,Chris Crawford,PF,211,471,167,358,44,113,Center,15,Jump Shot,12.855626326963906
2008-09,201604,Chris Douglas-Roberts,SG,81,176,78,164,3,12,Center,8,Jump Shot,7.721590909090909
2009-10,201604,Chris Douglas-Roberts,SF,255,573,241,519,14,54,Center,5,Jump Shot,8.790575916230367
2010-11,201604,Chris Douglas-Roberts,SF,117,273,102,227,15,46,Center,10,Jump Shot,10.893772893772894
2012-13,201604,Chris Douglas-Roberts,SG,5,14,5,10,0,4,Center,0,Jump Shot,14.214285714285714
2013-14,201604,Chris Douglas-Roberts,SF,111,252,60,120,51,132,Center,6,Jump Shot,14.904761904761905
2014-15,201604,Chris Douglas-Roberts,SG,5,21,4,14,1,7,Center,2,Jump Shot,10.285714285714286
2021-22,1630537,Chris Duarte,SG,268,621,174,366,94,255,Center,5,Jump Shot,15.025764895330113
2022-23,1630537,Chris Duarte,SF,123,333,68,159,55,174,Center,1,Jump Shot,16.81981981981982
2004-05,2768,Chris Duhon,PG,172,488,78,223,94,265,Center,4,Jump Shot,15.924180327868852
2005-06,2768,Chris Duhon,PG,215,538,115,260,100,278,Center,14,Jump Shot,16.382899628252787
2006-07,2768,Chris Duhon,PG,197,483,109,238,88,245,Center,14,Jump Shot,15.63768115942029
2007-08,2768,Chris Duhon,PG,133,344,79,189,54,155,Center,10,Jump Shot,14.633720930232558
2008-09,2768,Chris Duhon,PG,287,681,160,356,127,325,Center,14,Jump Shot,14.659324522760645
2009-10,2768,Chris Duhon,PG,168,451,78,193,90,258,Center,8,Jump Shot,17.301552106430155
2010-11,2768,Chris Duhon,PG,49,129,36,77,13,52,Center,6,Jump Shot,14.03875968992248
2011-12,2768,Chris Duhon,PG,85,203,35,84,50,119,Center,2,Jump Shot,18.049261083743843
2012-13,2768,Chris Duhon,PG,47,123,14,32,33,91,Left Side Center,3,Jump Shot,21.43089430894309
2009-10,201805,Chris Hunter,C,109,217,109,213,0,4,Center,3,Jump Shot,7.253456221198157
2003-04,2423,Chris Jefferies,SF-SG,27,72,10,30,17,42,Right Side Center,7,Jump Shot,18.88888888888889
2010-11,202419,Chris Johnson,C,9,21,9,21,0,0,Center,1,Jump Shot,6.428571428571429
2011-12,202419,Chris Johnson,C,20,41,20,41,0,0,Center,5,Jump Shot,4.634146341463414
2012-13,202419,Chris Johnson,C,48,75,48,75,0,0,Center,2,Jump Shot,6.266666666666667
2012-13,203187,Chris Johnson,SF,11,25,5,7,6,18,Center,0,Jump Shot,18.0
2013-14,203187,Chris Johnson,SF,85,214,42,87,43,127,Center,4,Jump Shot,16.630841121495326
2014-15,203187,Chris Johnson,SF,62,154,34,59,28,95,Center,5,Jump Shot,16.51298701298701
2015-16,203187,Chris Johnson,SF,72,194,45,95,27,99,Center,7,Jump Shot,15.427835051546392
2003-04,2549,Chris Kaman,C,200,435,200,433,0,2,Center,6,Jump Shot,4.455172413793103
2004-05,2549,Chris Kaman,C,246,495,246,494,0,1,Center,4,Jump Shot,5.276767676767677
2005-06,2549,Chris Kaman,C,369,706,369,704,0,2,Center,9,Layup Shot,4.279036827195467
2006-07,2549,Chris Kaman,C,294,652,294,651,0,1,Center,5,Layup Shot,4.92638036809816
2007-08,2549,Chris Kaman,C,338,700,338,696,0,4,Center,8,Jump Shot,5.854285714285714
2008-09,2549,Chris Kaman,C,161,305,161,305,0,0,Center,4,Jump Shot,5.19672131147541
2009-10,2549,Chris Kaman,C,589,1202,589,1196,0,6,Center,16,Jump Shot,8.200499168053245
2010-11,2549,Chris Kaman,C,177,376,177,376,0,0,Center,1,Jump Shot,9.297872340425531
2011-12,2549,Chris Kaman,C,266,597,266,597,0,0,Center,4,Jump Shot,8.792294807370185
2012-13,2549,Chris Kaman,C,313,617,313,616,0,1,Center,4,Jump Shot,9.038897893030795
2013-14,2549,Chris Kaman,C,176,346,176,343,0,3,Center,4,Jump Shot,8.442196531791907
2014-15,2549,Chris Kaman,C,283,549,283,549,0,0,Center,1,Jump Shot,7.298724954462659
2015-16,2549,Chris Kaman,C,20,43,19,39,1,4,Center,4,Jump Shot,12.279069767441861
2006-07,200840,Chris McCray,SG,0,3,0,3,0,0,Left Side,0,Jump Shot,19.0
2015-16,1626191,Chris McCullough,PF,44,109,31,75,13,34,Center,3,Jump Shot,13.963302752293577
2016-17,1626191,Chris McCullough,PF,16,32,15,25,1,7,Center,6,Jump Shot,10.4375
2017-18,1626191,Chris McCullough,PF,18,42,17,34,1,8,Center,8,Jump Shot,10.428571428571429
2003-04,2036,Chris Mihm,C-PF,186,381,186,381,0,0,Center,4,Jump Shot,5.0078740157480315
2004-05,2036,Chris Mihm,C,280,552,280,550,0,2,Center,2,Layup Shot,4.365942028985507
2005-06,2036,Chris Mihm,C,230,459,230,459,0,0,Center,3,Jump Shot,5.610021786492375
2007-08,2036,Chris Mihm,C,32,95,32,95,0,0,Center,3,Jump Shot,5.621052631578947
2008-09,2036,Chris Mihm,C,15,40,15,40,0,0,Center,4,Layup Shot,3.825
2005-06,101108,Chris Paul,PG,407,947,357,770,50,177,Center,22,Jump Shot,11.002111932418163
2006-07,101108,Chris Paul,PG,381,871,331,728,50,143,Center,27,Jump Shot,10.696900114810562
2007-08,101108,Chris Paul,PG,630,1291,538,1042,92,249,Center,22,Jump Shot,12.333849728892332
2008-09,101108,Chris Paul,PG,631,1255,567,1079,64,176,Center,37,Jump Shot,11.422310756972111
2009-10,101108,Chris Paul,PG,314,637,262,510,52,127,Center,24,Jump Shot,13.612244897959183
2010-11,101108,Chris Paul,PG,430,928,359,745,71,183,Center,18,Jump Shot,13.70905172413793
2011-12,101108,Chris Paul,PG,425,890,346,677,79,213,Center,34,Jump Shot,13.715730337078652
2012-13,101108,Chris Paul,PG,412,856,336,624,76,232,Center,24,Jump Shot,14.839953271028037
2013-14,101108,Chris Paul,PG,406,870,328,658,78,212,Center,19,Jump Shot,14.550574712643678
2014-15,101108,Chris Paul,PG,568,1170,429,821,139,349,Center,24,Jump Shot,15.971794871794872
2015-16,101108,Chris Paul,PG,515,1113,393,785,122,328,Center,20,Jump Shot,15.730458221024259
2016-17,101108,Chris Paul,PG,374,785,250,483,124,302,Center,13,Jump Shot,17.61783439490446
2017-18,101108,Chris Paul,PG,367,798,223,419,144,379,Center,17,Jump Shot,17.62531328320802
2018-19,101108,Chris Paul,PG,302,720,175,365,127,355,Center,13,Jump Shot,17.352777777777778
2019-20,101108,Chris Paul,PG,434,887,323,583,111,304,Center,30,Pullup Jump shot,16.656144306651633
2020-21,101108,Chris Paul,PG,439,879,337,621,102,258,Center,17,Pullup Jump shot,16.38452787258248
2021-22,101108,Chris Paul,PG,363,736,300,537,63,199,Center,18,Pullup Jump shot,15.956521739130435
2022-23,101108,Chris Paul,PG,294,668,196,407,98,261,Center,16,Pullup Jump shot,17.494011976047904
2006-07,200809,Chris Quinn,PG,48,131,28,74,20,57,Center,13,Jump Shot,16.358778625954198
2007-08,200809,Chris Quinn,PG,158,373,94,214,64,159,Center,14,Jump Shot,17.024128686327078
2008-09,200809,Chris Quinn,PG,118,289,62,152,56,137,Center,6,Jump Shot,17.474048442906575
2009-10,200809,Chris Quinn,PG,20,56,10,24,10,32,Left Side Center,5,Jump Shot,18.321428571428573
2010-11,200809,Chris Quinn,PG,33,90,22,54,11,36,Center,5,Jump Shot,17.1
2012-13,200809,Chris Quinn,SG,4,16,4,11,0,5,Center,2,Jump Shot,16.75
2007-08,201181,Chris Richard,C,41,87,41,87,0,0,Center,5,Layup Shot,2.218390804597701
2009-10,201181,Chris Richard,PF,15,29,15,29,0,0,Center,0,Hook Shot,2.310344827586207
2019-20,1629735,Chris Silva,PF,48,78,48,75,0,3,Center,4,Layup Shot,3.5384615384615383
2020-21,1629735,Chris Silva,PF,10,16,9,15,1,1,Center,3,Layup Shot,6.3125
2021-22,1629735,Chris Silva,PF,8,15,8,15,0,0,Center,0,Layup Shot,3.6666666666666665
2022-23,1629735,Chris Silva,PF,1,1,1,1,0,0,Center,0,Turnaround Hook Shot,7.0
2011-12,202698,Chris Singleton,SF,116,312,72,185,44,127,Center,6,Jump Shot,15.78525641025641
2012-13,202698,Chris Singleton,PF,92,241,85,205,7,36,Center,4,Jump Shot,12.887966804979254
2013-14,202698,Chris Singleton,SF,25,67,18,48,7,19,Center,4,Jump Shot,13.477611940298507
2005-06,101147,Chris Taft,C,23,38,23,38,0,0,Center,2,Layup Shot,3.1052631578947367
2003-04,185,Chris Webber,PF,174,421,173,416,1,5,Center,4,Jump Shot,10.002375296912113
2004-05,185,Chris Webber,PF,555,1283,540,1239,15,44,Center,24,Jump Shot,11.835541699142635
2005-06,185,Chris Webber,PF,617,1422,596,1345,21,77,Center,24,Jump Shot,10.373417721518987
2006-07,185,Chris Webber,PF,289,639,285,628,4,11,Center,9,Jump Shot,8.7981220657277
2007-08,185,Chris Webber,PF,15,31,15,31,0,0,Center,0,Jump Shot,11.516129032258064
2003-04,43,Chris Whitney,PG,17,45,9,27,8,18,Left Side,0,Jump Shot,19.08888888888889
2003-04,2404,Chris Wilcox,C,227,436,227,435,0,1,Center,9,Jump Shot,4.128440366972477
2004-05,2404,Chris Wilcox,C,169,329,169,329,0,0,Center,9,Jump Shot,4.227963525835866
2005-06,2404,Chris Wilcox,C-PF,257,450,257,448,0,2,Center,11,Jump Shot,4.757777777777778
2006-07,2404,Chris Wilcox,PF,433,819,433,813,0,6,Center,13,Jump Shot,4.881562881562882
2007-08,2404,Chris Wilcox,PF,334,638,334,635,0,3,Center,21,Jump Shot,4.478056426332288
2008-09,2404,Chris Wilcox,C,184,370,184,366,0,4,Center,5,Jump Shot,4.297297297297297
2009-10,2404,Chris Wilcox,PF,63,120,63,120,0,0,Center,4,Jump Shot,4.541666666666667
2010-11,2404,Chris Wilcox,PF,187,322,187,321,0,1,Center,15,Layup Shot,3.829192546583851
2011-12,2404,Chris Wilcox,C,64,107,64,107,0,0,Center,1,Jump Shot,4.168224299065421
2012-13,2404,Chris Wilcox,C,110,153,110,152,0,1,Center,3,Layup Shot,2.3856209150326797
2011-12,202874,Chris Wright,SF,23,45,23,45,0,0,Center,5,Layup Shot,3.1333333333333333
2012-13,203203,Chris Wright,SG,1,2,1,2,0,0,Center,1,Jump Shot,10.0
2013-14,202874,Chris Wright,SF,21,35,21,34,0,1,Center,0,Layup Shot,2.142857142857143
2022-23,1631128,Christian Braun,SG,143,289,109,193,34,96,Center,5,Jump Shot,10.920415224913494
2010-11,201963,Christian Eyenga,SF,130,306,105,215,25,91,Center,6,Jump Shot,13.062091503267974
2011-12,201963,Christian Eyenga,SF,6,25,5,22,1,3,Center,0,Jump Shot,11.92
2022-23,1631132,Christian Koloko,C,72,150,71,138,1,12,Center,5,Cutting Dunk Shot,4.546666666666667
2003-04,363,Christian Laettner,PF,119,256,113,235,6,21,Center,0,Jump Shot,12.6640625
2004-05,363,Christian Laettner,PF,107,184,106,177,1,7,Center,7,Jump Shot,11.0
2015-16,1626174,Christian Wood,PF,22,53,18,42,4,11,Center,4,Jump Shot,9.037735849056604
2016-17,1626174,Christian Wood,PF,12,23,12,18,0,5,Center,3,Jump Shot,6.913043478260869
2018-19,1626174,Christian Wood,PF,61,117,52,91,9,26,Center,7,Jump Shot,8.692307692307692
2019-20,1626174,Christian Wood,PF,288,508,234,368,54,140,Center,17,Jump Shot,9.616141732283465
2020-21,1626174,Christian Wood,C,329,640,252,434,77,206,Center,9,Jump Shot,11.7921875
2021-22,1626174,Christian Wood,C,440,878,309,542,131,336,Center,12,Jump Shot,12.52619589977221
2022-23,1626174,Christian Wood,C,396,769,291,490,105,279,Center,4,Jump Shot,12.34850455136541
2005-06,101236,Chuck Hayes,PF,59,105,59,104,0,1,Center,4,Layup Shot,1.6666666666666667
2006-07,101236,Chuck Hayes,PF,192,335,192,335,0,0,Center,3,Layup Shot,1.146268656716418
2007-08,101236,Chuck Hayes,PF,113,221,113,218,0,3,Center,3,Layup Shot,2.728506787330317
2008-09,101236,Chuck Hayes,C,42,113,42,109,0,4,Center,2,Layup Shot,5.619469026548672
2009-10,101236,Chuck Hayes,C,161,329,161,329,0,0,Center,0,Layup Shot,1.4012158054711246
2010-11,101236,Chuck Hayes,C,244,463,244,461,0,2,Center,3,Layup Shot,2.9438444924406046
2011-12,101236,Chuck Hayes,C,73,170,73,168,0,2,Center,2,Layup Shot,4.211764705882353
2012-13,101236,Chuck Hayes,C,84,190,84,189,0,1,Center,1,Jump Shot,4.231578947368421
2013-14,101236,Chuck Hayes,C,56,130,56,129,0,1,Center,1,Layup Shot,4.1692307692307695
2014-15,101236,Chuck Hayes,C,22,46,22,46,0,0,Center,0,Layup Shot,3.152173913043478
2015-16,101236,Chuck Hayes,C,1,2,1,2,0,0,Center,0,Jump Shot,5.0
2003-04,1088,Chucky Atkins,PG,192,484,111,243,81,241,Center,6,Jump Shot,17.826446280991735
2004-05,1088,Chucky Atkins,PG,388,910,212,455,176,455,Center,20,Jump Shot,17.696703296703298
2005-06,1088,Chucky Atkins,PG-SG,226,573,129,299,97,274,Center,7,Jump Shot,17.167539267015705
2006-07,1088,Chucky Atkins,PG,310,715,194,409,116,306,Center,19,Jump Shot,15.13006993006993
2007-08,1088,Chucky Atkins,SG,42,122,17,43,25,79,Center,3,Jump Shot,20.049180327868854
2008-09,1088,Chucky Atkins,PG,34,113,19,56,15,57,Right Side Center,4,Jump Shot,19.01769911504425
2009-10,1088,Chucky Atkins,PG,57,157,35,84,22,73,Center,1,Jump Shot,18.02547770700637
2020-21,1629643,Chuma Okeke,PF,135,324,86,183,49,141,Center,1,Jump Shot,16.354938271604937
2021-22,1629643,Chuma Okeke,PF,216,575,98,204,118,371,Center,10,Jump Shot,18.06608695652174
2022-23,1629643,Chuma Okeke,SF,43,122,17,36,26,86,Center,3,Jump Shot,19.07377049180328
2003-04,221,Clar. Weatherspoon,PF,104,211,104,210,0,1,Center,4,Jump Shot,6.9052132701421804
2004-05,221,Clar. Weatherspoon,PF,47,114,47,114,0,0,Center,1,Jump Shot,8.640350877192983
2014-15,203921,Cleanthony Early,SF,76,214,54,130,22,84,Center,6,Jump Shot,14.24766355140187
2015-16,203921,Cleanthony Early,SF,12,40,8,25,4,15,Center,1,Jump Shot,15.325
2015-16,1626146,Cliff Alexander,PF,5,10,5,10,0,0,Center,1,Jump Shot,7.4
2003-04,361,Clifford Robinson,PF,366,945,254,631,112,314,Center,17,Jump Shot,15.61058201058201
2004-05,361,Clifford Robinson,C-PF,202,523,135,330,67,193,Center,10,Jump Shot,16.066921606118548
2005-06,361,Clifford Robinson,PF,219,513,159,338,60,175,Center,11,Jump Shot,15.91812865497076
2006-07,361,Clifford Robinson,C,81,218,56,152,25,66,Center,1,Jump Shot,15.669724770642201
2014-15,203991,Clint Capela,C,14,29,14,29,0,0,Center,1,Jump Shot,1.6206896551724137
2015-16,203991,Clint Capela,C,231,397,231,396,0,1,Center,5,Layup Shot,1.6775818639798488
2016-17,203991,Clint Capela,C,362,563,362,563,0,0,Center,6,Layup Shot,1.6323268206039077
2017-18,203991,Clint Capela,C,441,676,441,675,0,1,Center,9,Layup Shot,1.7396449704142012
2018-19,203991,Clint Capela,C,474,732,474,732,0,0,Center,13,Layup Shot,1.8811475409836065
2019-20,203991,Clint Capela,C,244,388,244,388,0,0,Center,9,Alley Oop Dunk Shot,1.8015463917525774
2020-21,203991,Clint Capela,C,413,695,413,695,0,0,Center,11,Layup Shot,1.9755395683453238
2021-22,203991,Clint Capela,C,370,604,370,603,0,1,Center,5,Alley Oop Dunk Shot,1.846026490066225
2022-23,203991,Clint Capela,C,350,536,350,535,0,1,Center,12,Tip Layup Shot,1.7742537313432836
2007-08,201207,Coby Karl,SG,9,26,5,13,4,13,Center,7,Jump Shot,15.961538461538462
2009-10,201207,Coby Karl,SF-SG,11,32,9,21,2,11,Center,3,Jump Shot,13.125
2019-20,1629632,Coby White,PG,312,792,179,416,133,376,Center,15,Jump Shot,15.496212121212121
2020-21,1629632,Coby White,PG,375,902,212,448,163,454,Center,16,Jump Shot,16.135254988913527
2021-22,1629632,Coby White,PG,279,644,143,291,136,353,Center,6,Jump Shot,16.944099378881987
2022-23,1629632,Coby White,SG,263,594,135,250,128,344,Center,11,Jump Shot,17.282828282828284
2019-20,1628998,Cody Martin,SF,89,207,71,130,18,77,Center,6,Jump Shot,11.555555555555555
2020-21,1628998,Cody Martin,SF,83,188,67,130,16,58,Center,7,Jump Shot,10.659574468085106
2021-22,1628998,Cody Martin,SF,204,423,143,264,61,159,Center,2,Jump Shot,11.61465721040189
2022-23,1628998,Cody Martin,SF,14,36,11,22,3,14,Center,0,Jump Shot,12.86111111111111
2013-14,203469,Cody Zeller,C,172,404,172,403,0,1,Center,2,Jump Shot,7.915841584158416
2014-15,203469,Cody Zeller,C,172,373,171,372,1,1,Center,5,Jump Shot,8.359249329758713
2015-16,203469,Cody Zeller,C,231,437,230,427,1,10,Center,7,Jump Shot,4.91533180778032
2016-17,203469,Cody Zeller,C,253,443,253,442,0,1,Center,15,Layup Shot,4.121896162528217
2017-18,203469,Cody Zeller,C,85,156,83,153,2,3,Center,5,Layup Shot,4.82051282051282
2018-19,203469,Cody Zeller,C,190,345,184,323,6,22,Center,1,Layup Shot,4.594202898550725
2019-20,203469,Cody Zeller,C,251,479,233,404,18,75,Center,4,Jump Shot,6.068893528183716
2020-21,203469,Cody Zeller,C,181,324,177,296,4,28,Center,2,Layup Shot,4.447530864197531
2021-22,203469,Cody Zeller,C,51,90,51,86,0,4,Center,1,Tip Layup Shot,3.3555555555555556
2022-23,203469,Cody Zeller,C,37,59,37,57,0,2,Center,0,Cutting Layup Shot,4.220338983050848
2010-11,202332,Cole Aldrich,C,8,15,8,15,0,0,Center,3,Jump Shot,3.4
2011-12,202332,Cole Aldrich,C,22,42,22,42,0,0,Center,5,Hook Shot,3.119047619047619
2012-13,202332,Cole Aldrich,C,44,80,44,80,0,0,Center,3,Layup Shot,3.2
2013-14,202332,Cole Aldrich,C,33,61,33,61,0,0,Center,4,Layup Shot,2.9344262295081966
2014-15,202332,Cole Aldrich,C,144,301,144,301,0,0,Center,8,Hook Shot,4.318936877076412
2015-16,202332,Cole Aldrich,C,134,225,134,225,0,0,Center,10,Hook Shot,2.7555555555555555
2016-17,202332,Cole Aldrich,C,45,86,45,86,0,0,Center,3,Layup Shot,2.5813953488372094
2017-18,202332,Cole Aldrich,C,5,15,5,15,0,0,Center,3,Layup Shot,3.2
2020-21,1630175,Cole Anthony,PG,219,552,161,380,58,172,Center,13,Jump Shot,12.86231884057971
2021-22,1630175,Cole Anthony,PG,357,912,225,521,132,391,Center,23,Jump Shot,15.640350877192983
2022-23,1630175,Cole Anthony,PG,277,610,202,404,75,206,Center,5,Jump Shot,14.257377049180327
2022-23,1631306,Cole Swider,SF,3,9,0,1,3,8,Center,1,Jump Shot,23.77777777777778
2018-19,1629012,Collin Sexton,PG,519,1206,400,910,119,296,Center,26,Jump Shot,12.966003316749585
2019-20,1629012,Collin Sexton,PG,513,1086,416,831,97,255,Center,25,Jump Shot,10.66390423572744
2020-21,1629012,Collin Sexton,SG,525,1105,427,841,98,264,Center,11,Jump Shot,11.161990950226244
2021-22,1629012,Collin Sexton,SG,68,151,57,106,11,45,Center,1,Jump Shot,11.33774834437086
2022-23,1629012,Collin Sexton,SG,237,468,189,346,48,122,Center,6,Jump Shot,10.435897435897436
2007-08,201147,Corey Brewer,SF,182,486,175,450,7,36,Center,7,Jump Shot,11.609053497942387
2008-09,201147,Corey Brewer,SF,37,90,32,78,5,12,Center,0,Jump Shot,11.133333333333333
2009-10,201147,Corey Brewer,SG,409,949,327,712,82,237,Center,23,Jump Shot,12.519494204425712
2010-11,201147,Corey Brewer,SF-SG,193,488,163,376,30,112,Center,12,Jump Shot,12.07172131147541
2011-12,201147,Corey Brewer,SF,201,463,168,336,33,127,Center,10,Jump Shot,10.025917926565874
2012-13,201147,Corey Brewer,SF,375,882,284,576,91,306,Center,10,Jump Shot,12.741496598639456
2013-14,201147,Corey Brewer,SF,388,807,329,596,59,211,Center,14,Jump Shot,9.804213135068153
2014-15,201147,Corey Brewer,SF,342,804,280,570,62,234,Center,20,Jump Shot,11.126865671641792
2015-16,201147,Corey Brewer,SF,212,550,151,328,61,222,Center,11,Jump Shot,13.105454545454545
2016-17,201147,Corey Brewer,SF,147,347,120,230,27,117,Center,5,Jump Shot,10.78386167146974
2017-18,201147,Corey Brewer,SF-SG,142,316,111,206,31,110,Center,5,Jump Shot,10.104430379746836
2018-19,201147,Corey Brewer,SF,53,123,39,79,14,44,Center,1,Jump Shot,11.333333333333334
2019-20,201147,Corey Brewer,PF,2,4,2,3,0,1,Center,0,Reverse Layup Shot,6.75
2021-22,1630557,Corey Kispert,SF,234,514,122,194,112,320,Center,9,Jump Shot,17.587548638132297
2022-23,1630557,Corey Kispert,SF,291,585,128,201,163,384,Center,7,Jump Shot,18.162393162393162
2003-04,1894,Corey Maggette,SF,453,1013,377,782,76,231,Center,22,Jump Shot,12.339585389930898
2004-05,1894,Corey Maggette,SG,425,986,374,818,51,168,Center,19,Jump Shot,13.281947261663285
2005-06,1894,Corey Maggette,SF,167,375,143,304,24,71,Center,7,Jump Shot,13.448
2006-07,1894,Corey Maggette,SF,367,808,354,743,13,65,Center,21,Jump Shot,11.592821782178218
2007-08,1894,Corey Maggette,SF,458,1000,380,797,78,203,Center,15,Jump Shot,12.498
2008-09,1894,Corey Maggette,PF,292,634,268,539,24,95,Center,7,Jump Shot,11.324921135646688
2009-10,1894,Corey Maggette,PF,457,886,444,836,13,50,Center,12,Jump Shot,9.730248306997742
2010-11,1894,Corey Maggette,SF,253,559,225,481,28,78,Center,8,Jump Shot,12.978533094812164
2011-12,1894,Corey Maggette,SF,139,373,115,307,24,66,Center,4,Jump Shot,12.804289544235925
2012-13,1894,Corey Maggette,SF,27,76,22,55,5,21,Center,0,Jump Shot,14.736842105263158
2003-04,916,Corie Blount,PF-C,115,253,115,250,0,3,Center,1,Jump Shot,12.027667984189723
2003-04,722,Corliss Williamson,PF,304,602,304,602,0,0,Center,11,Jump Shot,5.365448504983389
2004-05,722,Corliss Williamson,PF,273,584,273,582,0,2,Center,10,Jump Shot,5.282534246575342
2005-06,722,Corliss Williamson,SF,43,103,41,101,2,2,Center,4,Jump Shot,6.728155339805825
2006-07,722,Corliss Williamson,PF,236,463,236,461,0,2,Center,14,Layup Shot,5.473002159827214
2004-05,2451,Corsley Edwards,C,10,31,10,31,0,0,Center,1,Jump Shot,3.935483870967742
2004-05,724,Cory Alexander,SG,16,49,8,30,8,19,Center,1,Jump Shot,15.979591836734693
2011-12,202809,Cory Higgins,PG,52,160,48,140,4,20,Center,10,Jump Shot,11.325
2012-13,202809,Cory Higgins,SG,6,19,5,14,1,5,Right Side,1,Jump Shot,16.210526315789473
2014-15,203928,Cory Jefferson,PF,75,167,73,152,2,15,Center,9,Jump Shot,9.04191616766467
2015-16,203928,Cory Jefferson,PF,9,22,9,21,0,1,Center,2,Jump Shot,5.454545454545454
2011-12,202709,Cory Joseph,PG,22,70,19,55,3,15,Center,7,Jump Shot,13.814285714285715
2012-13,202709,Cory Joseph,PG,51,110,45,89,6,21,Center,6,Jump Shot,10.8
2013-14,202709,Cory Joseph,SG,126,265,114,227,12,38,Center,33,Jump Shot,11.143396226415094
2014-15,202709,Cory Joseph,PG,207,411,191,367,16,44,Center,8,Jump Shot,9.372262773722628
2015-16,202709,Cory Joseph,SG,257,584,227,475,30,109,Center,13,Jump Shot,10.857876712328768
2016-17,202709,Cory Joseph,PG,299,661,251,526,48,135,Center,9,Jump Shot,11.944024205748866
2017-18,202709,Cory Joseph,PG,256,604,189,414,67,190,Center,11,Jump Shot,15.355960264900663
2018-19,202709,Cory Joseph,PG,226,548,171,377,55,171,Center,6,Jump Shot,15.218978102189782
2019-20,202709,Cory Joseph,PG,171,412,115,253,56,159,Center,2,Jump Shot,14.910194174757281
2020-21,202709,Cory Joseph,PG,200,426,155,294,45,132,Center,6,Jump Shot,12.518779342723004
2021-22,202709,Cory Joseph,PG,178,400,113,243,65,157,Center,9,Jump Shot,14.2325
2022-23,202709,Cory Joseph,PG,150,351,80,171,70,180,Center,10,Jump Shot,16.846153846153847
2015-16,1626262,Coty Clarke,SF,2,4,0,2,2,2,Center,1,Jump Shot,17.0
2011-12,202622,Courtney Fortson,PG,11,32,8,19,3,13,Center,0,Jump Shot,12.40625
2008-09,201584,Courtney Lee,SG,243,540,161,337,82,203,Center,7,Jump Shot,14.151851851851852
2009-10,201584,Courtney Lee,SG,338,775,262,550,76,225,Center,16,Jump Shot,13.570322580645161
2010-11,201584,Courtney Lee,SG,253,576,182,402,71,174,Center,13,Jump Shot,14.005208333333334
2011-12,201584,Courtney Lee,SG,251,580,164,363,87,217,Center,7,Jump Shot,15.181034482758621
2012-13,201584,Courtney Lee,SG,246,530,188,374,58,156,Center,20,Jump Shot,13.060377358490566
2013-14,201584,Courtney Lee,SG,295,614,223,420,72,194,Center,9,Jump Shot,14.799674267100977
2014-15,201584,Courtney Lee,SG,288,643,198,419,90,224,Center,6,Jump Shot,15.606531881804043
2015-16,201584,Courtney Lee,SG,290,639,208,422,82,217,Center,8,Jump Shot,15.167449139280125
2016-17,201584,Courtney Lee,SG,321,704,213,435,108,269,Center,9,Jump Shot,15.504261363636363
2017-18,201584,Courtney Lee,SG,343,755,230,477,113,278,Center,13,Jump Shot,15.754966887417218
2018-19,201584,Courtney Lee,SG,53,129,37,74,16,55,Center,6,Jump Shot,16.26356589147287
2019-20,201584,Courtney Lee,SG,40,82,19,35,21,47,Center,2,Jump Shot,16.841463414634145
2007-08,201235,Courtney Sims,C,0,1,0,1,0,0,Center,0,Layup Shot,2.0
2008-09,201235,Courtney Sims,C,3,6,3,6,0,0,Center,1,Layup Shot,3.6666666666666665
2010-11,202342,Craig Brackins,PF,4,16,4,11,0,5,Center,0,Jump Shot,15.375
2011-12,202342,Craig Brackins,PF,9,33,6,24,3,9,Center,5,Jump Shot,16.484848484848484
2006-07,200783,Craig Smith,PF,246,463,246,457,0,6,Center,13,Layup Shot,4.24622030237581
2007-08,200783,Craig Smith,PF,297,528,297,519,0,9,Center,9,Layup Shot,4.028409090909091
2008-09,200783,Craig Smith,PF,289,514,289,513,0,1,Center,4,Layup Shot,3.5797665369649807
2009-10,200783,Craig Smith,PF,226,397,225,392,1,5,Center,8,Layup Shot,3.0125944584382873
2010-11,200783,Craig Smith,PF,104,188,104,183,0,5,Center,9,Jump Shot,6.680851063829787
2011-12,200783,Craig Smith,PF,59,117,59,116,0,1,Center,1,Layup Shot,3.8632478632478633
2021-22,1628591,Craig Sword,SG,3,4,3,3,0,1,Center,0,Running Reverse Layup Shot,6.5
2015-16,1626245,Cristiano Felicio,C,40,72,40,68,0,4,Center,3,Jump Shot,6.972222222222222
2016-17,1626245,Cristiano Felicio,C,128,221,128,221,0,0,Center,7,Layup Shot,3.7828054298642533
2017-18,1626245,Cristiano Felicio,C,127,215,127,213,0,2,Center,10,Layup Shot,4.21860465116279
2018-19,1626245,Cristiano Felicio,C,95,179,95,175,0,4,Center,10,Layup Shot,3.3798882681564244
2019-20,1626245,Cristiano Felicio,C,34,54,34,52,0,2,Center,0,Putback Layup Shot,3.0185185185185186
2020-21,1626245,Cristiano Felicio,C,7,13,7,11,0,2,Center,1,Putback Layup Shot,7.076923076923077
2003-04,2414,Curtis Borchardt,C,22,56,22,55,0,1,Center,2,Jump Shot,8.732142857142858
2004-05,2414,Curtis Borchardt,C,74,172,74,172,0,0,Center,5,Jump Shot,4.104651162790698
2003-04,1749,Cuttino Mobley,SG,460,1081,296,661,164,420,Center,17,Jump Shot,15.367252543940795
2004-05,1749,Cuttino Mobley,SG,408,932,258,590,150,342,Center,16,Jump Shot,16.106223175965667
2005-06,1749,Cuttino Mobley,SG,429,1008,346,763,83,245,Center,14,Jump Shot,13.854166666666666
2006-07,1749,Cuttino Mobley,SG,388,882,287,636,101,246,Center,10,Jump Shot,14.609977324263038
2007-08,1749,Cuttino Mobley,SG,377,870,310,678,67,192,Center,15,Jump Shot,14.614942528735632
2008-09,1749,Cuttino Mobley,SG,63,146,51,111,12,35,Center,1,Jump Shot,12.095890410958905
2015-16,1626156,D'Angelo Russell,PG,391,954,262,586,129,368,Center,18,Jump Shot,15.30188679245283
2016-17,1626156,D'Angelo Russell,PG,351,865,216,483,135,382,Center,22,Jump Shot,16.3364161849711
2017-18,1626156,D'Angelo Russell,PG,278,672,188,394,90,278,Center,14,Jump Shot,15.577380952380953
2018-19,1626156,D'Angelo Russell,PG,659,1517,425,882,234,635,Center,31,Jump Shot,15.89452867501648
2019-20,1626156,D'Angelo Russell,PG,360,846,202,415,158,431,Center,8,Jump Shot,18.6016548463357
2020-21,1626156,D'Angelo Russell,PG,281,652,161,342,120,310,Center,19,Jump Shot,17.375766871165645
2021-22,1626156,D'Angelo Russell,PG,401,975,225,457,176,518,Center,8,Jump Shot,17.653333333333332
2022-23,1626156,D'Angelo Russell,PG,445,948,251,458,194,490,Center,12,Jump Shot,17.063291139240505
2008-09,201571,D.J. Augustin,PG,267,621,159,375,108,246,Center,12,Jump Shot,14.879227053140097
2009-10,201571,D.J. Augustin,PG,168,434,98,257,70,177,Center,6,Jump Shot,15.23963133640553
2010-11,201571,D.J. Augustin,PG,399,958,288,625,111,333,Center,15,Jump Shot,13.821503131524008
2011-12,201571,D.J. Augustin,PG,183,487,122,308,61,179,Center,10,Jump Shot,13.860369609856264
2012-13,201571,D.J. Augustin,PG,103,294,36,104,67,190,Center,2,Jump Shot,19.091836734693878
2013-14,201571,D.J. Augustin,PG,298,718,165,386,133,332,Center,10,Jump Shot,16.125348189415043
2014-15,201571,D.J. Augustin,PG,257,645,175,401,82,244,Center,10,Jump Shot,13.683720930232559
2015-16,201571,D.J. Augustin,PG,147,349,80,182,67,167,Center,4,Jump Shot,15.375358166189113
2016-17,201571,D.J. Augustin,PG,195,517,100,243,95,274,Center,2,Jump Shot,17.669245647969053
2017-18,201571,D.J. Augustin,PG,244,540,130,268,114,272,Center,7,Jump Shot,15.60925925925926
2018-19,201571,D.J. Augustin,PG,318,677,187,366,131,311,Center,11,Jump Shot,14.68685376661743
2019-20,201571,D.J. Augustin,PG,184,461,114,260,70,201,Center,0,Jump Shot,15.392624728850326
2020-21,201571,D.J. Augustin,PG,135,343,52,126,83,217,Center,0,Jump Shot,18.50728862973761
2021-22,201571,D.J. Augustin,PG,94,222,26,58,68,164,Center,1,Jump Shot,19.774774774774773
2011-12,202810,D.J. Kennedy,SF,5,12,3,8,2,4,Center,0,Jump Shot,17.416666666666668
2017-18,1628391,D.J. Wilson,PF,9,16,7,11,2,5,Center,3,Jump Shot,12.4375
2018-19,1628391,D.J. Wilson,PF,104,251,58,124,46,127,Center,6,Jump Shot,15.231075697211155
2019-20,1628391,D.J. Wilson,PF,52,132,34,59,18,73,Center,9,Jump Shot,16.25
2020-21,1628391,D.J. Wilson,PF,68,168,38,81,30,87,Center,6,Jump Shot,16.470238095238095
2021-22,1628391,D.J. Wilson,PF,11,15,11,13,0,2,Center,1,Step Back Jump shot,9.2
2004-05,2788,DJ Mbenga,C,6,14,6,14,0,0,Center,3,Jump Shot,5.142857142857143
2005-06,2788,DJ Mbenga,C,32,60,32,59,0,1,Center,11,Jump Shot,7.333333333333333
2006-07,2788,DJ Mbenga,C,5,16,5,16,0,0,Center,3,Layup Shot,5.5625
2007-08,2788,DJ Mbenga,C,39,84,39,84,0,0,Center,5,Jump Shot,6.285714285714286
2008-09,2788,DJ Mbenga,C,27,57,27,56,0,1,Center,2,Jump Shot,8.719298245614034
2009-10,2788,DJ Mbenga,C,48,103,48,103,0,0,Center,5,Jump Shot,8.669902912621358
2010-11,2788,DJ Mbenga,C,23,49,23,49,0,0,Center,1,Layup Shot,4.1020408163265305
2013-14,203474,DJ Stephens,SG,3,7,3,7,0,0,Center,1,Layup Shot,1.8571428571428572
2018-19,203474,DJ Stephens,SG,1,2,1,2,0,0,Center,0,Cutting Dunk Shot,0.5
2007-08,201199,DJ Strawberry,SG,29,92,23,67,6,25,Center,6,Jump Shot,12.75
2008-09,201591,DJ White,PF,26,50,26,50,0,0,Center,0,Jump Shot,7.5
2009-10,201591,DJ White,PF,25,41,25,41,0,0,Center,6,Jump Shot,10.951219512195122
2010-11,201591,DJ White,C-PF,111,219,111,217,0,2,Center,15,Jump Shot,10.474885844748858
2011-12,201591,DJ White,PF,174,353,173,352,1,1,Center,3,Jump Shot,11.152974504249292
2012-13,201591,DJ White,PF,12,23,12,23,0,0,Right Side,5,Jump Shot,13.478260869565217
2013-14,201591,DJ White,PF,0,1,0,1,0,0,Left Side,0,Jump Shot,15.0
2009-10,201969,DaJuan Summers,SF,46,130,31,88,15,42,Center,7,Jump Shot,14.046153846153846
2010-11,201969,DaJuan Summers,SF,28,69,19,48,9,21,Center,4,Jump Shot,14.73913043478261
2011-12,201969,DaJuan Summers,SF,28,65,23,49,5,16,Center,2,Jump Shot,14.323076923076924
2012-13,201969,DaJuan Summers,PF,1,4,1,4,0,0,Center,0,Jump Shot,16.5
2019-20,1629610,DaQuan Jeffries,SG,20,40,15,22,5,18,Center,3,Jump Shot,13.725
2020-21,1629610,DaQuan Jeffries,SG,50,120,30,53,20,67,Center,3,Jump Shot,15.791666666666666
2021-22,1629610,DaQuan Jeffries,SG,1,2,1,1,0,1,Center,1,Alley Oop Dunk Shot,11.5
2007-08,201161,Daequan Cook,SG,196,514,117,276,79,238,Left Side Center,10,Jump Shot,18.328793774319067
2008-09,201161,Daequan Cook,SF,242,645,89,250,153,395,Left Side Center,13,Jump Shot,20.302325581395348
2009-10,201161,Daequan Cook,SG,81,253,41,127,40,126,Left Side Center,7,Jump Shot,19.766798418972332
2010-11,201161,Daequan Cook,SG,79,181,14,27,65,154,Left Side Center,2,Jump Shot,22.668508287292816
2011-12,201161,Daequan Cook,SG,109,296,30,68,79,228,Right Side Center,4,Jump Shot,21.85472972972973
2012-13,201161,Daequan Cook,SG,51,167,25,76,26,91,Left Side Center,8,Jump Shot,19.688622754491018
2003-04,2563,Dahntay Jones,SG,15,53,14,49,1,4,Center,1,Jump Shot,10.679245283018869
2004-05,2563,Dahntay Jones,SG,83,190,60,130,23,60,Center,5,Jump Shot,13.131578947368421
2005-06,2563,Dahntay Jones,SF,109,263,106,242,3,21,Center,9,Jump Shot,10.604562737642585
2006-07,2563,Dahntay Jones,SG,220,461,215,449,5,12,Center,15,Jump Shot,9.600867678958785
2007-08,2563,Dahntay Jones,SG,23,53,22,47,1,6,Center,0,Jump Shot,9.849056603773585
2008-09,2563,Dahntay Jones,SG,154,336,143,319,11,17,Center,3,Jump Shot,7.294642857142857
2009-10,2563,Dahntay Jones,SF,287,623,283,591,4,32,Center,15,Jump Shot,10.12841091492777
2010-11,2563,Dahntay Jones,SG,100,214,86,175,14,39,Center,5,Jump Shot,12.313084112149532
2011-12,2563,Dahntay Jones,SF,115,281,82,204,33,77,Center,9,Jump Shot,12.163701067615659
2012-13,2563,Dahntay Jones,SF,82,222,71,173,11,49,Center,9,Jump Shot,11.76126126126126
2014-15,2563,Dahntay Jones,SF,6,21,6,17,0,4,Center,1,Jump Shot,12.285714285714286
2015-16,2563,Dahntay Jones,SF,6,14,5,12,1,2,Center,0,Jump Shot,11.142857142857142
2016-17,2563,Dahntay Jones,SF,3,8,3,6,0,2,Center,0,Jump Shot,10.625
2018-19,1629541,Dairis Bertans,SG,12,47,2,13,10,34,Right Side Center,0,Jump Shot,23.170212765957448
2021-22,1630227,Daishen Nix,SG,27,67,20,41,7,26,Center,3,Jump Shot,12.328358208955224
2022-23,1630227,Daishen Nix,PG,81,237,41,97,40,140,Center,6,Jump Shot,16.864978902953588
2003-04,2402,Dajuan Wagner,SG,112,306,81,220,31,86,Center,6,Jump Shot,11.709150326797385
2004-05,2402,Dajuan Wagner,SG,18,55,13,29,5,26,Center,3,Jump Shot,15.636363636363637
2006-07,2402,Dajuan Wagner,SG,1,1,0,0,1,1,Left Side,1,Jump Shot,23.0
2017-18,1626177,Dakari Johnson,C,22,39,22,39,0,0,Center,3,Layup Shot,3.871794871794872
2020-21,1629751,Dakota Mathias,SG,19,48,11,22,8,26,Center,3,Jump Shot,20.5625
2021-22,1629751,Dakota Mathias,SG,2,6,0,0,2,6,Left Side Center,2,Jump Shot,24.666666666666668
2021-22,1630625,Dalano Banton,PG,83,202,70,151,13,51,Center,8,Jump Shot,10.564356435643564
2022-23,1630625,Dalano Banton,PG,55,130,40,79,15,51,Center,7,Jump Shot,13.853846153846154
2003-04,905,Dale Davis,C,133,281,133,281,0,0,Center,1,Jump Shot,6.234875444839858
2004-05,905,Dale Davis,C,112,234,112,234,0,0,Center,3,Jump Shot,3.91025641025641
2005-06,905,Dale Davis,C,9,24,9,23,0,1,Center,1,Jump Shot,6.75
2006-07,905,Dale Davis,C,33,74,33,74,0,0,Center,2,Jump Shot,5.581081081081081
2022-23,1631207,Dalen Terry,SG,32,72,25,45,7,27,Center,11,Jump Shot,11.069444444444445
2016-17,1627745,Damian Jones,C,8,16,8,16,0,0,Center,0,Jump Shot,8.0
2017-18,1627745,Damian Jones,C,11,22,11,22,0,0,Center,2,Jump Shot,5.636363636363637
2018-19,1627745,Damian Jones,C,53,74,53,74,0,0,Center,2,Layup Shot,2.4864864864864864
2019-20,1627745,Damian Jones,C,121,178,119,169,2,9,Center,5,Alley Oop Dunk Shot,2.808988764044944
2020-21,1627745,Damian Jones,C,70,103,69,98,1,5,Center,3,Cutting Dunk Shot,5.669902912621359
2021-22,1627745,Damian Jones,C,175,266,165,237,10,29,Center,11,Jump Shot,6.958646616541353
2022-23,1627745,Damian Jones,C,55,86,45,69,10,17,Center,4,Jump Shot,6.8023255813953485
2012-13,203081,Damian Lillard,PG,553,1288,368,785,185,503,Center,29,Jump Shot,15.553571428571429
2013-14,203081,Damian Lillard,PG,553,1304,335,750,218,554,Center,29,Jump Shot,14.641104294478527
2014-15,203081,Damian Lillard,PG,590,1360,394,788,196,572,Center,41,Jump Shot,14.846323529411764
2015-16,203081,Damian Lillard,PG,618,1473,389,864,229,609,Center,32,Jump Shot,15.008825526137135
2016-17,203081,Damian Lillard,PG,661,1488,447,909,214,579,Center,28,Jump Shot,14.616263440860216
2017-18,203081,Damian Lillard,PG,621,1415,394,786,227,629,Center,33,Jump Shot,15.612720848056536
2018-19,203081,Damian Lillard,PG,681,1533,444,890,237,643,Center,38,Pullup Jump shot,15.158512720156557
2019-20,203081,Damian Lillard,PG,624,1349,354,675,270,674,Center,34,Pullup Jump shot,16.263157894736842
2020-21,203081,Damian Lillard,PG,602,1334,327,630,275,704,Center,33,Pullup Jump shot,17.426536731634183
2021-22,203081,Damian Lillard,PG,222,552,130,268,92,284,Center,6,Pullup Jump shot,17.42391304347826
2022-23,203081,Damian Lillard,PG,556,1202,312,544,244,658,Center,22,Pullup Jump shot,17.36272878535774
2015-16,203996,Damien Inglis,SF,13,36,10,24,3,12,Center,3,Jump Shot,13.416666666666666
2004-05,2863,Damien Wilkins,SF,73,168,57,109,16,59,Center,8,Jump Shot,12.422619047619047
2005-06,2863,Damien Wilkins,SF,193,435,179,379,14,56,Center,10,Jump Shot,10.471264367816092
2006-07,2863,Damien Wilkins,SF,262,602,212,480,50,122,Center,8,Jump Shot,12.662790697674419
2007-08,2863,Damien Wilkins,SF,271,673,221,518,50,155,Center,12,Jump Shot,14.200594353640415
2008-09,2863,Damien Wilkins,SG,77,213,50,141,27,72,Center,6,Jump Shot,14.826291079812206
2009-10,2863,Damien Wilkins,SF,165,381,147,320,18,61,Center,4,Jump Shot,11.766404199475065
2010-11,2863,Damien Wilkins,SF,69,137,67,127,2,10,Center,2,Jump Shot,8.941605839416058
2011-12,2863,Damien Wilkins,SF,76,193,69,170,7,23,Center,4,Jump Shot,12.05181347150259
2012-13,2863,Damien Wilkins,SG,145,316,128,265,17,51,Center,4,Jump Shot,11.518987341772151
2017-18,2863,Damien Wilkins,SF,13,39,9,21,4,18,Center,2,Jump Shot,15.102564102564102
2010-11,202345,Damion James,SF,46,103,46,100,0,3,Center,1,Jump Shot,9.514563106796116
2011-12,202345,Damion James,SF,13,35,13,34,0,1,Center,1,Jump Shot,10.17142857142857
2013-14,202345,Damion James,SF,2,9,2,7,0,2,Right Side,0,Jump Shot,14.444444444444445
2017-18,1627814,Damion Lee,SG,62,152,47,92,15,60,Center,1,Jump Shot,14.585526315789474
2018-19,1627814,Damion Lee,SG,56,127,29,59,27,68,Center,7,Jump Shot,17.80314960629921
2019-20,1627814,Damion Lee,SG,213,511,128,272,85,239,Center,10,Jump Shot,16.434442270058707
2020-21,1627814,Damion Lee,SG,128,274,51,80,77,194,Center,6,Jump Shot,19.82116788321168
2021-22,1627814,Damion Lee,SG,169,383,106,196,63,187,Center,7,Jump Shot,15.932114882506527
2022-23,1627814,Damion Lee,SG,200,452,90,205,110,247,Center,12,Jump Shot,17.057522123893804
2006-07,200806,Damir Markota,PF,19,52,13,36,6,16,Center,8,Jump Shot,13.903846153846153
2014-15,204014,Damjan Rudez,SF,119,263,50,93,69,170,Left Side,10,Jump Shot,20.231939163498097
2015-16,204014,Damjan Rudez,SF,25,62,8,12,17,50,Center,3,Jump Shot,20.338709677419356
2016-17,204014,Damjan Rudez,SF,31,88,11,24,20,64,Left Side Center,3,Jump Shot,21.852272727272727
2003-04,1800,Damon Jones,PG,210,524,112,251,98,273,Left Side Center,10,Jump Shot,18.778625954198475
2004-05,1800,Damon Jones,PG,331,726,106,205,225,521,Left Side Center,18,Jump Shot,20.993112947658403
2005-06,1800,Damon Jones,PG,190,491,50,120,140,371,Left Side Center,7,Jump Shot,21.19551934826884
2006-07,1800,Damon Jones,PG,137,355,48,124,89,231,Right Side,8,Jump Shot,20.515492957746478
2007-08,1800,Damon Jones,SG,151,363,36,87,115,276,Right Side,9,Jump Shot,21.085399449035812
2008-09,1800,Damon Jones,PG,11,34,0,6,11,28,Left Side Center,1,Jump Shot,23.235294117647058
2003-04,757,Damon Stoudamire,PG,408,1018,252,591,156,427,Center,23,Jump Shot,16.860510805500983
2004-05,757,Damon Stoudamire,PG,457,1165,276,675,181,490,Center,22,Jump Shot,17.113304721030044
2005-06,757,Damon Stoudamire,PG,114,287,78,183,36,104,Center,12,Jump Shot,14.547038327526133
2006-07,757,Damon Stoudamire,PG,171,437,112,262,59,175,Center,7,Jump Shot,16.876430205949656
2007-08,757,Damon Stoudamire,PG,120,337,70,188,50,149,Center,9,Jump Shot,17.189910979228486
2003-04,2245,Damone Brown,PF,1,10,1,10,0,0,Center,1,Jump Shot,5.3
2004-05,2245,Damone Brown,SF,23,62,19,51,4,11,Center,1,Jump Shot,12.241935483870968
2017-18,1628422,Damyean Dotson,SG,72,161,50,93,22,68,Center,8,Jump Shot,16.229813664596275
2018-19,1628422,Damyean Dotson,SG,290,698,164,356,126,342,Center,15,Jump Shot,17.73925501432665
2019-20,1628422,Damyean Dotson,SG,120,290,61,127,59,163,Center,8,Jump Shot,19.082758620689656
2020-21,1628422,Damyean Dotson,SG,119,293,73,134,46,159,Center,6,Jump Shot,17.901023890784984
2021-22,1628422,Damyean Dotson,SG,2,4,2,3,0,1,Right Side,0,Fadeaway Jump Shot,10.75
2003-04,2424,Dan Dickau,PG,37,98,27,68,10,30,Center,11,Jump Shot,13.622448979591837
2004-05,2424,Dan Dickau,PG,306,756,221,511,85,245,Center,23,Jump Shot,14.678571428571429
2005-06,2424,Dan Dickau,PG,17,46,7,26,10,20,Center,1,Jump Shot,16.543478260869566
2006-07,2424,Dan Dickau,PG,54,151,38,90,16,61,Center,10,Jump Shot,16.496688741721854
2007-08,2424,Dan Dickau,PG,124,296,88,188,36,108,Center,18,Jump Shot,16.381756756756758
2003-04,2429,Dan Gadzuric,C,183,349,183,348,0,1,Center,9,Jump Shot,3.6303724928366763
2004-05,2429,Dan Gadzuric,C,243,451,243,451,0,0,Center,1,Layup Shot,1.951219512195122
2005-06,2429,Dan Gadzuric,C,171,309,171,308,0,1,Center,4,Jump Shot,3.116504854368932
2006-07,2429,Dan Gadzuric,C,108,228,108,227,0,1,Center,0,Layup Shot,3.539473684210526
2007-08,2429,Dan Gadzuric,C,64,154,64,153,0,1,Center,7,Jump Shot,3.961038961038961
2008-09,2429,Dan Gadzuric,C,117,244,117,242,0,2,Center,3,Jump Shot,6.80327868852459
2009-10,2429,Dan Gadzuric,C,39,89,39,89,0,0,Center,1,Layup Shot,4.853932584269663
2010-11,2429,Dan Gadzuric,C-PF,54,129,54,128,0,1,Center,0,Jump Shot,5.62015503875969
2011-12,2429,Dan Gadzuric,C,0,2,0,2,0,0,Center,0,Layup Shot,1.5
2003-04,2061,Dan Langhi,SF,5,14,4,12,1,2,Left Side,0,Jump Shot,15.571428571428571
2003-04,344,Dana Barros,SG,2,3,2,3,0,0,Left Side,0,Jump Shot,19.666666666666668
2005-06,101137,Daniel Ewing,SG,97,255,75,177,22,78,Center,11,Jump Shot,15.411764705882353
2006-07,101137,Daniel Ewing,PG,65,161,51,117,14,44,Center,8,Jump Shot,16.453416149068325
2019-20,1629655,Daniel Gafford,C,94,134,94,134,0,0,Center,4,Layup Shot,1.3656716417910448
2020-21,1629655,Daniel Gafford,PF-C,154,225,154,225,0,0,Center,6,Layup Shot,2.831111111111111
2021-22,1629655,Daniel Gafford,C,285,411,285,410,0,1,Center,7,Layup Shot,2.4452554744525545
2022-23,1629655,Daniel Gafford,C,289,395,289,395,0,0,Center,6,Layup Shot,2.8227848101265822
2006-07,200789,Daniel Gibson,PG,98,231,46,107,52,124,Center,5,Jump Shot,17.138528138528137
2007-08,200789,Daniel Gibson,PG,201,465,83,197,118,268,Center,11,Jump Shot,19.260215053763442
2008-09,200789,Daniel Gibson,PG,206,527,98,244,108,283,Left Side Center,14,Jump Shot,18.753320683111955
2009-10,200789,Daniel Gibson,PG,125,268,54,119,71,149,Left Side Center,10,Jump Shot,18.746268656716417
2010-11,200789,Daniel Gibson,SG,264,660,146,367,118,293,Center,14,Jump Shot,16.796969696969697
2011-12,200789,Daniel Gibson,SG,87,248,32,109,55,139,Center,7,Jump Shot,18.891129032258064
2012-13,200789,Daniel Gibson,PG,84,247,28,84,56,163,Left Side Center,5,Jump Shot,21.562753036437247
2017-18,1627772,Daniel Hamilton,SG,5,11,3,6,2,5,Center,2,Jump Shot,14.454545454545455
2018-19,1627772,Daniel Hamilton,SG,23,60,15,37,8,23,Center,3,Jump Shot,12.166666666666666
2016-17,1627849,Daniel Ochefu,C,12,27,12,27,0,0,Center,3,Jump Shot,3.4444444444444446
2011-12,202350,Daniel Orton,PF,17,30,17,29,0,1,Center,1,Layup Shot,2.7333333333333334
2012-13,202350,Daniel Orton,C,12,26,12,26,0,0,Center,2,Layup Shot,3.3846153846153846
2013-14,202350,Daniel Orton,C,21,47,21,47,0,0,Center,0,Jump Shot,6.425531914893617
2020-21,1630187,Daniel Oturu,C,22,52,21,47,1,5,Center,9,Jump Shot,6.730769230769231
2021-22,1630187,Daniel Oturu,C,3,6,3,5,0,1,Center,1,Layup Shot,6.333333333333333
2003-04,2091,Daniel Santiago,C,78,163,78,163,0,0,Center,3,Layup Shot,4.392638036809816
2004-05,2091,Daniel Santiago,C,7,21,7,21,0,0,Center,2,Jump Shot,6.333333333333333
2017-18,1628464,Daniel Theis,C,126,233,108,175,18,58,Center,1,Jump Shot,9.88412017167382
2018-19,1628464,Daniel Theis,C,146,266,120,199,26,67,Center,3,Jump Shot,9.642857142857142
2019-20,1628464,Daniel Theis,C,241,426,209,330,32,96,Center,9,Jump Shot,8.715962441314554
2020-21,1628464,Daniel Theis,C,252,466,203,314,49,152,Center,9,Jump Shot,12.141630901287554
2021-22,1628464,Daniel Theis,C,151,291,118,184,33,107,Center,3,Jump Shot,11.962199312714777
2022-23,1628464,Daniel Theis,C,21,44,19,33,2,11,Center,0,Jump Shot,9.909090909090908
2008-09,201568,Danilo Gallinari,SG,56,125,24,53,32,72,Right Side Center,4,Jump Shot,18.56
2009-10,201568,Danilo Gallinari,SF,392,927,206,439,186,488,Center,12,Jump Shot,17.833872707659115
2010-11,201568,Danilo Gallinari,PF-SF,265,640,162,347,103,293,Center,12,Jump Shot,15.615625
2011-12,201568,Danilo Gallinari,SF,193,466,133,283,60,183,Center,4,Jump Shot,14.379828326180258
2012-13,201568,Danilo Gallinari,SF,364,870,229,509,135,361,Center,10,Jump Shot,15.058620689655172
2014-15,201568,Danilo Gallinari,SF,228,568,121,267,107,301,Center,8,Jump Shot,17.7306338028169
2015-16,201568,Danilo Gallinari,SF,287,700,200,461,87,239,Center,8,Jump Shot,14.441428571428572
2016-17,201568,Danilo Gallinari,SF,335,750,209,426,126,324,Center,10,Jump Shot,16.106666666666666
2017-18,201568,Danilo Gallinari,SF,102,256,66,145,36,111,Center,5,Jump Shot,16.375
2018-19,201568,Danilo Gallinari,SF,409,884,248,512,161,372,Center,9,Jump Shot,15.606334841628959
2019-20,201568,Danilo Gallinari,PF,358,817,180,378,178,439,Center,11,Jump Shot,17.99265605875153
2020-21,201568,Danilo Gallinari,PF,206,475,103,221,103,254,Center,3,Jump Shot,18.877894736842105
2021-22,201568,Danilo Gallinari,PF,259,597,147,303,112,294,Center,4,Jump Shot,17.877721943048577
2003-04,1504,Danny Fortson,C,71,139,71,139,0,0,Center,1,Layup Shot,2.143884892086331
2004-05,1504,Danny Fortson,C,118,226,118,226,0,0,Center,4,Layup Shot,0.7610619469026548
2005-06,1504,Danny Fortson,C,27,51,27,51,0,0,Center,0,Layup Shot,1.196078431372549
2006-07,1504,Danny Fortson,C,15,30,15,29,0,1,Center,0,Layup Shot,2.2666666666666666
2005-06,101122,Danny Granger,SF,221,478,191,385,30,93,Center,17,Jump Shot,12.460251046025105
2006-07,101122,Danny Granger,SF,398,868,288,580,110,288,Center,21,Jump Shot,14.414746543778802
2007-08,101122,Danny Granger,SF,537,1205,366,782,171,423,Center,18,Jump Shot,15.120331950207468
2008-09,101122,Danny Granger,SF,571,1277,389,827,182,450,Center,26,Jump Shot,15.330462020360219
2009-10,101122,Danny Granger,SF,487,1137,330,701,157,436,Center,19,Jump Shot,14.98504837291117
2010-11,101122,Danny Granger,SF,535,1260,378,853,157,407,Center,10,Jump Shot,14.396825396825397
2011-12,101122,Danny Granger,SF,391,940,268,618,123,322,Center,15,Jump Shot,14.372340425531915
2012-13,101122,Danny Granger,SF,10,35,8,25,2,10,Center,0,Jump Shot,16.0
2013-14,101122,Danny Granger,SF,116,307,73,179,43,128,Center,2,Jump Shot,15.45928338762215
2014-15,101122,Danny Granger,SF,65,162,35,78,30,84,Center,3,Jump Shot,17.604938271604937
2009-10,201980,Danny Green,SG,15,39,9,17,6,22,Center,6,Jump Shot,17.23076923076923
2010-11,201980,Danny Green,SG,17,35,10,16,7,19,Center,2,Jump Shot,17.37142857142857
2011-12,201980,Danny Green,SG,211,477,109,243,102,234,Center,14,Jump Shot,15.371069182389936
2012-13,201980,Danny Green,SG,297,663,120,250,177,413,Center,6,Jump Shot,17.992458521870287
2013-14,201980,Danny Green,SG,218,505,86,187,132,318,Center,6,Jump Shot,18.708910891089108
2014-15,201980,Danny Green,SG,322,738,131,281,191,457,Center,9,Jump Shot,18.039295392953928
2015-16,201980,Danny Green,SG,210,559,95,212,115,347,Center,3,Jump Shot,18.35062611806798
2016-17,201980,Danny Green,SG,176,449,58,138,118,311,Center,9,Jump Shot,19.474387527839642
2017-18,201980,Danny Green,SG,217,561,101,241,116,320,Center,7,Jump Shot,17.204991087344027
2018-19,201980,Danny Green,SG,293,630,95,195,198,435,Center,11,Jump Shot,19.13015873015873
2019-20,201980,Danny Green,SG,197,474,77,147,120,327,Center,5,Jump Shot,18.924050632911392
2020-21,201980,Danny Green,SF,224,544,49,112,175,432,Right Side,5,Jump Shot,21.045955882352942
2021-22,201980,Danny Green,SF,126,320,23,49,103,271,Right Side,4,Jump Shot,21.365625
2022-23,201980,Danny Green,SG,22,49,6,12,16,37,Center,0,Jump Shot,20.93877551020408
2009-10,201967,Dante Cunningham,PF,106,214,106,212,0,2,Center,11,Jump Shot,12.677570093457945
2010-11,201967,Dante Cunningham,PF,218,472,217,459,1,13,Center,5,Jump Shot,12.413135593220339
2011-12,201967,Dante Cunningham,PF,144,279,144,277,0,2,Center,5,Jump Shot,9.741935483870968
2012-13,201967,Dante Cunningham,PF,314,671,314,665,0,6,Center,21,Jump Shot,12.560357675111774
2013-14,201967,Dante Cunningham,PF,236,509,236,504,0,5,Center,4,Jump Shot,13.387033398821218
2014-15,201967,Dante Cunningham,PF,155,339,154,329,1,10,Center,7,Jump Shot,13.277286135693215
2015-16,201967,Dante Cunningham,SF,186,412,131,238,55,174,Center,6,Jump Shot,14.490291262135923
2016-17,201967,Dante Cunningham,PF,173,358,103,178,70,180,Center,5,Jump Shot,14.824022346368714
2017-18,201967,Dante Cunningham,SF,164,364,106,196,58,168,Center,3,Jump Shot,13.052197802197803
2018-19,201967,Dante Cunningham,PF,75,158,45,93,30,65,Center,6,Jump Shot,13.240506329113924
2014-15,203957,Dante Exum,PG,145,416,62,152,83,264,Center,2,Jump Shot,18.411057692307693
2016-17,203957,Dante Exum,PG,155,363,111,214,44,149,Center,7,Jump Shot,11.829201101928374
2017-18,203957,Dante Exum,PG,42,87,37,69,5,18,Center,0,Driving Layup Shot,8.0
2018-19,203957,Dante Exum,PG,101,241,83,179,18,62,Center,8,Driving Layup Shot,8.551867219917012
2019-20,203957,Dante Exum,SG,56,119,41,76,15,43,Center,3,Jump Shot,10.941176470588236
2020-21,203957,Dante Exum,SG,10,26,8,15,2,11,Center,0,Jump Shot,12.576923076923077
2017-18,1627863,Danuel House Jr.,SG,56,129,41,71,15,58,Center,9,Jump Shot,13.48062015503876
2018-19,1627863,Danuel House Jr.,SF,118,252,44,74,74,178,Center,6,Jump Shot,17.8015873015873
2019-20,1627863,Danuel House Jr.,SF,230,539,101,184,129,355,Center,7,Jump Shot,17.163265306122447
2020-21,1627863,Danuel House Jr.,SF,110,272,56,116,54,156,Center,3,Jump Shot,16.540441176470587
2021-22,1627863,Danuel House Jr.,SF,80,198,36,81,44,117,Center,1,Jump Shot,16.42929292929293
2022-23,1627863,Danuel House Jr.,SF,93,197,56,87,37,110,Center,4,Jump Shot,15.380710659898478
2011-12,202359,Darington Hobson,SG,2,13,2,7,0,6,Center,0,Jump Shot,17.0
2016-17,203967,Dario Saric,PF,380,926,275,586,105,340,Center,13,Jump Shot,13.587473002159827
2017-18,203967,Dario Saric,PF,403,890,246,491,157,399,Center,16,Jump Shot,15.021348314606742
2018-19,203967,Dario Saric,PF,304,696,186,373,118,323,Center,7,Jump Shot,14.567528735632184
2019-20,203967,Dario Saric,PF,256,538,172,303,84,235,Center,7,Jump Shot,13.488847583643123
2020-21,203967,Dario Saric,C,153,342,106,207,47,135,Center,2,Jump Shot,13.011695906432749
2022-23,203967,Dario Saric,PF,127,277,82,162,45,115,Center,7,Jump Shot,13.494584837545126
2019-20,1629647,Darius Bazley,PF,125,317,76,176,49,141,Center,6,Jump Shot,13.290220820189274
2020-21,1629647,Darius Bazley,PF,273,690,190,404,83,286,Center,10,Jump Shot,12.807246376811595
2021-22,1629647,Darius Bazley,PF,274,649,194,380,80,269,Center,8,Jump Shot,12.2095531587057
2022-23,1629647,Darius Bazley,PF,83,183,63,130,20,53,Center,5,Jump Shot,9.46448087431694
2022-23,1630620,Darius Days,PF,5,12,2,2,3,10,Left Side,3,Jump Shot,19.916666666666668
2019-20,1629636,Darius Garland,SG,280,699,175,403,105,296,Center,13,Jump Shot,15.510729613733906
2020-21,1629636,Darius Garland,PG,362,802,257,536,105,266,Center,10,Jump Shot,12.609725685785536
2021-22,1629636,Darius Garland,PG,542,1173,368,719,174,454,Center,19,Jump Shot,15.019607843137255
2022-23,1629636,Darius Garland,PG,522,1129,353,717,169,412,Center,19,Pullup Jump shot,14.571302037201063
2012-13,203130,Darius Johnson-Odom,SG,0,4,0,3,0,1,Center,0,Jump Shot,13.25
2013-14,203130,Darius Johnson-Odom,SG,0,7,0,4,0,3,Center,0,Jump Shot,18.714285714285715
2003-04,2032,Darius Miles,SF,365,753,358,713,7,40,Center,10,Jump Shot,7.876494023904383
2004-05,2032,Darius Miles,SF,336,697,328,674,8,23,Center,16,Jump Shot,8.67431850789096
2005-06,2032,Darius Miles,SF,235,510,233,500,2,10,Center,11,Jump Shot,10.096078431372549
2008-09,2032,Darius Miles,SF,48,99,47,93,1,6,Center,6,Jump Shot,9.272727272727273
2012-13,203121,Darius Miller,SF,44,108,22,52,22,56,Center,4,Jump Shot,16.796296296296298
2013-14,203121,Darius Miller,SF,73,166,48,89,25,77,Center,8,Jump Shot,18.174698795180724
2014-15,203121,Darius Miller,SF,1,7,1,6,0,1,Center,0,Jump Shot,14.857142857142858
2017-18,203121,Darius Miller,SF,216,487,69,129,147,358,Right Side Center,11,Jump Shot,21.942505133470227
2018-19,203121,Darius Miller,SF,189,484,56,120,133,364,Center,6,Jump Shot,21.787190082644628
2020-21,203121,Darius Miller,SF,22,48,5,6,17,42,Left Side Center,1,Jump Shot,24.4375
2011-12,202721,Darius Morris,PG,18,42,14,33,4,9,Center,7,Jump Shot,12.071428571428571
2012-13,202721,Darius Morris,PG,73,188,49,122,24,66,Center,9,Jump Shot,12.26595744680851
2013-14,202721,Darius Morris,PG,39,96,27,58,12,38,Center,0,Jump Shot,14.770833333333334
2014-15,202721,Darius Morris,PG,36,106,29,73,7,33,Center,4,Jump Shot,12.745283018867925
2003-04,2443,Darius Songaila,PF,133,273,133,273,0,0,Center,9,Jump Shot,5.798534798534798
2004-05,2443,Darius Songaila,PF,257,488,257,485,0,3,Center,4,Jump Shot,9.493852459016393
2005-06,2443,Darius Songaila,PF,236,491,234,486,2,5,Center,7,Jump Shot,10.128309572301426
2006-07,2443,Darius Songaila,PF,118,225,118,223,0,2,Center,6,Jump Shot,10.413333333333334
2007-08,2443,Darius Songaila,C,214,467,214,465,0,2,Center,6,Jump Shot,8.89507494646681
2008-09,2443,Darius Songaila,C,243,457,243,456,0,1,Center,5,Jump Shot,8.796498905908097
2009-10,2443,Darius Songaila,C,241,488,240,482,1,6,Center,11,Jump Shot,11.721311475409836
2010-11,2443,Darius Songaila,C,7,15,7,15,0,0,Center,0,Jump Shot,11.6
2007-08,200827,Darius Washington,SG,21,48,17,36,4,12,Center,1,Jump Shot,13.208333333333334
2003-04,2545,Darko Milicic,C,17,65,17,64,0,1,Center,9,Jump Shot,7.723076923076923
2004-05,2545,Darko Milicic,C,25,76,25,76,0,0,Center,4,Jump Shot,10.026315789473685
2005-06,2545,Darko Milicic,C,119,234,119,232,0,2,Center,7,Jump Shot,10.11965811965812
2006-07,2545,Darko Milicic,PF,249,548,249,547,0,1,Center,8,Hook Shot,5.531021897810219
2007-08,2545,Darko Milicic,C,219,500,219,499,0,1,Center,2,Jump Shot,5.398
2008-09,2545,Darko Milicic,C,137,266,137,266,0,0,Center,2,Layup Shot,3.781954887218045
2009-10,2545,Darko Milicic,C,100,204,100,203,0,1,Center,1,Jump Shot,6.911764705882353
2010-11,2545,Darko Milicic,C,271,578,271,578,0,0,Center,5,Jump Shot,4.56401384083045
2011-12,2545,Darko Milicic,C,59,130,59,130,0,0,Center,0,Layup Shot,3.776923076923077
2012-13,2545,Darko Milicic,C,0,1,0,1,0,0,Center,0,Jump Shot,5.0
2008-09,201616,Darnell Jackson,PF,37,86,37,84,0,2,Center,7,Jump Shot,9.627906976744185
2009-10,201616,Darnell Jackson,PF,9,30,8,26,1,4,Center,1,Jump Shot,8.233333333333333
2010-11,201616,Darnell Jackson,PF,77,158,74,147,3,11,Center,7,Jump Shot,10.00632911392405
2003-04,353,Darrell Armstrong,PG,291,736,156,307,135,429,Center,9,Jump Shot,18.20923913043478
2004-05,353,Darrell Armstrong,PG,89,277,61,166,28,111,Center,8,Jump Shot,16.826714801444044
2005-06,353,Darrell Armstrong,PG,43,128,32,80,11,48,Center,10,Jump Shot,16.0546875
2006-07,353,Darrell Armstrong,PG,156,377,84,163,72,214,Center,5,Jump Shot,19.0053050397878
2007-08,353,Darrell Armstrong,PG,40,110,17,41,23,69,Center,6,Jump Shot,22.618181818181817
2008-09,201589,Darrell Arthur,PF,191,436,191,434,0,2,Center,5,Jump Shot,8.497706422018348
2009-10,201589,Darrell Arthur,PF,63,146,63,145,0,1,Center,2,Jump Shot,8.253424657534246
2010-11,201589,Darrell Arthur,PF,310,624,310,618,0,6,Center,3,Jump Shot,10.23397435897436
2012-13,201589,Darrell Arthur,PF,162,359,157,341,5,18,Center,6,Jump Shot,11.426183844011142
2013-14,201589,Darrell Arthur,SF,162,410,138,346,24,64,Center,2,Jump Shot,15.348780487804879
2014-15,201589,Darrell Arthur,PF,155,384,129,274,26,110,Center,3,Jump Shot,16.315104166666668
2015-16,201589,Darrell Arthur,PF,221,489,176,372,45,117,Center,6,Jump Shot,14.599182004089979
2016-17,201589,Darrell Arthur,PF,95,215,42,98,53,117,Center,3,Jump Shot,18.344186046511627
2017-18,201589,Darrell Arthur,PF,22,47,14,24,8,23,Center,2,Jump Shot,17.76595744680851
2009-10,201954,Darren Collison,PG,376,789,330,674,46,115,Center,32,Jump Shot,11.183776932826362
2010-11,201954,Darren Collison,PG,398,870,357,746,41,124,Center,27,Jump Shot,11.568965517241379
2011-12,201954,Darren Collison,PG,230,523,196,429,34,94,Center,9,Jump Shot,12.390057361376673
2012-13,201954,Darren Collison,PG,341,724,293,588,48,136,Center,15,Jump Shot,11.664364640883978
2013-14,201954,Darren Collison,PG,324,693,253,505,71,188,Center,22,Jump Shot,13.45021645021645
2014-15,201954,Darren Collison,PG,260,550,200,389,60,161,Center,9,Jump Shot,14.223636363636365
2015-16,201954,Darren Collison,PG,377,776,290,559,87,217,Center,19,Jump Shot,13.314432989690722
2016-17,201954,Darren Collison,PG,340,714,267,539,73,175,Center,18,Jump Shot,13.428571428571429
2017-18,201954,Darren Collison,PG,316,638,220,433,96,205,Center,17,Jump Shot,15.282131661442007
2018-19,201954,Darren Collison,PG,308,659,229,465,79,194,Center,16,Pullup Jump shot,14.681335356600911
2021-22,201954,Darren Collison,PG,2,7,2,4,0,3,Left Side,0,Jump Shot,15.714285714285714
2003-04,239,Darrick Martin,PG,20,67,14,41,6,26,Center,2,Jump Shot,15.343283582089553
2004-05,239,Darrick Martin,PG,16,50,11,32,5,18,Center,2,Jump Shot,16.62
2005-06,239,Darrick Martin,PG,34,97,18,57,16,40,Center,6,Jump Shot,16.804123711340207
2006-07,239,Darrick Martin,PG,33,94,20,57,13,37,Center,5,Jump Shot,16.872340425531913
2007-08,239,Darrick Martin,PG,10,43,8,27,2,16,Center,1,Jump Shot,17.325581395348838
2015-16,1626199,Darrun Hilliard,SG,52,131,33,81,19,50,Center,9,Jump Shot,15.816793893129772
2016-17,1626199,Darrun Hilliard,SG,47,126,35,80,12,46,Center,5,Jump Shot,16.22222222222222
2017-18,1626199,Darrun Hilliard,SG,5,19,5,13,0,6,Center,2,Jump Shot,13.736842105263158
2007-08,201208,Darryl Watkins,C,5,15,5,15,0,0,Center,2,Jump Shot,8.2
2011-12,201208,Darryl Watkins,C,7,14,7,14,0,0,Center,0,Jump Shot,8.714285714285714
2003-04,1032,Darvin Ham,SF,37,75,36,73,1,2,Center,5,Jump Shot,5.613333333333333
2004-05,1032,Darvin Ham,SF,17,37,17,37,0,0,Center,3,Layup Shot,4.324324324324325
2018-19,1629133,Daryl Macon,SG,10,27,5,16,5,11,Center,3,Jump Shot,17.59259259259259
2019-20,1629133,Daryl Macon,PG,1,3,0,1,1,2,Left Side Center,0,Jump Shot,22.0
2009-10,2431,David Andersen,C,147,340,120,262,27,78,Center,2,Jump Shot,13.66764705882353
2010-11,2431,David Andersen,PF,56,121,48,98,8,23,Center,2,Jump Shot,15.826446280991735
2021-22,1630561,David Duke Jr.,PG,39,108,30,71,9,37,Center,3,Jump Shot,10.11111111111111
2022-23,1630561,David Duke Jr.,SG,36,78,35,66,1,12,Center,5,Driving Layup Shot,6.512820512820513
2004-05,2758,David Harrison,C,106,184,106,184,0,0,Center,6,Layup Shot,4.418478260869565
2005-06,2758,David Harrison,C,148,294,148,294,0,0,Center,8,Layup Shot,4.244897959183674
2006-07,2758,David Harrison,C,30,58,30,58,0,0,Center,4,Layup Shot,4.068965517241379
2007-08,2758,David Harrison,C,90,170,90,170,0,0,Center,3,Layup Shot,4.629411764705883
2021-22,1630525,David Johnson,SG,0,1,0,0,0,1,Right Side Center,0,Jump Shot,26.0
2005-06,101135,David Lee,SF,137,229,137,229,0,0,Center,12,Layup Shot,4.25764192139738
2006-07,101135,David Lee,PF,240,400,240,400,0,0,Center,11,Layup Shot,3.12
2007-08,101135,David Lee,PF,341,618,341,616,0,2,Center,16,Layup Shot,3.3446601941747574
2008-09,101135,David Lee,C,522,951,522,948,0,3,Center,14,Layup Shot,4.520504731861199
2009-10,101135,David Lee,C,686,1258,686,1250,0,8,Center,29,Jump Shot,7.660572337042925
2010-11,101135,David Lee,PF,496,978,495,975,1,3,Center,11,Jump Shot,8.463190184049079
2011-12,101135,David Lee,PF,464,922,464,917,0,5,Center,15,Jump Shot,6.996746203904555
2012-13,101135,David Lee,PF,602,1160,602,1156,0,4,Center,19,Jump Shot,7.301724137931035
2013-14,101135,David Lee,PF,513,981,513,980,0,1,Center,12,Jump Shot,5.229357798165138
2014-15,101135,David Lee,PF,160,313,160,311,0,2,Center,2,Jump Shot,5.63258785942492
2015-16,101135,David Lee,PF,178,335,178,334,0,1,Center,1,Layup Shot,3.9492537313432834
2016-17,101135,David Lee,PF,248,420,248,420,0,0,Center,2,Jump Shot,4.197619047619048
2006-07,200786,David Noel,PF,65,177,48,124,17,53,Center,5,Jump Shot,14.112994350282486
2016-17,1628021,David Nwaba,SG,47,80,46,76,1,4,Center,4,Layup Shot,3.2625
2017-18,1628021,David Nwaba,SG,202,423,184,371,18,52,Center,4,Driving Layup Shot,5.612293144208038
2018-19,1628021,David Nwaba,SF,126,262,102,187,24,75,Center,2,Jump Shot,9.580152671755725
2019-20,1628021,David Nwaba,SF,37,71,25,43,12,28,Center,2,Jump Shot,11.028169014084508
2020-21,1628021,David Nwaba,SF,106,218,89,155,17,63,Center,1,Jump Shot,8.76605504587156
2021-22,1628021,David Nwaba,SF,85,176,70,127,15,49,Center,7,Jump Shot,8.539772727272727
2022-23,1631223,David Roddy,PF,180,420,115,208,65,212,Center,11,Jump Shot,14.023809523809524
2014-15,204065,David Stockton,PG,2,6,1,4,1,2,Center,0,Jump Shot,11.0
2017-18,204065,David Stockton,PG,2,3,0,0,2,3,Center,1,Jump Shot,25.666666666666668
2014-15,204033,David Wear,PF,0,2,0,1,0,1,Left Side Center,0,Jump Shot,12.0
2003-04,133,David Wesley,SG,311,800,219,515,92,285,Center,8,Jump Shot,17.6975
2004-05,133,David Wesley,SG,334,840,216,525,118,315,Center,9,Jump Shot,17.705952380952382
2005-06,133,David Wesley,SG,226,561,127,290,99,271,Center,13,Jump Shot,17.855614973262032
2006-07,133,David Wesley,SG,22,75,13,37,9,38,Center,4,Jump Shot,18.413333333333334
2003-04,2561,David West,PF,108,228,108,226,0,2,Center,7,Layup Shot,3.232456140350877
2004-05,2561,David West,SF,75,172,73,167,2,5,Center,3,Jump Shot,8.36046511627907
2005-06,2561,David West,PF,530,1036,527,1025,3,11,Center,17,Jump Shot,9.632239382239382
2006-07,2561,David West,PF,377,792,369,767,8,25,Center,17,Jump Shot,9.916666666666666
2007-08,2561,David West,PF,629,1305,623,1280,6,25,Center,12,Jump Shot,9.55095785440613
2008-09,2561,David West,PF,610,1292,604,1267,6,25,Center,28,Jump Shot,9.951238390092879
2009-10,2561,David West,PF,619,1226,612,1199,7,27,Center,21,Jump Shot,8.730831973898859
2010-11,2561,David West,PF,528,1040,526,1031,2,9,Center,28,Jump Shot,9.572115384615385
2011-12,2561,David West,PF,349,716,347,707,2,9,Center,12,Jump Shot,9.006983240223464
2012-13,2561,David West,PF,502,1008,498,990,4,18,Center,25,Jump Shot,9.387896825396826
2013-14,2561,David West,PF,458,939,454,924,4,15,Center,12,Jump Shot,10.143769968051119
2014-15,2561,David West,PF,323,686,319,666,4,20,Center,13,Jump Shot,12.329446064139942
2015-16,2561,David West,PF,244,448,241,441,3,7,Center,2,Jump Shot,10.140625
2016-17,2561,David West,C,135,252,132,244,3,8,Center,1,Jump Shot,10.591269841269842
2017-18,2561,David West,C,216,378,213,370,3,8,Center,0,Jump Shot,9.16931216931217
2021-22,1630558,Davion Mitchell,PG,352,843,251,523,101,320,Center,14,Jump Shot,15.068801897983393
2022-23,1630558,Davion Mitchell,PG,181,399,118,202,63,197,Center,9,Jump Shot,15.927318295739349
2016-17,202722,Davis Bertans,PF,103,234,34,61,69,173,Center,8,Jump Shot,19.91025641025641
2017-18,202722,Davis Bertans,PF,161,366,67,114,94,252,Center,9,Jump Shot,19.666666666666668
2018-19,202722,Davis Bertans,PF,204,453,59,115,145,338,Center,7,Jump Shot,21.32450331125828
2019-20,202722,Davis Bertans,PF,265,610,65,138,200,472,Center,8,Jump Shot,21.731147540983606
2020-21,202722,Davis Bertans,PF,193,478,24,50,169,428,Right Side Center,1,Jump Shot,24.292887029288703
2021-22,202722,Davis Bertans,PF,99,275,22,45,77,230,Center,2,Jump Shot,22.505454545454544
2022-23,202722,Davis Bertans,PF,69,160,14,19,55,141,Center,2,Jump Shot,22.86875
2017-18,1628432,Davon Reed,SG,22,76,11,38,11,38,Center,3,Jump Shot,17.68421052631579
2018-19,1628432,Davon Reed,SG,5,12,3,8,2,4,Center,1,Jump Shot,14.583333333333334
2021-22,1628432,Davon Reed,SG,81,161,44,75,37,86,Center,6,Jump Shot,17.440993788819874
2022-23,1628432,Davon Reed,SG,28,84,11,38,17,46,Left Side Center,5,Jump Shot,18.107142857142858
2021-22,1630549,Day'Ron Sharpe,PF,86,149,84,142,2,7,Center,12,Tip Layup Shot,2.8120805369127515
2022-23,1630549,Day'Ron Sharpe,C,93,171,87,160,6,11,Center,9,Tip Layup Shot,3.4327485380116958
2017-18,1628368,De'Aaron Fox,PG,328,797,281,644,47,153,Center,31,Jump Shot,12.026348808030113
2018-19,1628368,De'Aaron Fox,PG,505,1102,419,870,86,232,Center,26,Jump Shot,11.077132486388384
2019-20,1628368,De'Aaron Fox,PG,391,815,337,630,54,185,Center,26,Driving Layup Shot,10.260122699386503
2020-21,1628368,De'Aaron Fox,PG,529,1110,426,790,103,320,Center,33,Driving Layup Shot,12.413513513513514
2021-22,1628368,De'Aaron Fox,PG,516,1092,442,843,74,249,Center,24,Pullup Jump shot,11.908424908424909
2022-23,1628368,De'Aaron Fox,PG,682,1331,563,964,119,367,Center,51,Pullup Jump shot,13.032306536438767
2019-20,1629631,De'Andre Hunter,SF,280,683,172,379,108,304,Center,7,Jump Shot,15.114202049780381
2020-21,1629631,De'Andre Hunter,SF,120,248,89,153,31,95,Center,5,Jump Shot,14.358870967741936
2021-22,1629631,De'Andre Hunter,SF,254,575,180,380,74,195,Center,8,Jump Shot,13.417391304347825
2022-23,1629631,De'Andre Hunter,SF,379,822,279,536,100,286,Center,8,Jump Shot,14.135036496350365
2018-19,1629001,De'Anthony Melton,PG,100,256,71,161,29,95,Center,6,Jump Shot,13.21875
2019-20,1629001,De'Anthony Melton,PG,161,401,121,261,40,140,Center,8,Jump Shot,13.423940149625935
2020-21,1629001,De'Anthony Melton,PG,172,393,85,182,87,211,Center,9,Jump Shot,16.450381679389313
2021-22,1629001,De'Anthony Melton,SG,281,695,142,323,139,372,Center,4,Jump Shot,16.75971223021583
2022-23,1629001,De'Anthony Melton,PG,277,651,120,248,157,403,Center,5,Jump Shot,17.474654377880185
2008-09,201599,DeAndre Jordan,C,93,147,93,147,0,0,Center,6,Alley Oop Dunk Shot,1.0136054421768708
2009-10,201599,DeAndre Jordan,C,144,238,144,236,0,2,Center,6,Layup Shot,1.319327731092437
2010-11,201599,DeAndre Jordan,C,234,341,234,340,0,1,Center,9,Layup Shot,1.6392961876832846
2011-12,201599,DeAndre Jordan,C,206,326,206,325,0,1,Center,5,Alley Oop Dunk Shot,2.128834355828221
2012-13,201599,DeAndre Jordan,C,314,488,314,488,0,0,Center,4,Layup Shot,2.3381147540983607
2013-14,201599,DeAndre Jordan,C,348,515,348,515,0,0,Center,14,Alley Oop Dunk Shot,1.6524271844660194
2014-15,201599,DeAndre Jordan,C,379,534,378,530,1,4,Center,5,Alley Oop Dunk Shot,0.9176029962546817
2015-16,201599,DeAndre Jordan,C,357,508,357,507,0,1,Center,22,Alley Oop Dunk Shot,1.1968503937007875
2016-17,201599,DeAndre Jordan,C,412,577,412,575,0,2,Center,16,Alley Oop Dunk Shot,1.0433275563258233
2017-18,201599,DeAndre Jordan,C,373,578,373,578,0,0,Center,10,Tip Layup Shot,1.328719723183391
2018-19,201599,DeAndre Jordan,C,286,446,286,446,0,0,Center,7,Alley Oop Dunk Shot,1.6121076233183858
2019-20,201599,DeAndre Jordan,C,191,287,191,287,0,0,Center,4,Alley Oop Dunk Shot,1.3554006968641115
2020-21,201599,DeAndre Jordan,C,190,249,190,248,0,1,Center,1,Alley Oop Dunk Shot,1.3052208835341366
2021-22,201599,DeAndre Jordan,C,92,143,92,143,0,0,Center,1,Alley Oop Dunk Shot,1.3706293706293706
2022-23,201599,DeAndre Jordan,C,88,115,87,114,1,1,Center,3,Alley Oop Dunk Shot,1.791304347826087
2011-12,202732,DeAndre Liggins,SF,12,25,12,21,0,4,Center,5,Jump Shot,7.24
2012-13,202732,DeAndre Liggins,SG,21,47,14,28,7,19,Center,3,Jump Shot,11.893617021276595
2013-14,202732,DeAndre Liggins,SG,1,1,1,1,0,0,Center,1,Layup Shot,1.0
2016-17,202732,DeAndre Liggins,SG,55,142,38,96,17,46,Center,4,Jump Shot,11.147887323943662
2017-18,202732,DeAndre Liggins,SG,40,106,21,53,19,53,Center,2,Jump Shot,16.81132075471698
2016-17,1627761,DeAndre' Bembry,SF,47,98,46,80,1,18,Center,10,Jump Shot,7.714285714285714
2017-18,1627761,DeAndre' Bembry,SF,53,128,42,98,11,30,Center,0,Jump Shot,8.65625
2018-19,1627761,DeAndre' Bembry,SG,275,616,225,443,50,173,Center,9,Jump Shot,9.334415584415584
2019-20,1627761,DeAndre' Bembry,SG,104,228,89,163,15,65,Center,3,Jump Shot,9.175438596491228
2020-21,1627761,DeAndre' Bembry,SF,117,228,103,175,14,53,Center,4,Jump Shot,8.355263157894736
2021-22,1627761,DeAndre' Bembry,SF,124,221,109,185,15,36,Center,3,Jump Shot,5.710407239819005
2009-10,201971,DeJuan Blair,PF,275,495,275,493,0,2,Center,11,Layup Shot,2.5898989898989897
2010-11,201971,DeJuan Blair,PF,292,583,292,581,0,2,Center,12,Layup Shot,3.881646655231561
2011-12,201971,DeJuan Blair,PF,269,504,269,503,0,1,Center,6,Layup Shot,4.194444444444445
2012-13,201971,DeJuan Blair,PF,142,271,142,270,0,1,Center,4,Jump Shot,5.4206642066420665
2013-14,201971,DeJuan Blair,PF,210,393,210,391,0,2,Center,3,Jump Shot,4.636132315521628
2014-15,201971,DeJuan Blair,PF,26,57,26,57,0,0,Center,8,Jump Shot,4.666666666666667
2015-16,201971,DeJuan Blair,C,28,68,28,67,0,1,Center,4,Jump Shot,8.176470588235293
2009-10,201942,DeMar DeRozan,SG,255,512,251,496,4,16,Center,8,Jump Shot,8.8125
2010-11,201942,DeMar DeRozan,SG,539,1154,534,1102,5,52,Center,28,Jump Shot,10.675043327556326
2011-12,201942,DeMar DeRozan,SG,381,903,357,811,24,92,Center,18,Jump Shot,12.198228128460686
2012-13,201942,DeMar DeRozan,SG,548,1231,514,1111,34,120,Center,14,Jump Shot,12.535337124289196
2013-14,201942,DeMar DeRozan,SG,604,1407,540,1197,64,210,Center,17,Jump Shot,13.679459843638949
2014-15,201942,DeMar DeRozan,SG,409,990,384,902,25,88,Center,24,Jump Shot,12.322222222222223
2015-16,201942,DeMar DeRozan,SG,614,1376,567,1238,47,138,Center,27,Jump Shot,11.189680232558139
2016-17,201942,DeMar DeRozan,SG,721,1545,688,1421,33,124,Center,46,Jump Shot,12.10873786407767
2017-18,201942,DeMar DeRozan,SG,645,1413,556,1126,89,287,Center,33,Jump Shot,12.927105449398443
2018-19,201942,DeMar DeRozan,SG,631,1313,624,1268,7,45,Center,19,Pullup Jump shot,10.303884234577303
2019-20,201942,DeMar DeRozan,SF,557,1049,548,1014,9,35,Center,33,Pullup Jump shot,9.379408960915157
2020-21,201942,DeMar DeRozan,PF,455,920,436,846,19,74,Center,26,Pullup Jump shot,10.506521739130434
2021-22,201942,DeMar DeRozan,PF,774,1535,724,1393,50,142,Center,31,Pullup Jump shot,12.556351791530945
2022-23,201942,DeMar DeRozan,SF,657,1303,611,1161,46,142,Center,26,Pullup Jump shot,13.18342287029931
2010-11,202326,DeMarcus Cousins,C,432,1004,429,986,3,18,Center,20,Jump Shot,7.923306772908367
2011-12,202326,DeMarcus Cousins,C,448,999,446,985,2,14,Center,20,Jump Shot,7.049049049049049
2012-13,202326,DeMarcus Cousins,C,482,1036,478,1014,4,22,Center,16,Jump Shot,7.928571428571429
2013-14,202326,DeMarcus Cousins,C,591,1191,591,1184,0,7,Center,20,Jump Shot,7.3341729638958855
2014-15,202326,DeMarcus Cousins,C,498,1066,496,1058,2,8,Center,20,Jump Shot,7.232645403377111
2015-16,202326,DeMarcus Cousins,C,601,1332,531,1122,70,210,Center,23,Jump Shot,9.191441441441441
2016-17,202326,DeMarcus Cousins,C,647,1432,516,1069,131,363,Center,36,Jump Shot,11.113128491620111
2017-18,202326,DeMarcus Cousins,C,406,864,302,570,104,294,Center,19,Jump Shot,11.8125
2018-19,202326,DeMarcus Cousins,C,178,371,152,276,26,95,Center,1,Jump Shot,9.638814016172507
2020-21,202326,DeMarcus Cousins,C,130,305,83,170,47,135,Center,4,Jump Shot,13.039344262295081
2021-22,202326,DeMarcus Cousins,C,149,324,112,202,37,122,Center,2,Jump Shot,11.57716049382716
2008-09,201634,DeMarcus Nelson,PG,24,54,24,51,0,3,Center,3,Jump Shot,8.148148148148149
2009-10,201960,DeMarre Carroll,SF,88,222,88,216,0,6,Center,10,Jump Shot,11.527027027027026
2010-11,201960,DeMarre Carroll,PF,4,12,4,12,0,0,Center,1,Jump Shot,7.833333333333333
2011-12,201960,DeMarre Carroll,SF-PF,43,105,36,86,7,19,Center,7,Jump Shot,12.838095238095239
2012-13,201960,DeMarre Carroll,SF,149,324,129,254,20,70,Center,6,Jump Shot,13.444444444444445
2013-14,201960,DeMarre Carroll,SF,302,642,205,374,97,268,Center,12,Jump Shot,13.274143302180685
2014-15,201960,DeMarre Carroll,SF,318,653,198,349,120,304,Center,6,Jump Shot,13.820826952526799
2015-16,201960,DeMarre Carroll,SF,105,270,59,152,46,118,Center,5,Jump Shot,14.274074074074074
2016-17,201960,DeMarre Carroll,SF,220,548,111,230,109,318,Center,8,Jump Shot,17.047445255474454
2017-18,201960,DeMarre Carroll,PF,325,785,180,394,145,391,Center,12,Jump Shot,15.070063694267516
2018-19,201960,DeMarre Carroll,PF,227,575,121,265,106,310,Center,7,Jump Shot,15.848695652173912
2019-20,201960,DeMarre Carroll,SF-C,25,66,17,33,8,33,Center,3,Jump Shot,14.757575757575758
2012-13,203199,DeQuan Jones,SF,95,218,86,183,9,35,Center,3,Jump Shot,9.899082568807339
2003-04,2205,DeSagana Diop,C,57,147,57,147,0,0,Center,6,Jump Shot,10.081632653061224
2004-05,2205,DeSagana Diop,C,20,69,20,67,0,2,Center,3,Jump Shot,9.73913043478261
2005-06,2205,DeSagana Diop,C,75,154,74,152,1,2,Center,1,Jump Shot,4.694805194805195
2006-07,2205,DeSagana Diop,C,71,151,71,150,0,1,Center,2,Layup Shot,2.403973509933775
2007-08,2205,DeSagana Diop,C,94,180,94,180,0,0,Center,3,Layup Shot,3.2111111111111112
2008-09,2205,DeSagana Diop,C,74,171,74,171,0,0,Center,2,Layup Shot,3.7719298245614037
2009-10,2205,DeSagana Diop,C,15,29,15,29,0,0,Center,1,Layup Shot,3.7241379310344827
2010-11,2205,DeSagana Diop,C,8,24,8,24,0,0,Center,0,Jump Shot,8.208333333333334
2011-12,2205,DeSagana Diop,C,15,42,15,42,0,0,Center,1,Jump Shot,8.666666666666666
2012-13,2205,DeSagana Diop,C,8,27,8,26,0,1,Center,2,Jump Shot,16.40740740740741
2003-04,2052,DeShawn Stevenson,SG-SF,376,871,357,800,19,71,Center,13,Jump Shot,13.630309988518944
2004-05,2052,DeShawn Stevenson,SG,174,426,149,359,25,67,Center,7,Jump Shot,11.981220657276996
2005-06,2052,DeShawn Stevenson,SG,359,781,357,766,2,15,Center,15,Jump Shot,10.253521126760564
2006-07,2052,DeShawn Stevenson,SG,347,753,273,570,74,183,Center,16,Jump Shot,14.191235059760956
2007-08,2052,DeShawn Stevenson,SG,301,780,143,367,158,413,Center,15,Jump Shot,18.03076923076923
2008-09,2052,DeShawn Stevenson,SG,72,231,37,102,35,129,Center,5,Jump Shot,19.333333333333332
2009-10,2052,DeShawn Stevenson,SG,46,163,27,76,19,87,Left Side Center,1,Jump Shot,18.957055214723926
2010-11,2052,DeShawn Stevenson,SG,128,330,34,81,94,249,Right Side Center,7,Jump Shot,20.766666666666666
2011-12,2052,DeShawn Stevenson,SF,49,172,8,27,41,145,Right Side Center,0,Jump Shot,22.209302325581394
2012-13,2052,DeShawn Stevenson,SG,98,262,22,53,76,209,Left Side,1,Jump Shot,21.84351145038168
2018-19,1629152,DeVaughn Akoon-Purcell,SG,3,10,3,6,0,4,Center,2,Jump Shot,12.4
2019-20,1629731,Dean Wade,PF,9,13,7,9,2,4,Center,3,Jump Shot,8.0
2020-21,1629731,Dean Wade,PF,134,311,56,98,78,213,Center,5,Jump Shot,18.228295819935692
2021-22,1629731,Dean Wade,PF,99,217,48,75,51,142,Center,5,Jump Shot,17.84331797235023
2022-23,1629731,Dean Wade,PF,73,177,28,50,45,127,Center,2,Jump Shot,18.63276836158192
2018-19,1629028,Deandre Ayton,C,509,870,509,866,0,4,Center,15,Jump Shot,6.233333333333333
2019-20,1629028,Deandre Ayton,C,310,568,307,555,3,13,Center,6,Jump Shot,6.167253521126761
2020-21,1629028,Deandre Ayton,C,430,687,426,667,4,20,Center,7,Jump Shot,5.1120815138282385
2021-22,1629028,Deandre Ayton,C,442,697,435,678,7,19,Center,14,Jump Shot,6.489239598278336
2022-23,1629028,Deandre Ayton,C,522,887,515,863,7,24,Center,16,Jump Shot,7.225479143179256
2006-07,200793,Dee Brown,PG,32,98,26,70,6,28,Center,1,Jump Shot,12.071428571428571
2008-09,200793,Dee Brown,PG,18,49,11,25,7,24,Center,1,Jump Shot,14.122448979591837
2020-21,1629686,Deividas Sirvydis,SG,14,40,4,12,10,28,Right Side Center,5,Jump Shot,18.65
2021-22,1629686,Deividas Sirvydis,SG,1,10,0,3,1,7,Right Side Center,0,Jump Shot,18.9
2016-17,1627749,Dejounte Murray,PG,50,116,41,93,9,23,Center,9,Jump Shot,9.21551724137931
2017-18,1627749,Dejounte Murray,PG,270,609,261,575,9,34,Center,21,Pullup Jump shot,7.440065681444992
2019-20,1627749,Dejounte Murray,PG,294,637,253,526,41,111,Center,5,Pullup Jump shot,11.028257456828886
2020-21,1627749,Dejounte Murray,PG,441,974,378,775,63,199,Center,12,Pullup Jump shot,12.127310061601642
2021-22,1627749,Dejounte Murray,PG,573,1241,477,947,96,294,Center,26,Pullup Jump shot,12.219178082191782
2022-23,1627749,Dejounte Murray,SG,612,1319,479,932,133,387,Center,25,Pullup Jump shot,14.072024260803639
2015-16,1626153,Delon Wright,PG,36,80,31,67,5,13,Center,6,Jump Shot,8.0875
2016-17,1626153,Delon Wright,PG,49,116,39,86,10,30,Center,4,Jump Shot,9.85344827586207
2017-18,1626153,Delon Wright,PG,201,432,145,279,56,153,Center,9,Jump Shot,11.081018518518519
2018-19,1626153,Delon Wright,PG,242,558,192,390,50,168,Center,10,Jump Shot,10.317204301075268
2019-20,1626153,Delon Wright,PG,190,411,143,284,47,127,Center,2,Jump Shot,10.53771289537713
2020-21,1626153,Delon Wright,SG-PG,240,518,176,346,64,172,Center,8,Jump Shot,11.011583011583012
2021-22,1626153,Delon Wright,SG,122,269,78,153,44,116,Center,4,Jump Shot,13.579925650557621
2022-23,1626153,Delon Wright,PG,138,291,97,172,41,119,Center,5,Jump Shot,13.804123711340207
2004-05,2753,Delonte West,SG,66,155,42,88,24,67,Center,3,Jump Shot,15.6
2005-06,2753,Delonte West,PG,333,684,249,466,84,218,Center,10,Jump Shot,13.98391812865497
2006-07,2753,Delonte West,SG,306,717,241,539,65,178,Center,20,Jump Shot,13.99302649930265
2007-08,2753,Delonte West,PG,196,475,148,340,48,135,Center,19,Jump Shot,13.330526315789474
2008-09,2753,Delonte West,SG,285,624,194,396,91,228,Center,6,Jump Shot,14.753205128205128
2009-10,2753,Delonte West,SG,194,436,169,359,25,77,Center,3,Jump Shot,11.020642201834862
2010-11,2753,Delonte West,PG,55,120,43,87,12,33,Center,1,Jump Shot,14.475
2011-12,2753,Delonte West,PG,166,360,139,284,27,76,Center,1,Jump Shot,13.45
2007-08,201193,Demetris Nichols,SF,6,23,3,10,3,13,Right Side Center,4,Jump Shot,20.304347826086957
2008-09,201193,Demetris Nichols,SF,3,9,3,7,0,2,Center,2,Jump Shot,15.11111111111111
2016-17,1627743,Demetrius Jackson,PG,3,4,2,3,1,1,Right Side Center,1,Jump Shot,14.5
2017-18,1627743,Demetrius Jackson,PG,7,18,6,11,1,7,Center,1,Driving Layup Shot,10.11111111111111
2018-19,1627743,Demetrius Jackson,PG,8,15,6,9,2,6,Center,3,Jump Shot,13.6
2018-19,1629061,Deng Adel,SF,11,36,5,13,6,23,Center,1,Jump Shot,18.75
2020-21,1630166,Deni Avdija,SF,130,312,77,144,53,168,Center,10,Jump Shot,16.147435897435898
2021-22,1630166,Deni Avdija,SF,250,579,168,320,82,259,Center,12,Jump Shot,13.879101899827289
2022-23,1630166,Deni Avdija,SF,253,579,184,347,69,232,Center,6,Jump Shot,12.407599309153714
2011-12,202862,Dennis Horner,PF,1,4,1,3,0,1,Right Side,0,Jump Shot,14.25
2013-14,203471,Dennis Schroder,PG,72,188,62,146,10,42,Center,1,Jump Shot,11.372340425531915
2014-15,203471,Dennis Schroder,PG,284,665,232,517,52,148,Center,9,Jump Shot,10.857142857142858
2015-16,203471,Dennis Schroder,PG,329,781,252,542,77,239,Center,5,Jump Shot,12.551856594110115
2016-17,203471,Dennis Schroder,PG,548,1213,448,920,100,293,Center,27,Driving Layup Shot,11.289365210222588
2017-18,203471,Dennis Schroder,PG,500,1146,424,884,76,262,Center,20,Driving Layup Shot,12.37085514834206
2018-19,203471,Dennis Schroder,PG,457,1104,333,740,124,364,Center,12,Jump Shot,13.589673913043478
2019-20,203471,Dennis Schroder,PG,453,965,328,640,125,325,Center,20,Jump Shot,14.35440414507772
2020-21,203471,Dennis Schroder,SG,332,760,261,548,71,212,Center,10,Jump Shot,12.23421052631579
2021-22,203471,Dennis Schroder,SG-PG,312,724,226,474,86,250,Center,11,Jump Shot,14.21132596685083
2022-23,203471,Dennis Schroder,PG,270,650,196,425,74,225,Center,11,Jump Shot,13.915384615384616
2017-18,1628372,Dennis Smith Jr.,PG,404,1024,298,685,106,339,Center,41,Jump Shot,13.287109375
2018-19,1628372,Dennis Smith Jr.,PG,278,650,211,442,67,208,Center,15,Jump Shot,12.204615384615385
2019-20,1628372,Dennis Smith Jr.,PG,72,211,56,157,16,54,Center,2,Jump Shot,12.222748815165877
2020-21,1628372,Dennis Smith Jr.,PG,58,145,39,87,19,58,Center,2,Jump Shot,14.875862068965517
2021-22,1628372,Dennis Smith Jr.,PG,79,189,73,162,6,27,Center,5,Driving Layup Shot,8.486772486772487
2022-23,1628372,Dennis Smith Jr.,PG,186,452,162,341,24,111,Center,13,Jump Shot,10.922566371681416
2016-17,1627756,Denzel Valentine,SG,102,288,29,80,73,208,Center,6,Jump Shot,20.21527777777778
2017-18,1627756,Denzel Valentine,SG,301,721,158,351,143,370,Center,8,Jump Shot,17.574202496532592
2019-20,1627756,Denzel Valentine,SF,97,237,51,100,46,137,Center,7,Jump Shot,19.046413502109704
2020-21,1627756,Denzel Valentine,SG,155,416,75,174,80,242,Center,5,Jump Shot,18.266826923076923
2021-22,1627756,Denzel Valentine,SG,25,66,6,19,19,47,Center,4,Jump Shot,20.151515151515152
2018-19,1629126,Deonte Burton,SG,33,82,25,55,8,27,Center,4,Jump Shot,10.609756097560975
2019-20,1629126,Deonte Burton,SF,43,125,33,72,10,53,Center,11,Jump Shot,14.104
2022-23,1629126,Deonte Burton,SG,0,2,0,1,0,1,Center,0,Driving Reverse Layup Shot,13.5
2003-04,2035,DerMarr Johnson,SF,36,97,23,61,13,36,Center,2,Jump Shot,13.402061855670103
2004-05,2035,DerMarr Johnson,SG,185,371,132,223,53,148,Center,15,Jump Shot,12.288409703504042
2005-06,2035,DerMarr Johnson,SG,132,306,76,146,56,160,Center,13,Jump Shot,15.764705882352942
2006-07,2035,DerMarr Johnson,SF,50,154,31,66,19,88,Center,8,Jump Shot,16.2012987012987
2007-08,2035,DerMarr Johnson,SF,7,14,4,5,3,9,Left Side,3,Jump Shot,19.142857142857142
2003-04,1507,Derek Anderson,SG,230,612,151,353,79,259,Center,8,Jump Shot,17.673202614379086
2004-05,1507,Derek Anderson,SG,152,391,94,240,58,151,Center,5,Jump Shot,16.529411764705884
2005-06,1507,Derek Anderson,SG,108,303,68,169,40,134,Center,4,Jump Shot,17.495049504950494
2006-07,1507,Derek Anderson,SF,126,294,72,142,54,152,Center,5,Jump Shot,17.700680272108844
2007-08,1507,Derek Anderson,SG,47,125,28,73,19,52,Center,0,Jump Shot,16.784
2003-04,965,Derek Fisher,SG,203,576,151,397,52,179,Center,8,Jump Shot,16.881944444444443
2004-05,965,Derek Fisher,PG,297,755,189,464,108,291,Center,14,Jump Shot,17.904635761589404
2005-06,965,Derek Fisher,PG,364,887,247,592,117,295,Center,29,Jump Shot,16.429537767756482
2006-07,965,Derek Fisher,SG,258,675,210,519,48,156,Center,9,Jump Shot,14.708148148148148
2007-08,965,Derek Fisher,PG,339,777,227,501,112,276,Center,4,Jump Shot,16.804375804375805
2008-09,965,Derek Fisher,PG,292,688,172,386,120,302,Center,7,Jump Shot,17.517441860465116
2009-10,965,Derek Fisher,PG,212,558,134,334,78,224,Center,8,Jump Shot,17.93548387096774
2010-11,965,Derek Fisher,PG,206,529,143,370,63,159,Center,9,Jump Shot,16.44423440453686
2011-12,965,Derek Fisher,PG,129,348,94,239,35,109,Center,9,Jump Shot,17.07758620689655
2012-13,965,Derek Fisher,SG-PG,55,161,25,81,30,80,Left Side,2,Jump Shot,18.770186335403725
2013-14,965,Derek Fisher,SG,141,361,53,132,88,229,Center,2,Jump Shot,19.97229916897507
2022-23,1631220,Dereon Seabron,SG,2,5,2,5,0,0,Center,2,Driving Layup Shot,5.0
2005-06,101114,Deron Williams,PG,339,805,248,586,91,219,Center,19,Jump Shot,14.647204968944099
2006-07,101114,Deron Williams,PG,494,1083,412,828,82,255,Center,22,Jump Shot,13.163434903047092
2007-08,101114,Deron Williams,PG,566,1117,483,907,83,210,Center,22,Jump Shot,11.593554162936437
2008-09,101114,Deron Williams,PG,463,984,393,758,70,226,Center,31,Jump Shot,12.172764227642276
2009-10,101114,Deron Williams,PG,494,1053,398,794,96,259,Center,15,Jump Shot,12.595441595441596
2010-11,101114,Deron Williams,PG,428,975,323,658,105,317,Center,27,Jump Shot,13.86051282051282
2011-12,101114,Deron Williams,PG,391,961,276,619,115,342,Center,15,Jump Shot,15.174817898022892
2012-13,101114,Deron Williams,PG,495,1124,326,677,169,447,Center,17,Jump Shot,15.62099644128114
2013-14,101114,Deron Williams,PG,322,716,224,448,98,268,Center,14,Jump Shot,15.42877094972067
2014-15,101114,Deron Williams,PG,298,771,211,534,87,237,Center,10,Jump Shot,13.87289234760052
2015-16,101114,Deron Williams,PG,321,775,224,493,97,282,Center,22,Jump Shot,14.778064516129032
2016-17,101114,Deron Williams,PG,263,600,178,366,85,234,Center,6,Jump Shot,16.045
2009-10,201974,Derrick Brown,SF,68,147,66,140,2,7,Center,5,Jump Shot,5.421768707482993
2010-11,201974,Derrick Brown,SF,74,130,69,121,5,9,Center,9,Layup Shot,4.007692307692308
2011-12,201974,Derrick Brown,SF,212,409,206,385,6,24,Center,14,Jump Shot,7.9486552567237165
2011-12,201182,Derrick Byars,PF,3,11,3,5,0,6,Center,0,Jump Shot,14.181818181818182
2010-11,202382,Derrick Caracter,C,32,66,32,66,0,0,Center,11,Jump Shot,5.121212121212121
2003-04,934,Derrick Coleman,C,107,259,99,223,8,36,Center,3,Jump Shot,10.617760617760618
2004-05,934,Derrick Coleman,C,3,14,3,12,0,2,Center,1,Jump Shot,9.428571428571429
2003-04,1760,Derrick Dial,SG,9,28,7,19,2,9,Center,3,Jump Shot,15.964285714285714
2010-11,202324,Derrick Favors,PF,215,416,215,416,0,0,Center,4,Jump Shot,4.4110576923076925
2011-12,202324,Derrick Favors,PF,222,445,222,445,0,0,Center,6,Jump Shot,4.462921348314607
2012-13,202324,Derrick Favors,PF,274,568,274,563,0,5,Center,5,Jump Shot,5.48943661971831
2013-14,202324,Derrick Favors,PF,390,747,390,746,0,1,Center,22,Jump Shot,5.597054886211513
2014-15,202324,Derrick Favors,PF,482,918,481,912,1,6,Center,10,Jump Shot,6.772331154684096
2015-16,202324,Derrick Favors,PF,418,811,418,807,0,4,Center,14,Jump Shot,7.670776818742294
2016-17,202324,Derrick Favors,PF,203,417,200,407,3,10,Center,1,Jump Shot,7.9352517985611515
2017-18,202324,Derrick Favors,C,395,702,381,639,14,63,Center,2,Jump Shot,7.3917378917378915
2018-19,202324,Derrick Favors,C,363,619,346,541,17,78,Center,1,Jump Shot,6.148626817447496
2019-20,202324,Derrick Favors,C,209,339,208,332,1,7,Center,4,Tip Layup Shot,3.4749262536873156
2020-21,202324,Derrick Favors,C,155,243,155,241,0,2,Center,0,Jump Shot,4.720164609053498
2021-22,202324,Derrick Favors,C,94,182,92,166,2,16,Center,1,Jump Shot,9.291208791208792
2016-17,1627884,Derrick Jones Jr.,SF,68,121,65,110,3,11,Center,6,Jump Shot,5.595041322314049
2017-18,1627884,Derrick Jones Jr.,SF,21,53,18,35,3,18,Center,4,Jump Shot,10.358490566037736
2018-19,1627884,Derrick Jones Jr.,SF,160,324,132,233,28,91,Center,5,Jump Shot,8.521604938271604
2019-20,1627884,Derrick Jones Jr.,SF,184,349,147,217,37,132,Center,4,Jump Shot,10.710601719197708
2020-21,1627884,Derrick Jones Jr.,SF,147,304,104,168,43,136,Center,8,Jump Shot,11.552631578947368
2021-22,1627884,Derrick Jones Jr.,PF,105,195,85,134,20,61,Center,2,Jump Shot,8.487179487179487
2022-23,1627884,Derrick Jones Jr.,SF,115,230,88,150,27,80,Center,6,Jump Shot,9.265217391304347
2008-09,201565,Derrick Rose,PG,574,1208,558,1136,16,72,Center,25,Jump Shot,10.052980132450331
2009-10,201565,Derrick Rose,PG,672,1373,656,1313,16,60,Center,30,Jump Shot,10.598689002184996
2010-11,201565,Derrick Rose,PG,711,1597,583,1212,128,385,Center,39,Jump Shot,12.512210394489669
2011-12,201565,Derrick Rose,PG,302,695,248,522,54,173,Center,14,Jump Shot,12.117985611510791
2013-14,201565,Derrick Rose,PG,58,164,42,117,16,47,Center,3,Jump Shot,11.78048780487805
2014-15,201565,Derrick Rose,PG,338,835,262,564,76,271,Center,16,Jump Shot,13.658682634730539
2015-16,201565,Derrick Rose,PG,447,1048,403,898,44,150,Center,13,Jump Shot,10.704198473282442
2016-17,201565,Derrick Rose,PG,460,977,447,917,13,60,Center,22,Jump Shot,8.34288638689867
2017-18,201565,Derrick Rose,PG,81,186,74,156,7,30,Center,4,Jump Shot,9.591397849462366
2018-19,201565,Derrick Rose,PG,363,753,309,607,54,146,Center,16,Jump Shot,11.653386454183266
2019-20,201565,Derrick Rose,PG,369,753,324,606,45,147,Center,18,Driving Layup Shot,10.46215139442231
2020-21,201565,Derrick Rose,PG,287,611,237,482,50,129,Center,6,Jump Shot,11.693944353518821
2021-22,201565,Derrick Rose,PG,122,274,85,182,37,92,Center,3,Jump Shot,12.905109489051094
2022-23,201565,Derrick Rose,PG,61,159,42,96,19,63,Center,0,Jump Shot,13.647798742138365
2017-18,1628476,Derrick Walton Jr.,PG,8,25,1,8,7,17,Right Side Center,0,Jump Shot,24.04
2019-20,1628476,Derrick Walton Jr.,PG,18,39,8,15,10,24,Center,1,Jump Shot,19.974358974358974
2021-22,1628476,Derrick Walton Jr.,PG,6,26,3,13,3,13,Center,0,Jump Shot,17.53846153846154
2017-18,1628401,Derrick White,PG,16,33,8,20,8,13,Center,2,Jump Shot,14.454545454545455
2018-19,1628401,Derrick White,PG,260,543,212,401,48,142,Center,9,Pullup Jump shot,11.948434622467772
2019-20,1628401,Derrick White,SG,253,552,174,336,79,216,Center,9,Jump Shot,13.704710144927537
2020-21,1628401,Derrick White,SG,186,453,102,210,84,243,Center,5,Jump Shot,16.388520971302427
2021-22,1628401,Derrick White,SG,337,800,222,431,115,369,Center,11,Jump Shot,14.9575
2022-23,1628401,Derrick White,SG,350,758,201,367,149,391,Center,10,Jump Shot,15.62269129287599
2011-12,202682,Derrick Williams,PF,205,498,168,360,37,138,Center,6,Jump Shot,11.17871485943775
2012-13,202682,Derrick Williams,PF,338,786,273,590,65,196,Center,12,Jump Shot,11.801526717557252
2013-14,202682,Derrick Williams,SF-PF,206,482,180,383,26,99,Center,0,Jump Shot,10.228215767634854
2014-15,202682,Derrick Williams,PF,217,485,168,329,49,156,Center,5,Jump Shot,11.934020618556701
2015-16,202682,Derrick Williams,SF,253,564,210,415,43,149,Center,9,Jump Shot,11.26950354609929
2016-17,202682,Derrick Williams,PF,108,244,78,147,30,97,Center,9,Jump Shot,13.180327868852459
2017-18,202682,Derrick Williams,PF,1,4,1,2,0,2,Center,0,Jump Shot,12.75
2005-06,2583,Derrick Zimmerman,PG,2,3,2,3,0,0,Center,1,Alley Oop Layup shot,2.3333333333333335
2006-07,2824,Desmon Farmer,SG,5,15,3,7,2,8,Right Side,2,Jump Shot,18.466666666666665
2008-09,2824,Desmon Farmer,SG,4,14,1,2,3,12,Right Side,0,Jump Shot,19.928571428571427
2020-21,1630217,Desmond Bane,SG,234,499,117,228,117,271,Center,13,Jump Shot,16.482965931863728
2021-22,1630217,Desmond Bane,SG,508,1101,280,578,228,523,Center,19,Jump Shot,16.274296094459583
2022-23,1630217,Desmond Bane,SG,450,939,284,532,166,407,Center,13,Jump Shot,14.347177848775292
2003-04,2724,Desmond Ferguson,SF,5,12,2,4,3,8,Left Side Center,2,Jump Shot,18.833333333333332
2003-04,2046,Desmond Mason,SF,409,867,400,828,9,39,Center,11,Jump Shot,9.183391003460208
2004-05,2046,Desmond Mason,SF,478,1079,477,1071,1,8,Center,14,Jump Shot,8.050046339202966
2005-06,2046,Desmond Mason,SF,275,690,274,684,1,6,Center,7,Jump Shot,6.636231884057971
2006-07,2046,Desmond Mason,SF,407,900,407,900,0,0,Center,12,Jump Shot,3.962222222222222
2007-08,2046,Desmond Mason,SF,230,477,230,477,0,0,Center,5,Jump Shot,5.578616352201258
2008-09,2046,Desmond Mason,SG,124,285,124,282,0,3,Center,4,Jump Shot,6.385964912280702
2009-10,2046,Desmond Mason,SF,5,12,5,12,0,0,Center,0,Jump Shot,6.083333333333333
2003-04,2667,Desmond Penigar,PF,14,28,14,28,0,0,Center,2,Jump Shot,7.642857142857143
2003-04,1904,Devean George,SF,233,571,168,385,65,186,Center,9,Jump Shot,15.280210157618214
2004-05,1904,Devean George,SF,37,104,16,46,21,58,Center,2,Jump Shot,19.26923076923077
2005-06,1904,Devean George,SF,170,425,120,265,50,160,Center,8,Jump Shot,16.00941176470588
2006-07,1904,Devean George,SF,146,370,93,220,53,150,Center,6,Jump Shot,15.81891891891892
2007-08,1904,Devean George,SF,74,207,52,139,22,68,Center,5,Jump Shot,15.101449275362318
2008-09,1904,Devean George,SF,54,142,32,66,22,76,Center,3,Jump Shot,16.176056338028168
2009-10,1904,Devean George,SF,89,206,41,83,48,123,Right Side Center,1,Jump Shot,19.436893203883496
2015-16,1626164,Devin Booker,SG,367,867,268,578,99,289,Center,21,Jump Shot,14.594002306805075
2016-17,1626164,Devin Booker,SG,606,1431,459,1026,147,405,Center,38,Jump Shot,14.29979035639413
2017-18,1626164,Devin Booker,SG,455,1054,308,670,147,384,Center,21,Jump Shot,15.116698292220114
2018-19,1626164,Devin Booker,SG,586,1255,451,841,135,414,Center,35,Pullup Jump shot,14.061354581673307
2019-20,1626164,Devin Booker,SG,627,1283,486,885,141,398,Center,27,Pullup Jump shot,13.583008573655494
2020-21,1626164,Devin Booker,SG,623,1287,497,916,126,371,Center,18,Pullup Jump shot,14.053613053613054
2021-22,1626164,Devin Booker,SG,662,1421,479,943,183,478,Center,36,Pullup Jump shot,15.56509500351865
2022-23,1626164,Devin Booker,SG,527,1067,416,751,111,316,Center,17,Pullup Jump shot,14.039362699156513
2003-04,2484,Devin Brown,SG,85,196,81,182,4,14,Center,11,Jump Shot,11.673469387755102
2004-05,2484,Devin Brown,SG,173,409,128,288,45,121,Center,14,Jump Shot,13.422982885085574
2005-06,2484,Devin Brown,SG,207,527,168,409,39,118,Center,11,Jump Shot,12.214421252371917
2006-07,2484,Devin Brown,SG,233,555,152,328,81,227,Center,13,Jump Shot,13.985585585585586
2007-08,2484,Devin Brown,SG,217,531,172,385,45,146,Center,6,Jump Shot,12.116760828625235
2008-09,2484,Devin Brown,SG,111,313,83,216,28,97,Center,5,Jump Shot,11.814696485623003
2009-10,2484,Devin Brown,SG,136,361,78,197,58,164,Center,4,Jump Shot,14.96398891966759
2020-21,1629962,Devin Cannady,PG,11,28,5,12,6,16,Center,2,Jump Shot,18.821428571428573
2021-22,1629962,Devin Cannady,PG,15,44,0,7,15,37,Right Side Center,2,Jump Shot,21.954545454545453
2010-11,202365,Devin Ebanks,SG,21,51,19,46,2,5,Center,3,Jump Shot,9.019607843137255
2011-12,202365,Devin Ebanks,SG,37,89,37,80,0,9,Center,1,Jump Shot,10.123595505617978
2012-13,202365,Devin Ebanks,SF,24,73,18,51,6,22,Center,4,Jump Shot,14.684931506849315
2005-06,101209,Devin Green,SG,6,28,6,26,0,2,Center,1,Jump Shot,9.428571428571429
2004-05,2734,Devin Harris,PG,157,366,113,235,44,131,Center,9,Jump Shot,13.551912568306012
2005-06,2734,Devin Harris,PG,190,405,185,384,5,21,Center,14,Jump Shot,7.6345679012345675
2006-07,2734,Devin Harris,PG,292,593,278,543,14,50,Center,8,Jump Shot,8.354131534569984
2007-08,2734,Devin Harris,PG,321,693,265,526,56,167,Center,13,Jump Shot,10.994227994227995
2008-09,2734,Devin Harris,PG,455,1039,391,819,64,220,Center,24,Jump Shot,11.334937439846005
2009-10,2734,Devin Harris,PG,356,884,296,667,60,217,Center,14,Jump Shot,11.895927601809955
2010-11,2734,Devin Harris,PG,343,813,285,633,58,180,Center,23,Jump Shot,11.650676506765068
2011-12,2734,Devin Harris,PG,241,542,164,329,77,213,Center,11,Jump Shot,14.933579335793358
2012-13,2734,Devin Harris,SG,194,443,117,213,77,230,Center,0,Jump Shot,15.790067720090294
2013-14,2734,Devin Harris,PG,96,254,65,153,31,101,Center,3,Jump Shot,13.834645669291339
2014-15,2734,Devin Harris,PG,219,524,124,258,95,266,Center,5,Jump Shot,16.01145038167939
2015-16,2734,Devin Harris,PG,166,373,115,216,51,157,Center,3,Jump Shot,14.225201072386058
2016-17,2734,Devin Harris,PG,136,341,78,164,58,177,Center,2,Jump Shot,15.806451612903226
2017-18,2734,Devin Harris,PG,187,454,108,227,79,227,Center,3,Jump Shot,15.451541850220265
2018-19,2734,Devin Harris,PG,132,347,70,147,62,200,Center,0,Jump Shot,17.037463976945244
2017-18,1628421,Devin Robinson,SF,1,3,1,3,0,0,Center,0,Jump Shot,6.333333333333333
2018-19,1628421,Devin Robinson,SF,19,32,19,30,0,2,Center,3,Jump Shot,7.375
2020-21,1630170,Devin Vassell,SF,123,303,71,153,52,150,Center,6,Jump Shot,17.019801980198018
2021-22,1630170,Devin Vassell,SF,326,764,189,384,137,380,Center,6,Jump Shot,16.75392670157068
2022-23,1630170,Devin Vassell,SG,261,595,158,329,103,266,Center,4,Pullup Jump shot,17.070588235294117
2020-21,1629653,Devon Dotson,PG,11,21,10,14,1,7,Center,4,Driving Layup Shot,12.047619047619047
2021-22,1629653,Devon Dotson,PG,11,23,9,14,2,9,Center,3,Jump Shot,11.695652173913043
2022-23,1629653,Devon Dotson,PG,1,10,0,6,1,4,Center,0,Jump Shot,16.1
2019-20,1628985,Devon Hall,PG,6,30,2,13,4,17,Center,0,Jump Shot,17.2
2019-20,1629719,Devontae Cacok,C,3,6,3,6,0,0,Center,0,Layup Shot,3.3333333333333335
2020-21,1629719,Devontae Cacok,PF,17,29,17,29,0,0,Center,6,Dunk Shot,2.7241379310344827
2021-22,1629719,Devontae Cacok,PF,21,31,21,31,0,0,Center,6,Layup Shot,4.193548387096774
2018-19,1628984,Devonte' Graham,PG,74,216,40,95,34,121,Center,6,Jump Shot,17.90277777777778
2019-20,1628984,Devonte' Graham,PG,368,963,150,378,218,585,Center,21,Jump Shot,18.88785046728972
2020-21,1628984,Devonte' Graham,PG,252,669,73,192,179,477,Center,16,Jump Shot,21.27354260089686
2021-22,1628984,Devonte' Graham,PG,296,815,104,252,192,563,Center,12,Jump Shot,20.72883435582822
2022-23,1628984,Devonte' Graham,PG,161,431,42,93,119,338,Center,3,Jump Shot,22.020881670533644
2014-15,203906,Devyn Marble,SG,14,44,10,22,4,22,Center,2,Jump Shot,14.159090909090908
2015-16,203906,Devyn Marble,SG,21,71,13,39,8,32,Center,2,Jump Shot,15.788732394366198
2019-20,1629608,Dewan Hernandez,C,5,14,4,12,1,2,Center,2,Driving Layup Shot,5.357142857142857
2013-14,203473,Dewayne Dedmon,C,38,83,38,83,0,0,Center,6,Jump Shot,5.180722891566265
2014-15,203473,Dewayne Dedmon,C,91,162,91,161,0,1,Center,2,Layup Shot,2.8333333333333335
2015-16,203473,Dewayne Dedmon,C,99,177,99,177,0,0,Center,10,Jump Shot,4.242937853107344
2016-17,203473,Dewayne Dedmon,C,161,259,161,259,0,0,Center,12,Layup Shot,2.8223938223938223
2017-18,203473,Dewayne Dedmon,C,250,477,200,336,50,141,Center,13,Jump Shot,12.522012578616351
2018-19,203473,Dewayne Dedmon,C,259,526,176,309,83,217,Center,8,Jump Shot,12.739543726235741
2019-20,203473,Dewayne Dedmon,C,102,255,80,148,22,107,Center,4,Jump Shot,13.04313725490196
2020-21,203473,Dewayne Dedmon,C,46,65,45,60,1,5,Center,1,Cutting Layup Shot,4.953846153846154
2021-22,203473,Dewayne Dedmon,C,164,290,145,243,19,47,Center,1,Jump Shot,7.686206896551724
2022-23,203473,Dewayne Dedmon,C,77,151,65,112,12,39,Center,1,Jump Shot,9.629139072847682
2010-11,202354,Dexter Pittman,C,1,3,1,3,0,0,Center,0,Layup Shot,4.0
2011-12,202354,Dexter Pittman,C,44,94,44,94,0,0,Center,2,Layup Shot,3.797872340425532
2012-13,202354,Dexter Pittman,C,4,11,4,11,0,0,Center,2,Layup Shot,3.727272727272727
2013-14,202354,Dexter Pittman,C,0,1,0,1,0,0,Center,0,Putback Layup Shot,1.0
2016-17,1627738,Deyonta Davis,C,24,47,24,47,0,0,Center,3,Jump Shot,4.851063829787234
2017-18,1627738,Deyonta Davis,C,161,265,161,265,0,0,Center,3,Jump Shot,5.60377358490566
2018-19,1627738,Deyonta Davis,C,15,22,15,21,0,1,Center,1,Jump Shot,4.045454545454546
2016-17,1627754,Diamond Stone,C,3,13,3,13,0,0,Left Side,1,Jump Shot,9.76923076923077
2012-13,203197,Diante Garrett,PG,16,49,13,34,3,15,Center,5,Jump Shot,12.755102040816327
2013-14,203197,Diante Garrett,PG,101,264,65,169,36,95,Center,4,Jump Shot,14.715909090909092
2020-21,1629712,Didi Louzada,SF,3,13,1,5,2,8,Center,0,Jump Shot,17.23076923076923
2021-22,1629712,Didi Louzada,SG-SF,12,33,3,10,9,23,Center,0,Jump Shot,19.454545454545453
2005-06,101159,Dijon Thompson,SG,11,25,7,14,4,11,Center,8,Jump Shot,14.72
2006-07,101159,Dijon Thompson,SF,6,15,6,13,0,2,Center,2,Jump Shot,9.666666666666666
2003-04,87,Dikembe Mutombo,C,141,295,141,295,0,0,Center,6,Jump Shot,4.728813559322034
2004-05,87,Dikembe Mutombo,C,108,217,108,217,0,0,Center,0,Layup Shot,4.023041474654378
2005-06,87,Dikembe Mutombo,C,50,95,50,95,0,0,Center,0,Layup Shot,2.8421052631578947
2006-07,87,Dikembe Mutombo,C,85,153,85,153,0,0,Center,0,Layup Shot,2.784313725490196
2007-08,87,Dikembe Mutombo,C,43,80,43,80,0,0,Center,0,Layup Shot,3.25
2008-09,87,Dikembe Mutombo,C,5,13,5,13,0,0,Center,0,Layup Shot,1.0
2017-18,1628415,Dillon Brooks,SF,340,772,246,508,94,264,Center,8,Jump Shot,13.696891191709845
2018-19,1628415,Dillon Brooks,SF,49,122,34,82,15,40,Center,1,Jump Shot,12.655737704918034
2019-20,1628415,Dillon Brooks,SG,435,1068,288,657,147,411,Center,7,Jump Shot,15.116104868913858
2020-21,1628415,Dillon Brooks,SF,432,1031,304,659,128,372,Center,14,Jump Shot,14.537342386032977
2021-22,1628415,Dillon Brooks,SF,227,526,181,377,46,149,Center,3,Pullup Jump shot,12.771863117870723
2022-23,1628415,Dillon Brooks,SF,392,991,249,552,143,439,Center,12,Jump Shot,15.300706357214935
2003-04,1901,Dion Glover,SG,230,589,190,470,40,119,Center,11,Jump Shot,11.056027164685908
2004-05,1901,Dion Glover,SG,8,22,7,14,1,8,Center,2,Jump Shot,10.409090909090908
2012-13,203079,Dion Waiters,SG,336,815,273,612,63,203,Center,16,Jump Shot,12.41840490797546
2013-14,203079,Dion Waiters,SG,430,993,338,743,92,250,Center,17,Jump Shot,13.508559919436053
2014-15,203079,Dion Waiters,SG,375,946,302,700,73,246,Center,10,Jump Shot,12.566596194503171
2015-16,203079,Dion Waiters,SG,282,705,196,466,86,239,Center,10,Jump Shot,13.8822695035461
2016-17,203079,Dion Waiters,SG,281,663,196,448,85,215,Center,15,Jump Shot,13.294117647058824
2017-18,203079,Dion Waiters,SG,163,410,111,240,52,170,Center,13,Jump Shot,14.958536585365854
2018-19,203079,Dion Waiters,SG,198,478,89,189,109,289,Center,9,Jump Shot,17.315899581589957
2019-20,203079,Dion Waiters,SG,41,99,26,52,15,47,Center,2,Jump Shot,15.353535353535353
2013-14,202091,Dionte Christmas,SF,22,62,13,31,9,31,Center,5,Jump Shot,17.516129032258064
2003-04,1717,Dirk Nowitzki,C,605,1310,506,1020,99,290,Center,16,Jump Shot,14.906106870229008
2004-05,1717,Dirk Nowitzki,PF,663,1445,572,1217,91,228,Center,20,Jump Shot,14.092733564013841
2005-06,1717,Dirk Nowitzki,PF,751,1564,641,1293,110,271,Center,22,Jump Shot,13.957161125319693
2006-07,1717,Dirk Nowitzki,PF,673,1341,601,1168,72,173,Center,22,Jump Shot,13.425055928411632
2007-08,1717,Dirk Nowitzki,PF,630,1314,551,1094,79,220,Center,24,Jump Shot,13.518264840182649
2008-09,1717,Dirk Nowitzki,PF,774,1616,713,1446,61,170,Center,24,Jump Shot,13.400990099009901
2009-10,1717,Dirk Nowitzki,PF,720,1496,669,1375,51,121,Center,22,Jump Shot,13.287433155080214
2010-11,1717,Dirk Nowitzki,PF,610,1179,544,1011,66,168,Center,22,Jump Shot,13.894826123833758
2011-12,1717,Dirk Nowitzki,PF,473,1034,395,822,78,212,Center,13,Jump Shot,15.070599613152805
2012-13,1717,Dirk Nowitzki,PF,343,728,278,571,65,157,Center,13,Jump Shot,15.791208791208792
2013-14,1717,Dirk Nowitzki,PF,633,1273,502,944,131,329,Center,20,Jump Shot,16.186959937156324
2014-15,1717,Dirk Nowitzki,PF,487,1062,383,788,104,274,Center,18,Jump Shot,16.408662900188325
2015-16,1717,Dirk Nowitzki,PF,498,1112,372,770,126,342,Center,20,Jump Shot,16.598021582733814
2016-17,1717,Dirk Nowitzki,PF,296,678,217,469,79,209,Center,8,Jump Shot,17.535398230088497
2017-18,1717,Dirk Nowitzki,C,346,758,208,421,138,337,Center,3,Jump Shot,19.238786279683378
2018-19,1717,Dirk Nowitzki,PF,135,376,71,171,64,205,Center,3,Jump Shot,20.4468085106383
2016-17,1627734,Domantas Sabonis,PF,192,481,141,322,51,159,Center,7,Jump Shot,12.253638253638254
2017-18,1627734,Domantas Sabonis,C,340,661,327,624,13,37,Center,5,Jump Shot,7.202723146747353
2018-19,1627734,Domantas Sabonis,C,413,700,404,683,9,17,Center,9,Jump Shot,5.771428571428571
2019-20,1627734,Domantas Sabonis,PF,458,848,441,781,17,67,Center,13,Jump Shot,6.714622641509434
2020-21,1627734,Domantas Sabonis,PF,484,904,432,742,52,162,Center,13,Jump Shot,8.32853982300885
2021-22,1627734,Domantas Sabonis,PF-C,443,773,404,648,39,125,Center,10,Jump Shot,7.164294954721863
2022-23,1627734,Domantas Sabonis,C,577,938,546,855,31,83,Center,10,Jump Shot,5.840085287846482
2007-08,201187,Dominic McGuire,SG,39,103,38,97,1,6,Center,6,Jump Shot,8.359223300970873
2008-09,201187,Dominic McGuire,SF,140,324,138,320,2,4,Center,6,Jump Shot,8.898148148148149
2009-10,201187,Dominic McGuire,SF,19,52,19,52,0,0,Center,3,Jump Shot,8.26923076923077
2010-11,201187,Dominic McGuire,SF,72,182,72,180,0,2,Center,6,Jump Shot,8.956043956043956
2011-12,201187,Dominic McGuire,PF,94,210,94,206,0,4,Center,5,Jump Shot,8.30952380952381
2012-13,201187,Dominic McGuire,SF,24,56,24,56,0,0,Center,2,Jump Shot,10.696428571428571
2022-23,1631230,Dominick Barlow,SF,46,86,46,82,0,4,Center,9,Jump Shot,5.058139534883721
2010-11,202346,Dominique Jones,SG,14,45,14,41,0,4,Center,5,Jump Shot,10.066666666666666
2011-12,202346,Dominique Jones,SG,29,73,28,65,1,8,Center,7,Jump Shot,8.191780821917808
2012-13,202346,Dominique Jones,PG,40,109,39,100,1,9,Center,3,Jump Shot,6.055045871559633
2011-12,202388,Donald Sloan,PG,79,198,77,173,2,25,Center,10,Jump Shot,11.222222222222221
2012-13,202388,Donald Sloan,SG-PG,27,78,20,59,7,19,Center,0,Jump Shot,12.08974358974359
2013-14,202388,Donald Sloan,SG,44,117,34,75,10,42,Center,11,Jump Shot,13.41025641025641
2014-15,202388,Donald Sloan,PG,145,355,104,224,41,131,Center,17,Jump Shot,13.571830985915494
2015-16,202388,Donald Sloan,PG,153,349,116,251,37,98,Center,7,Jump Shot,11.805157593123209
2012-13,202700,Donatas Motiejunas,PF,97,213,73,130,24,83,Center,10,Jump Shot,12.126760563380282
2013-14,202700,Donatas Motiejunas,PF,131,296,110,212,21,84,Center,4,Jump Shot,10.574324324324325
2014-15,202700,Donatas Motiejunas,PF,353,700,304,567,49,133,Center,6,Jump Shot,8.397142857142857
2015-16,202700,Donatas Motiejunas,PF,90,205,74,148,16,57,Center,3,Jump Shot,10.8
2016-17,202700,Donatas Motiejunas,PF,57,138,46,91,11,47,Center,7,Jump Shot,11.96376811594203
2018-19,202700,Donatas Motiejunas,PF,3,6,3,6,0,0,Center,2,Hook Shot,7.333333333333333
2005-06,101182,Donell Taylor,SG,53,136,49,119,4,17,Center,3,Jump Shot,11.345588235294118
2006-07,101182,Donell Taylor,SG,56,140,53,123,3,17,Center,6,Jump Shot,12.2
2003-04,2051,Donnell Harvey,PF,89,201,89,198,0,3,Center,4,Jump Shot,5.925373134328358
2004-05,2051,Donnell Harvey,PF,2,2,2,2,0,0,Center,1,Layup Shot,0.5
2017-18,1628378,Donovan Mitchell,SG,595,1362,408,812,187,550,Center,32,Jump Shot,14.388399412628488
2018-19,1628378,Donovan Mitchell,SG,661,1530,473,1011,188,519,Center,32,Jump Shot,13.201960784313725
2019-20,1628378,Donovan Mitchell,SG,602,1342,429,869,173,473,Center,28,Pullup Jump shot,14.295081967213115
2020-21,1628378,Donovan Mitchell,PG,478,1091,300,630,178,461,Center,24,Pullup Jump shot,15.529789184234646
2021-22,1628378,Donovan Mitchell,SG,617,1376,385,722,232,654,Center,27,Pullup Jump shot,16.180959302325583
2022-23,1628378,Donovan Mitchell,SG,679,1402,434,767,245,635,Center,29,Pullup Jump shot,15.847360912981456
2022-23,1631495,Donovan Williams,SG,2,5,2,3,0,2,Center,2,Running Layup Shot,11.6
2019-20,1629743,Donta Hall,C-PF,15,22,15,22,0,0,Center,2,Cutting Layup Shot,2.4545454545454546
2020-21,1629743,Donta Hall,PF,25,35,25,35,0,0,Center,3,Putback Layup Shot,2.6285714285714286
2004-05,2764,Donta Smith,SG,44,113,38,91,6,22,Center,4,Jump Shot,9.70796460176991
2005-06,2764,Donta Smith,SG,15,27,13,23,2,4,Center,0,Jump Shot,7.37037037037037
2018-19,1628978,Donte DiVincenzo,SG,50,124,28,41,22,83,Center,3,Jump Shot,18.153225806451612
2019-20,1628978,Donte DiVincenzo,SG,232,510,149,263,83,247,Center,12,Jump Shot,14.762745098039217
2020-21,1628978,Donte DiVincenzo,SG,253,603,122,257,131,346,Center,3,Jump Shot,16.6849087893864
2021-22,1628978,Donte DiVincenzo,SG,118,336,44,118,74,218,Center,4,Jump Shot,18.142857142857142
2022-23,1628978,Donte DiVincenzo,SG,235,540,85,162,150,378,Center,15,Jump Shot,19.251851851851853
2018-19,1629055,Donte Grantham,SF,0,2,0,0,0,2,Left Side Center,0,Jump Shot,26.0
2008-09,201590,Donte Greene,SF,77,236,51,136,26,100,Center,7,Jump Shot,15.73728813559322
2009-10,201590,Donte Greene,SF,244,553,175,370,69,183,Center,9,Jump Shot,12.772151898734178
2010-11,201590,Donte Greene,SF,156,386,111,232,45,154,Center,5,Jump Shot,14.450777202072539
2011-12,201590,Donte Greene,PF,108,266,83,161,25,105,Center,6,Jump Shot,14.6203007518797
2008-09,200971,Dontell Jefferson,SG,11,22,10,20,1,2,Center,0,Jump Shot,7.5
2003-04,923,Donyell Marshall,PF,470,1020,339,695,131,325,Center,19,Jump Shot,12.548039215686275
2004-05,923,Donyell Marshall,PF,262,592,111,229,151,363,Center,16,Jump Shot,17.050675675675677
2005-06,923,Donyell Marshall,PF,265,671,137,276,128,395,Center,14,Jump Shot,15.830104321907601
2006-07,923,Donyell Marshall,PF,209,493,114,222,95,271,Center,10,Jump Shot,14.880324543610548
2007-08,923,Donyell Marshall,PF,32,98,17,45,15,53,Center,1,Jump Shot,15.255102040816327
2008-09,923,Donyell Marshall,PF,33,73,8,18,25,55,Center,8,Jump Shot,19.835616438356166
2004-05,2748,Dorell Wright,SF,3,11,3,7,0,4,Right Side Center,0,Jump Shot,15.090909090909092
2005-06,2748,Dorell Wright,SF,20,43,17,37,3,6,Center,4,Jump Shot,14.209302325581396
2006-07,2748,Dorell Wright,SF,162,364,157,330,5,34,Center,10,Jump Shot,11.219780219780219
2007-08,2748,Dorell Wright,SF,143,293,139,282,4,11,Center,3,Jump Shot,13.276450511945393
2008-09,2748,Dorell Wright,SF,8,20,8,20,0,0,Center,0,Jump Shot,7.95
2009-10,2748,Dorell Wright,SF,194,419,133,262,61,157,Center,11,Jump Shot,14.914081145584726
2010-11,2748,Dorell Wright,SF,485,1146,291,630,194,516,Center,15,Jump Shot,15.56457242582897
2011-12,2748,Dorell Wright,SF,222,526,117,234,105,292,Center,4,Jump Shot,16.99809885931559
2012-13,2748,Dorell Wright,SF,237,599,102,238,135,361,Left Side Center,19,Jump Shot,18.525876460767947
2013-14,2748,Dorell Wright,SF,111,297,42,95,69,202,Left Side,1,Jump Shot,19.32323232323232
2014-15,2748,Dorell Wright,SF,72,190,31,82,41,108,Center,0,Jump Shot,17.305263157894736
2016-17,1627827,Dorian Finney-Smith,PF,124,333,68,142,56,191,Center,4,Jump Shot,16.123123123123122
2017-18,1627827,Dorian Finney-Smith,PF,46,121,26,54,20,67,Center,0,Jump Shot,16.355371900826448
2018-19,1627827,Dorian Finney-Smith,SF,228,528,149,274,79,254,Center,12,Jump Shot,13.573863636363637
2019-20,1627827,Dorian Finney-Smith,PF,243,522,129,219,114,303,Center,11,Jump Shot,15.057471264367816
2020-21,1627827,Dorian Finney-Smith,PF,220,466,101,164,119,302,Center,8,Jump Shot,16.742489270386265
2021-22,1627827,Dorian Finney-Smith,PF,326,692,154,257,172,435,Center,10,Jump Shot,16.539017341040463
2022-23,1627827,Dorian Finney-Smith,PF,196,501,82,163,114,338,Center,7,Jump Shot,17.331337325349303
2012-13,203117,Doron Lamb,SG,60,163,46,126,14,37,Center,9,Jump Shot,13.079754601226995
2013-14,203117,Doron Lamb,SG,63,160,27,70,36,90,Center,8,Jump Shot,18.625
2003-04,57,Doug Christie,SG,317,688,268,546,49,142,Center,10,Jump Shot,13.598837209302326
2004-05,57,Doug Christie,SG,130,332,115,270,15,62,Center,2,Jump Shot,14.734939759036145
2005-06,57,Doug Christie,SG,9,26,9,25,0,1,Center,0,Jump Shot,13.346153846153847
2006-07,57,Doug Christie,SG,5,17,4,11,1,6,Center,0,Jump Shot,17.647058823529413
2014-15,203926,Doug McDermott,SF,43,107,30,66,13,41,Center,3,Jump Shot,12.813084112149532
2015-16,203926,Doug McDermott,SF,291,644,181,385,110,259,Center,7,Jump Shot,14.496894409937887
2016-17,203926,Doug McDermott,SF,222,497,145,289,77,208,Center,11,Jump Shot,15.448692152917506
2017-18,203926,Doug McDermott,SF,237,508,145,292,92,216,Center,11,Jump Shot,14.125984251968504
2018-19,203926,Doug McDermott,SF,207,422,123,216,84,206,Center,10,Jump Shot,15.644549763033176
2019-20,203926,Doug McDermott,PF,267,547,139,253,128,294,Center,3,Jump Shot,16.356489945155392
2020-21,203926,Doug McDermott,PF,354,665,243,379,111,286,Center,8,Jump Shot,12.350375939849624
2021-22,203926,Doug McDermott,PF,215,465,107,209,108,256,Center,2,Jump Shot,16.10537634408602
2022-23,203926,Doug McDermott,SF,239,523,116,225,123,298,Center,0,Jump Shot,16.766730401529635
2003-04,77,Doug Overton,PG,99,245,96,222,3,23,Center,6,Jump Shot,15.56734693877551
2016-17,1627733,Dragan Bender,PF,57,160,29,60,28,100,Center,4,Jump Shot,17.71875
2017-18,1627733,Dragan Bender,PF,187,484,69,162,118,322,Center,6,Jump Shot,17.85330578512397
2018-19,1627733,Dragan Bender,PF,88,197,66,96,22,101,Center,4,Jump Shot,13.436548223350254
2019-20,1627733,Dragan Bender,PF-C,41,92,26,49,15,43,Center,0,Jump Shot,13.48913043478261
2012-13,203110,Draymond Green,SF,84,257,70,190,14,67,Center,7,Jump Shot,13.622568093385214
2013-14,203110,Draymond Green,SF,187,459,132,294,55,165,Center,13,Jump Shot,13.291938997821351
2014-15,203110,Draymond Green,PF,339,765,228,436,111,329,Center,5,Jump Shot,13.649673202614379
2015-16,203110,Draymond Green,PF,401,819,301,561,100,258,Center,11,Jump Shot,10.015873015873016
2016-17,203110,Draymond Green,PF,272,650,191,387,81,263,Center,8,Jump Shot,12.26923076923077
2017-18,203110,Draymond Green,PF,281,619,204,363,77,256,Center,9,Jump Shot,13.390953150242327
2018-19,203110,Draymond Green,PF,188,422,141,257,47,165,Center,2,Jump Shot,12.919431279620854
2019-20,203110,Draymond Green,PF,123,316,87,187,36,129,Center,4,Jump Shot,14.481012658227849
2020-21,203110,Draymond Green,PF,170,380,136,254,34,126,Center,5,Jump Shot,11.676315789473684
2021-22,203110,Draymond Green,PF,135,257,119,203,16,54,Center,3,Jump Shot,9.38910505836576
2022-23,203110,Draymond Green,PF,250,474,210,343,40,131,Center,5,Jump Shot,9.856540084388186
2018-19,1629234,Drew Eubanks,PF,15,26,15,26,0,0,Center,9,Hook Shot,4.769230769230769
2019-20,1629234,Drew Eubanks,C,43,67,42,66,1,1,Center,3,Hook Shot,4.686567164179104
2020-21,1629234,Drew Eubanks,C,116,205,114,203,2,2,Center,7,Layup Shot,4.15609756097561
2021-22,1629234,Drew Eubanks,C,221,371,216,348,5,23,Center,4,Hook Shot,5.787061994609164
2022-23,1629234,Drew Eubanks,C,214,334,207,316,7,18,Center,5,Hook Shot,5.3532934131736525
2003-04,2400,Drew Gooden,PF,369,829,360,787,9,42,Center,17,Jump Shot,9.361881785283474
2004-05,2400,Drew Gooden,PF,464,943,459,915,5,28,Center,13,Jump Shot,7.454931071049841
2005-06,2400,Drew Gooden,PF,334,652,333,649,1,3,Center,7,Jump Shot,5.840490797546012
2006-07,2400,Drew Gooden,PF,371,784,370,778,1,6,Center,4,Jump Shot,9.105867346938776
2007-08,2400,Drew Gooden,PF,332,740,332,734,0,6,Center,10,Jump Shot,8.651351351351352
2008-09,2400,Drew Gooden,PF,237,506,237,502,0,4,Center,7,Jump Shot,10.274703557312254
2009-10,2400,Drew Gooden,C-PF,288,602,287,594,1,8,Center,5,Jump Shot,6.8023255813953485
2010-11,2400,Drew Gooden,PF,156,362,153,342,3,20,Center,7,Jump Shot,11.569060773480663
2011-12,2400,Drew Gooden,C,286,656,271,602,15,54,Center,6,Jump Shot,11.38109756097561
2012-13,2400,Drew Gooden,C,20,61,19,56,1,5,Center,2,Jump Shot,9.278688524590164
2013-14,2400,Drew Gooden,C,76,143,69,126,7,17,Center,2,Jump Shot,12.034965034965035
2014-15,2400,Drew Gooden,PF,110,276,87,217,23,59,Center,2,Jump Shot,14.771739130434783
2015-16,2400,Drew Gooden,PF,33,103,26,62,7,41,Center,3,Jump Shot,15.514563106796116
2014-15,204079,Drew Gordon,PF,8,19,8,16,0,3,Center,1,Jump Shot,8.947368421052632
2022-23,1630696,Dru Smith,SG,18,45,13,26,5,19,Center,2,Jump Shot,14.333333333333334
2021-22,1630613,Duane Washington Jr.,PG,173,427,92,212,81,215,Center,11,Jump Shot,15.836065573770492
2022-23,1630613,Duane Washington Jr.,SG,94,256,54,145,40,111,Center,8,Jump Shot,16.33203125
2015-16,1626251,Duje Dukan,SF,2,10,0,5,2,5,Left Side,0,Jump Shot,20.4
2018-19,1629130,Duncan Robinson,SF,18,46,8,11,10,35,Right Side Center,1,Jump Shot,20.347826086956523
2019-20,1629130,Duncan Robinson,SG,323,687,53,81,270,606,Center,12,Jump Shot,22.777292576419214
2020-21,1629130,Duncan Robinson,SF,315,717,65,104,250,613,Center,7,Jump Shot,22.270571827057182
2021-22,1629130,Duncan Robinson,SG,290,726,58,102,232,624,Center,6,Jump Shot,22.18595041322314
2022-23,1629130,Duncan Robinson,SF,88,237,25,45,63,192,Center,3,Jump Shot,21.864978902953588
2018-19,1628605,Dusty Hannahs,SG,3,12,3,7,0,5,Center,0,Jump Shot,12.583333333333334
2019-20,1628605,Dusty Hannahs,SG,4,9,2,6,2,3,Center,1,Jump Shot,13.777777777777779
2017-18,1628407,Dwayne Bacon,SG,72,192,61,149,11,43,Center,6,Jump Shot,14.213541666666666
2018-19,1628407,Dwayne Bacon,SG,122,257,84,170,38,87,Center,10,Jump Shot,12.470817120622568
2019-20,1628407,Dwayne Bacon,SG,85,244,66,177,19,67,Center,3,Jump Shot,11.098360655737705
2020-21,1628407,Dwayne Bacon,SG,292,726,233,519,59,207,Center,10,Jump Shot,12.356749311294767
2005-06,101204,Dwayne Jones,PF,4,10,4,10,0,0,Center,1,Layup Shot,1.9
2006-07,101204,Dwayne Jones,PF,0,1,0,1,0,0,Center,0,Layup Shot,0.0
2007-08,101204,Dwayne Jones,PF,25,47,25,46,0,1,Center,2,Layup Shot,2.0
2008-09,101204,Dwayne Jones,PF,4,7,4,7,0,0,Center,0,Layup Shot,1.5714285714285714
2013-14,202779,Dwight Buycks,PG,15,48,10,31,5,17,Center,2,Jump Shot,15.145833333333334
2014-15,202779,Dwight Buycks,PG,18,40,11,29,7,11,Center,3,Jump Shot,13.05
2017-18,202779,Dwight Buycks,PG,82,198,67,153,15,45,Center,4,Jump Shot,13.131313131313131
2004-05,2730,Dwight Howard,PF,352,677,352,675,0,2,Center,14,Layup Shot,3.471196454948301
2005-06,2730,Dwight Howard,PF,468,881,468,879,0,2,Center,13,Layup Shot,3.1237230419977298
2006-07,2730,Dwight Howard,C,526,873,525,871,1,2,Center,17,Layup Shot,2.524627720504009
2007-08,2730,Dwight Howard,C,583,974,583,970,0,4,Center,15,Layup Shot,3.1570841889117043
2008-09,2730,Dwight Howard,C,560,979,560,977,0,2,Center,10,Layup Shot,3.1818181818181817
2009-10,2730,Dwight Howard,C,510,834,510,827,0,7,Center,7,Layup Shot,3.537170263788969
2010-11,2730,Dwight Howard,C,619,1044,619,1037,0,7,Center,13,Layup Shot,4.438697318007663
2011-12,2730,Dwight Howard,C,416,726,416,719,0,7,Center,8,Hook Shot,3.7107438016528924
2012-13,2730,Dwight Howard,C,470,813,469,807,1,6,Center,13,Layup Shot,3.2460024600246005
2013-14,2730,Dwight Howard,C,473,800,471,793,2,7,Center,7,Layup Shot,3.0325
2014-15,2730,Dwight Howard,C,251,423,250,421,1,2,Center,3,Layup Shot,2.7186761229314422
2015-16,2730,Dwight Howard,C,372,600,372,594,0,6,Center,10,Layup Shot,2.5866666666666664
2016-17,2730,Dwight Howard,C,388,613,388,611,0,2,Center,6,Layup Shot,2.504078303425775
2017-18,2730,Dwight Howard,C,506,911,505,904,1,7,Center,8,Layup Shot,4.686059275521405
2018-19,2730,Dwight Howard,C,43,69,43,69,0,0,Center,0,Layup Shot,4.101449275362318
2019-20,2730,Dwight Howard,C,202,277,199,272,3,5,Center,3,Alley Oop Dunk Shot,2.032490974729242
2020-21,2730,Dwight Howard,C,178,303,173,283,5,20,Center,2,Layup Shot,4.02970297029703
2021-22,2730,Dwight Howard,C,134,219,126,204,8,15,Center,4,Layup Shot,4.114155251141552
2014-15,203939,Dwight Powell,PF,31,67,28,56,3,11,Center,6,Jump Shot,11.044776119402986
2015-16,203939,Dwight Powell,PF,146,296,144,280,2,16,Center,4,Jump Shot,8.408783783783784
2016-17,203939,Dwight Powell,C,194,377,173,303,21,74,Center,13,Jump Shot,10.021220159151193
2017-18,203939,Dwight Powell,C,255,430,227,346,28,84,Center,10,Jump Shot,7.890697674418605
2018-19,203939,Dwight Powell,C,290,486,251,359,39,127,Center,11,Jump Shot,8.09670781893004
2019-20,203939,Dwight Powell,C,146,229,136,190,10,39,Center,1,Jump Shot,5.593886462882096
2020-21,203939,Dwight Powell,C,120,194,115,173,5,21,Center,4,Alley Oop Dunk Shot,4.046391752577319
2021-22,203939,Dwight Powell,C,269,401,256,364,13,37,Center,2,Alley Oop Dunk Shot,4.1895261845386536
2022-23,203939,Dwight Powell,C,197,269,197,264,0,5,Center,3,Cutting Layup Shot,2.0446096654275094
2003-04,2548,Dwyane Wade,PG,371,798,355,745,16,53,Center,9,Jump Shot,7.120300751879699
2004-05,2548,Dwyane Wade,SG,630,1318,617,1273,13,45,Center,28,Jump Shot,8.03566009104704
2005-06,2548,Dwyane Wade,SG,699,1413,686,1337,13,76,Center,31,Jump Shot,9.581033262561926
2006-07,2548,Dwyane Wade,SG,472,962,451,883,21,79,Center,18,Jump Shot,10.66008316008316
2007-08,2548,Dwyane Wade,SG,439,937,417,860,22,77,Center,22,Jump Shot,11.16648879402348
2008-09,2548,Dwyane Wade,SG,854,1739,766,1461,88,278,Center,36,Jump Shot,11.99367452558942
2009-10,2548,Dwyane Wade,SG,719,1511,646,1268,73,243,Center,16,Jump Shot,10.901389808074123
2010-11,2548,Dwyane Wade,SG,692,1383,629,1178,63,205,Center,15,Jump Shot,9.897324656543745
2011-12,2548,Dwyane Wade,SG,416,837,401,781,15,56,Center,15,Jump Shot,8.943847072879331
2012-13,2548,Dwyane Wade,SG,569,1093,552,1027,17,66,Center,15,Jump Shot,9.043000914913083
2013-14,2548,Dwyane Wade,SG,415,761,406,729,9,32,Center,13,Jump Shot,9.09329829172142
2014-15,2548,Dwyane Wade,SG,509,1084,480,982,29,102,Center,33,Jump Shot,11.467712177121772
2015-16,2548,Dwyane Wade,SG,540,1183,533,1139,7,44,Center,31,Jump Shot,9.571428571428571
2016-17,2548,Dwyane Wade,SG,414,954,369,810,45,144,Center,12,Jump Shot,11.815513626834381
2017-18,2548,Dwyane Wade,SG,299,682,267,571,32,111,Center,9,Jump Shot,11.127565982404692
2018-19,2548,Dwyane Wade,SG,416,960,330,699,86,261,Center,25,Jump Shot,12.519791666666666
2020-21,1629685,Dylan Windler,SF,57,130,31,53,26,77,Center,8,Jump Shot,15.738461538461538
2021-22,1629685,Dylan Windler,SF,37,98,16,28,21,70,Center,5,Jump Shot,18.26530612244898
2022-23,1629685,Dylan Windler,SF,2,3,1,1,1,2,Right Side Center,1,Jump Shot,17.0
2022-23,1630700,Dyson Daniels,PG,87,208,60,122,27,86,Center,6,Jump Shot,13.125
2018-19,1629058,Dzanan Musa,SG,9,22,8,12,1,10,Center,6,Jump Shot,15.136363636363637
2019-20,1629058,Dzanan Musa,SF,64,172,45,94,19,78,Center,5,Jump Shot,13.029069767441861
2011-12,202734,E'Twaun Moore,PG,43,113,26,68,17,45,Center,10,Jump Shot,16.61061946902655
2012-13,202734,E'Twaun Moore,SG,237,598,170,401,67,197,Center,20,Jump Shot,15.488294314381271
2013-14,202734,E'Twaun Moore,SG,195,456,138,295,57,161,Center,8,Jump Shot,14.032894736842104
2014-15,202734,E'Twaun Moore,SG,62,139,49,101,13,38,Center,6,Jump Shot,12.66906474820144
2015-16,202734,E'Twaun Moore,SG,187,389,140,285,47,104,Center,10,Jump Shot,12.876606683804628
2016-17,202734,E'Twaun Moore,SG,283,618,206,411,77,207,Center,7,Jump Shot,13.864077669902912
2017-18,202734,E'Twaun Moore,SG,423,832,295,531,128,301,Center,14,Jump Shot,13.165865384615385
2018-19,202734,E'Twaun Moore,SG,256,532,180,356,76,176,Center,11,Jump Shot,12.857142857142858
2019-20,202734,E'Twaun Moore,SG,186,437,123,270,63,167,Center,3,Jump Shot,13.965675057208237
2020-21,202734,E'Twaun Moore,SG,55,121,44,86,11,35,Center,5,Jump Shot,12.537190082644628
2005-06,2853,Earl Barron,C,5,16,5,16,0,0,Center,3,Jump Shot,9.375
2006-07,2853,Earl Barron,C,24,83,24,82,0,1,Center,6,Jump Shot,10.879518072289157
2007-08,2853,Earl Barron,C,132,327,131,314,1,13,Center,6,Jump Shot,12.15290519877676
2009-10,2853,Earl Barron,C,30,68,30,68,0,0,Center,1,Jump Shot,9.691176470588236
2010-11,2853,Earl Barron,C,32,99,32,99,0,0,Center,2,Jump Shot,9.191919191919192
2011-12,2853,Earl Barron,C,2,4,2,4,0,0,Center,1,Jump Shot,8.75
2012-13,2853,Earl Barron,C,18,51,18,51,0,0,Center,3,Jump Shot,9.843137254901961
2014-15,2853,Earl Barron,C,12,39,10,35,2,4,Center,1,Jump Shot,12.384615384615385
2003-04,1863,Earl Boykins,SG,321,766,266,595,55,171,Center,14,Jump Shot,14.945169712793733
2004-05,1863,Earl Boykins,PG,340,824,284,658,56,166,Center,17,Jump Shot,14.242718446601941
2005-06,1863,Earl Boykins,PG,271,661,209,482,62,179,Center,12,Jump Shot,15.349470499243571
2006-07,1863,Earl Boykins,PG,323,769,228,530,95,239,Center,11,Jump Shot,14.583875162548765
2007-08,1863,Earl Boykins,PG,61,172,47,128,14,44,Center,3,Jump Shot,13.738372093023257
2009-10,1863,Earl Boykins,PG,172,403,153,343,19,60,Center,6,Jump Shot,13.674937965260545
2010-11,1863,Earl Boykins,PG,156,352,129,281,27,71,Center,8,Jump Shot,14.335227272727273
2011-12,1863,Earl Boykins,PG,12,36,10,27,2,9,Center,0,Jump Shot,17.833333333333332
2009-10,201947,Earl Clark,PF,56,151,54,146,2,5,Center,5,Jump Shot,12.304635761589404
2010-11,201947,Earl Clark,SF,68,158,68,153,0,5,Center,3,Jump Shot,9.715189873417721
2011-12,201947,Earl Clark,PF,51,139,51,139,0,0,Center,1,Jump Shot,10.014388489208633
2012-13,201947,Earl Clark,PF,170,386,135,282,35,104,Center,6,Jump Shot,13.44041450777202
2013-14,201947,Earl Clark,PF,97,261,56,139,41,122,Center,2,Jump Shot,16.915708812260537
2014-15,201947,Earl Clark,PF,11,30,7,16,4,14,Right Side Center,1,Jump Shot,18.733333333333334
2003-04,2248,Earl Watson,PG,172,464,146,358,26,106,Center,6,Jump Shot,12.46551724137931
2004-05,2248,Earl Watson,PG,236,554,184,391,52,163,Center,9,Jump Shot,11.635379061371841
2005-06,2248,Earl Watson,PG,219,509,109,237,110,272,Center,8,Jump Shot,16.64636542239686
2006-07,2248,Earl Watson,PG,263,687,171,407,92,280,Center,4,Jump Shot,15.179039301310043
2007-08,2248,Earl Watson,PG,339,747,290,615,49,132,Center,11,Jump Shot,13.124497991967871
2008-09,2248,Earl Watson,PG,174,453,154,368,20,85,Center,9,Jump Shot,12.068432671081677
2009-10,2248,Earl Watson,PG,223,524,170,340,53,184,Center,11,Jump Shot,12.90648854961832
2010-11,2248,Earl Watson,PG,126,307,90,200,36,107,Center,1,Jump Shot,14.410423452768729
2011-12,2248,Earl Watson,PG,54,160,44,108,10,52,Center,2,Jump Shot,13.5625
2012-13,2248,Earl Watson,PG,37,120,32,92,5,28,Center,1,Jump Shot,11.4
2013-14,2248,Earl Watson,PG,3,11,1,4,2,7,Right Side,1,Jump Shot,20.09090909090909
2010-11,202334,Ed Davis,PF,215,373,215,373,0,0,Center,12,Jump Shot,4.351206434316354
2011-12,202334,Ed Davis,PF,172,335,172,334,0,1,Center,4,Jump Shot,6.325373134328358
2012-13,202334,Ed Davis,C-PF,260,482,260,482,0,0,Center,6,Jump Shot,5.6078838174273855
2013-14,202334,Ed Davis,PF,155,290,155,290,0,0,Center,5,Jump Shot,4.855172413793103
2014-15,202334,Ed Davis,PF,282,469,282,469,0,0,Center,14,Layup Shot,2.2452025586353943
2015-16,202334,Ed Davis,PF,206,337,206,337,0,0,Center,4,Layup Shot,2.0089020771513355
2016-17,202334,Ed Davis,PF,75,142,75,142,0,0,Center,0,Layup Shot,2.119718309859155
2017-18,202334,Ed Davis,C,170,292,170,291,0,1,Center,1,Layup Shot,2.410958904109589
2018-19,202334,Ed Davis,C,186,302,186,300,0,2,Center,1,Tip Layup Shot,1.7682119205298013
2019-20,202334,Ed Davis,C,22,46,22,46,0,0,Center,1,Layup Shot,2.6956521739130435
2020-21,202334,Ed Davis,C,19,44,19,44,0,0,Center,0,Tip Layup Shot,1.5227272727272727
2021-22,202334,Ed Davis,C,11,16,11,16,0,0,Center,1,Cutting Layup Shot,1.9375
2005-06,101188,Eddie Basden,SF,15,37,14,30,1,7,Center,2,Jump Shot,8.324324324324325
2003-04,2109,Eddie Gill,PG,15,36,12,28,3,8,Center,2,Jump Shot,14.63888888888889
2004-05,2109,Eddie Gill,PG,81,242,45,125,36,117,Center,4,Jump Shot,17.55785123966942
2005-06,2109,Eddie Gill,PG,10,45,3,22,7,23,Center,8,Jump Shot,18.288888888888888
2007-08,2109,Eddie Gill,PG,12,31,7,16,5,15,Center,2,Jump Shot,16.548387096774192
2008-09,2109,Eddie Gill,PG,6,9,4,6,2,3,Center,1,Jump Shot,13.0
2004-05,2204,Eddie Griffin,PF,202,522,135,318,67,204,Center,8,Jump Shot,14.298850574712644
2005-06,2204,Eddie Griffin,C,130,370,114,288,16,82,Center,4,Jump Shot,12.267567567567568
2006-07,2204,Eddie Griffin,PF,7,27,7,26,0,1,Center,0,Jump Shot,12.296296296296296
2003-04,2067,Eddie House,SG,161,449,110,313,51,136,Center,19,Jump Shot,16.91759465478842
2004-05,2067,Eddie House,PG-SG,165,366,121,269,44,97,Left Side,11,Jump Shot,17.707650273224044
2005-06,2067,Eddie House,PG,320,759,197,443,123,316,Right Side Center,7,Jump Shot,19.566534914361
2006-07,2067,Eddie House,SG,180,421,105,246,75,175,Left Side,10,Jump Shot,19.121140142517813
2007-08,2067,Eddie House,PG,217,531,100,233,117,298,Center,18,Jump Shot,20.683615819209038
2008-09,2067,Eddie House,PG,249,560,98,220,151,340,Right Side Center,10,Jump Shot,21.160714285714285
2009-10,2067,Eddie House,PG-SG,173,455,94,228,79,227,Right Side Center,7,Jump Shot,20.274725274725274
2010-11,2067,Eddie House,SG,128,321,60,146,68,175,Right Side Center,11,Jump Shot,20.91588785046729
2003-04,224,Eddie Jones,SG,473,1156,296,677,177,479,Center,13,Jump Shot,16.540657439446367
2004-05,224,Eddie Jones,SF,351,820,209,438,142,382,Center,16,Jump Shot,15.852439024390243
2005-06,224,Eddie Jones,SG,292,722,159,348,133,374,Center,18,Jump Shot,16.132963988919666
2006-07,224,Eddie Jones,SG,178,422,100,200,78,222,Center,8,Jump Shot,16.592417061611375
2007-08,224,Eddie Jones,SG,66,180,32,64,34,116,Center,3,Jump Shot,18.383333333333333
2003-04,1944,Eddie Robinson,SF,157,326,156,321,1,5,Center,5,Jump Shot,13.785276073619633
2003-04,2201,Eddy Curry,PF,417,840,416,839,1,1,Center,13,Layup Shot,4.0321428571428575
2004-05,2201,Eddy Curry,C,393,730,393,730,0,0,Center,13,Layup Shot,3.778082191780822
2005-06,2201,Eddy Curry,C,336,597,336,597,0,0,Center,3,Layup Shot,1.8425460636515913
2006-07,2201,Eddy Curry,C,585,1016,584,1015,1,1,Center,29,Layup Shot,2.377952755905512
2007-08,2201,Eddy Curry,C,297,544,297,544,0,0,Center,7,Layup Shot,2.676470588235294
2008-09,2201,Eddy Curry,C,2,2,2,2,0,0,Center,0,Driving Layup Shot,0.0
2009-10,2201,Eddy Curry,C,8,21,8,21,0,0,Center,0,Layup Shot,3.1904761904761907
2011-12,2201,Eddy Curry,C,12,26,12,26,0,0,Center,4,Layup Shot,2.0384615384615383
2012-13,2201,Eddy Curry,C,4,8,4,8,0,0,Center,1,Layup Shot,3.5
2017-18,1628410,Edmond Sumner,PG,1,1,1,1,0,0,Center,1,Running Finger Roll Layup Shot,0.0
2018-19,1628410,Edmond Sumner,PG,22,64,15,37,7,27,Center,2,Jump Shot,13.03125
2019-20,1628410,Edmond Sumner,SG,61,142,47,89,14,53,Center,4,Jump Shot,11.619718309859154
2020-21,1628410,Edmond Sumner,SG,148,282,113,194,35,88,Center,4,Jump Shot,9.893617021276595
2022-23,1628410,Edmond Sumner,SG,124,269,93,182,31,87,Center,9,Jump Shot,10.721189591078067
2003-04,2059,Eduardo Najera,SF,72,162,70,158,2,4,Center,5,Layup Shot,6.265432098765432
2004-05,2059,Eduardo Najera,PF,145,322,139,301,6,21,Center,5,Jump Shot,9.611801242236025
2005-06,2059,Eduardo Najera,PF,127,301,123,289,4,12,Center,3,Jump Shot,7.04983388704319
2006-07,2059,Eduardo Najera,PF,204,354,203,342,1,12,Center,4,Layup Shot,5.02542372881356
2007-08,2059,Eduardo Najera,PF,174,368,121,221,53,147,Center,3,Jump Shot,11.855978260869565
2008-09,2059,Eduardo Najera,PF,33,74,28,49,5,25,Center,2,Jump Shot,10.72972972972973
2009-10,2059,Eduardo Najera,PF,62,146,43,82,19,64,Center,4,Jump Shot,13.39041095890411
2010-11,2059,Eduardo Najera,PF,26,72,15,38,11,34,Center,4,Jump Shot,16.97222222222222
2011-12,2059,Eduardo Najera,PF,24,64,16,35,8,29,Center,1,Jump Shot,14.15625
2011-12,202775,Edwin Ubiles,SF,5,18,4,13,1,5,Center,1,Jump Shot,14.61111111111111
2015-16,204002,Edy Tavares,C,11,19,11,19,0,0,Center,1,Layup Shot,2.8421052631578947
2016-17,204002,Edy Tavares,C,4,5,4,5,0,0,Center,0,Hook Shot,3.6
2010-11,202327,Ekpe Udoh,C,97,222,97,222,0,0,Center,4,Jump Shot,6.833333333333333
2011-12,202327,Ekpe Udoh,C,127,295,127,293,0,2,Center,5,Jump Shot,7.6305084745762715
2012-13,202327,Ekpe Udoh,C,117,269,117,268,0,1,Center,4,Jump Shot,5.672862453531598
2013-14,202327,Ekpe Udoh,PF,57,143,57,143,0,0,Center,3,Jump Shot,6.440559440559441
2014-15,202327,Ekpe Udoh,PF,11,24,11,24,0,0,Center,8,Jump Shot,7.75
2017-18,202327,Ekpe Udoh,C,60,120,60,119,0,1,Center,7,Layup Shot,4.458333333333333
2018-19,202327,Ekpe Udoh,C,50,72,50,72,0,0,Center,12,Layup Shot,3.375
2003-04,922,Elden Campbell,C,138,314,138,314,0,0,Center,0,Jump Shot,8.063694267515924
2004-05,922,Elden Campbell,C,39,123,39,121,0,2,Center,0,Jump Shot,8.268292682926829
2014-15,203901,Elfrid Payton,PG,301,708,290,666,11,42,Center,18,Jump Shot,6.43361581920904
2015-16,203901,Elfrid Payton,PG,318,729,288,638,30,91,Center,16,Jump Shot,8.781893004115226
2016-17,203901,Elfrid Payton,PG,430,912,390,766,40,146,Center,15,Jump Shot,8.735745614035087
2017-18,203901,Elfrid Payton,PG,329,667,299,575,30,92,Center,16,Jump Shot,8.137931034482758
2018-19,203901,Elfrid Payton,PG,179,412,146,307,33,105,Center,5,Jump Shot,9.058252427184467
2019-20,203901,Elfrid Payton,PG,193,440,179,371,14,69,Center,6,Driving Layup Shot,8.195454545454545
2020-21,203901,Elfrid Payton,PG,269,622,241,524,28,98,Center,6,Driving Layup Shot,7.951768488745981
2021-22,203901,Elfrid Payton,PG,67,175,63,157,4,18,Center,8,Driving Layup Shot,7.514285714285714
2013-14,203548,Elias Harris,SF,0,1,0,1,0,0,Center,0,Driving Layup Shot,1.0
2018-19,1629059,Elie Okobo,PG,114,290,75,158,39,132,Center,11,Jump Shot,15.00344827586207
2019-20,1629059,Elie Okobo,PG,72,181,47,110,25,71,Center,5,Jump Shot,13.005524861878452
2020-21,1629091,Elijah Bryant,SG,6,13,5,8,1,5,Center,1,Jump Shot,12.153846153846153
2020-21,1630190,Elijah Hughes,SF,10,30,2,7,8,23,Right Side Center,6,Jump Shot,21.466666666666665
2021-22,1630190,Elijah Hughes,SG-SF,47,144,22,49,25,95,Center,4,Jump Shot,19.59722222222222
2014-15,202407,Elijah Millsap,SG,81,238,53,148,28,90,Center,5,Jump Shot,13.096638655462185
2015-16,202407,Elijah Millsap,SG,11,39,10,27,1,12,Center,0,Jump Shot,9.35897435897436
2016-17,202407,Elijah Millsap,SG,1,7,1,5,0,2,Center,0,Jump Shot,13.571428571428571
2011-12,202343,Elliot Williams,SG,37,74,29,47,8,27,Center,7,Jump Shot,12.378378378378379
2013-14,202343,Elliot Williams,SG,140,337,103,212,37,125,Center,7,Jump Shot,11.934718100890208
2014-15,202343,Elliot Williams,SG,14,37,6,19,8,18,Right Side Center,4,Jump Shot,17.81081081081081
2015-16,202343,Elliot Williams,PG,2,10,1,6,1,4,Right Side Center,0,Jump Shot,19.0
2003-04,1882,Elton Brand,PF,484,982,484,981,0,1,Center,8,Jump Shot,6.6629327902240325
2004-05,1882,Elton Brand,PF,629,1251,629,1248,0,3,Center,24,Jump Shot,7.749000799360512
2005-06,1882,Elton Brand,PF,756,1435,755,1432,1,3,Center,25,Jump Shot,8.958885017421602
2006-07,1882,Elton Brand,PF,645,1211,644,1210,1,1,Center,21,Jump Shot,8.776218001651527
2007-08,1882,Elton Brand,PF,52,114,52,114,0,0,Center,1,Jump Shot,9.473684210526315
2008-09,1882,Elton Brand,PF,163,365,163,365,0,0,Center,5,Jump Shot,8.887671232876713
2009-10,1882,Elton Brand,PF,412,858,412,857,0,1,Center,8,Jump Shot,8.801864801864802
2010-11,1882,Elton Brand,PF,502,981,502,980,0,1,Center,13,Jump Shot,9.202854230377167
2011-12,1882,Elton Brand,C,287,581,287,580,0,1,Center,3,Jump Shot,9.860585197934595
2012-13,1882,Elton Brand,C,226,478,226,477,0,1,Center,3,Jump Shot,9.129707112970712
2013-14,1882,Elton Brand,C,179,332,179,330,0,2,Center,2,Jump Shot,9.234939759036145
2014-15,1882,Elton Brand,C,42,95,42,94,0,1,Center,1,Jump Shot,11.389473684210527
2015-16,1882,Elton Brand,C,31,72,31,71,0,1,Center,0,Jump Shot,10.847222222222221
2018-19,1629150,Emanuel Terry,PF,4,7,4,7,0,0,Center,0,Putback Layup Shot,1.0
2021-22,1629150,Emanuel Terry,PF,0,5,0,5,0,0,Center,0,Putback Layup Shot,1.8
2004-05,2731,Emeka Okafor,PF,448,1003,448,1002,0,1,Center,9,Jump Shot,7.597208374875374
2005-06,2731,Emeka Okafor,PF,131,316,131,316,0,0,Center,4,Jump Shot,6.768987341772152
2006-07,2731,Emeka Okafor,C,394,740,394,740,0,0,Center,15,Layup Shot,4.34054054054054
2007-08,2731,Emeka Okafor,C,460,860,460,860,0,0,Center,14,Layup Shot,4.169767441860465
2008-09,2731,Emeka Okafor,C,433,772,433,772,0,0,Center,14,Layup Shot,3.5725388601036268
2009-10,2731,Emeka Okafor,C,348,656,348,656,0,0,Center,3,Layup Shot,3.9451219512195124
2010-11,2731,Emeka Okafor,C,300,524,300,523,0,1,Center,7,Layup Shot,3.232824427480916
2011-12,2731,Emeka Okafor,C,114,214,114,214,0,0,Center,3,Jump Shot,7.233644859813084
2012-13,2731,Emeka Okafor,C,328,687,328,687,0,0,Center,8,Jump Shot,7.5298398835516736
2017-18,2731,Emeka Okafor,C,48,95,48,95,0,0,Center,3,Jump Shot,5.368421052631579
2015-16,1626144,Emmanuel Mudiay,PG,329,905,255,673,74,232,Center,23,Jump Shot,12.688397790055248
2016-17,1626144,Emmanuel Mudiay,PG,208,551,152,373,56,178,Center,6,Jump Shot,12.116152450090745
2017-18,1626144,Emmanuel Mudiay,PG,204,526,157,378,47,148,Center,12,Jump Shot,12.809885931558936
2018-19,1626144,Emmanuel Mudiay,PG,330,740,261,530,69,210,Center,12,Jump Shot,12.232432432432432
2019-20,1626144,Emmanuel Mudiay,PG,151,327,121,240,30,87,Center,4,Jump Shot,11.960244648318042
2021-22,1626144,Emmanuel Mudiay,PG,0,2,0,2,0,0,Right Side,0,Fadeaway Jump Shot,12.5
2011-12,202683,Enes Freedom,C,117,236,117,235,0,1,Center,8,Jump Shot,4.593220338983051
2012-13,202683,Enes Freedom,C,206,379,205,378,1,1,Center,14,Jump Shot,5.91820580474934
2013-14,202683,Enes Freedom,C,419,853,419,852,0,1,Center,8,Jump Shot,6.964830011723329
2014-15,202683,Enes Freedom,C,482,928,466,883,16,45,Center,12,Jump Shot,6.899784482758621
2015-16,202683,Enes Freedom,C,414,719,404,698,10,21,Center,14,Layup Shot,4.86230876216968
2016-17,202683,Enes Freedom,C,402,737,397,699,5,38,Center,4,Jump Shot,5.388059701492537
2017-18,202683,Enes Freedom,C,422,713,422,711,0,2,Center,3,Layup Shot,3.8092566619915846
2018-19,202683,Enes Freedom,C,375,683,365,649,10,34,Center,5,Layup Shot,4.1654465592972185
2019-20,202683,Enes Freedom,C,199,348,198,341,1,7,Center,3,Layup Shot,3.163793103448276
2020-21,202683,Enes Freedom,C,339,561,338,557,1,4,Center,10,Layup Shot,2.308377896613191
2021-22,202683,Enes Freedom,C,51,97,49,92,2,5,Center,6,Tip Layup Shot,4.030927835051546
2010-11,202339,Eric Bledsoe,PG,206,486,174,370,32,116,Center,7,Jump Shot,11.419753086419753
2011-12,202339,Eric Bledsoe,PG,49,126,43,96,6,30,Center,1,Jump Shot,10.666666666666666
2012-13,202339,Eric Bledsoe,PG,253,568,222,490,31,78,Center,16,Jump Shot,9.85387323943662
2013-14,202339,Eric Bledsoe,PG,265,556,215,416,50,140,Center,19,Jump Shot,11.897482014388489
2014-15,202339,Eric Bledsoe,PG,468,1046,380,774,88,272,Center,34,Jump Shot,12.178776290630974
2015-16,202339,Eric Bledsoe,PG,223,492,175,363,48,129,Center,11,Jump Shot,12.804878048780488
2016-17,202339,Eric Bledsoe,PG,449,1034,345,724,104,310,Center,23,Jump Shot,13.241779497098646
2017-18,202339,Eric Bledsoe,PG,468,989,343,629,125,360,Center,27,Jump Shot,13.696663296258848
2018-19,202339,Eric Bledsoe,PG,470,971,346,594,124,377,Center,20,Jump Shot,12.385169927909372
2019-20,202339,Eric Bledsoe,PG,334,703,260,488,74,215,Center,10,Jump Shot,11.736842105263158
2020-21,202339,Eric Bledsoe,SG,307,730,186,375,121,355,Center,8,Jump Shot,16.04794520547945
2021-22,202339,Eric Bledsoe,PG,197,468,146,305,51,163,Center,4,Jump Shot,13.741452991452991
2011-12,201286,Eric Dawson,C,7,12,7,12,0,0,Center,3,Jump Shot,10.0
2008-09,201569,Eric Gordon,SG,411,901,280,564,131,337,Center,18,Jump Shot,14.144284128745838
2009-10,201569,Eric Gordon,SG,352,784,233,463,119,321,Center,7,Jump Shot,13.942602040816327
2010-11,201569,Eric Gordon,SG,427,948,321,658,106,290,Center,18,Jump Shot,12.888185654008439
2011-12,201569,Eric Gordon,SG,63,140,53,100,10,40,Center,3,Jump Shot,12.45
2012-13,201569,Eric Gordon,SG,235,584,179,411,56,173,Center,7,Jump Shot,13.058219178082192
2013-14,201569,Eric Gordon,SG,356,817,255,559,101,258,Center,10,Jump Shot,12.833537331701347
2014-15,201569,Eric Gordon,SG,285,694,144,379,141,315,Center,15,Jump Shot,15.70028818443804
2015-16,201569,Eric Gordon,SG,231,551,118,258,113,293,Center,5,Jump Shot,16.326678765880217
2016-17,201569,Eric Gordon,SG,411,1015,166,355,245,660,Center,9,Jump Shot,18.233497536945812
2017-18,201569,Eric Gordon,SG,415,970,197,362,218,608,Center,7,Jump Shot,17.757731958762886
2018-19,201569,Eric Gordon,SG,384,938,168,338,216,600,Center,9,Jump Shot,17.778251599147122
2019-20,201569,Eric Gordon,SF,171,463,75,160,96,303,Center,5,Jump Shot,18.473002159827214
2020-21,201569,Eric Gordon,SG,159,367,90,157,69,210,Center,5,Jump Shot,16.580381471389646
2021-22,201569,Eric Gordon,SG,268,564,144,263,124,301,Center,8,Jump Shot,15.74645390070922
2022-23,201569,Eric Gordon,SG,291,653,159,297,132,356,Center,9,Jump Shot,16.695252679938744
2009-10,201953,Eric Maynor,PG,154,368,132,297,22,71,Center,11,Jump Shot,11.179347826086957
2010-11,201953,Eric Maynor,PG,134,333,97,237,37,96,Center,3,Jump Shot,14.24924924924925
2011-12,201953,Eric Maynor,PG,14,39,8,22,6,17,Center,0,Jump Shot,17.58974358974359
2012-13,201953,Eric Maynor,PG-SG,106,281,72,185,34,96,Center,9,Jump Shot,14.387900355871887
2013-14,201953,Eric Maynor,PG,32,101,20,64,12,37,Center,1,Jump Shot,16.08910891089109
2019-20,1628450,Eric Mika,C,2,3,2,3,0,0,Center,0,Reverse Layup Shot,5.0
2014-15,203961,Eric Moreland,PF,1,1,1,1,0,0,Center,1,Jump Shot,5.0
2015-16,203961,Eric Moreland,PF,3,6,3,6,0,0,Center,2,Hook Shot,2.5
2017-18,203961,Eric Moreland,PF,66,122,66,122,0,0,Center,3,Layup Shot,3.5901639344262297
2018-19,203961,Eric Moreland,PF,3,7,2,6,1,1,Center,0,Tip Layup Shot,6.428571428571429
2019-20,1629672,Eric Paschall,PF,318,640,281,511,37,129,Center,15,Jump Shot,10.6609375
2020-21,1629672,Eric Paschall,PF,148,298,130,244,18,54,Center,11,Jump Shot,10.825503355704697
2021-22,1629672,Eric Paschall,PF,114,235,74,127,40,108,Center,7,Jump Shot,12.906382978723403
2003-04,15,Eric Piatkowski,SF,72,191,29,69,43,122,Right Side,3,Jump Shot,19.015706806282722
2004-05,15,Eric Piatkowski,SG,111,258,54,124,57,134,Center,6,Jump Shot,17.472868217054263
2005-06,15,Eric Piatkowski,SG,24,61,15,28,9,33,Center,2,Jump Shot,17.78688524590164
2006-07,15,Eric Piatkowski,SG,9,25,2,7,7,18,Left Side,2,Jump Shot,20.72
2007-08,15,Eric Piatkowski,SF,12,33,1,7,11,26,Right Side Center,6,Jump Shot,22.393939393939394
2003-04,727,Eric Snow,PG,295,715,293,697,2,18,Center,16,Jump Shot,9.387412587412587
2004-05,727,Eric Snow,SG,125,327,112,282,13,45,Center,10,Jump Shot,13.134556574923547
2005-06,727,Eric Snow,PG,163,399,162,389,1,10,Center,7,Jump Shot,11.764411027568922
2006-07,727,Eric Snow,PG,135,324,135,320,0,4,Center,2,Jump Shot,7.737654320987654
2007-08,727,Eric Snow,PG,6,38,6,36,0,2,Center,0,Jump Shot,10.605263157894736
2003-04,677,Eric Williams,SF,231,598,196,471,35,127,Center,5,Jump Shot,11.431438127090301
2004-05,677,Eric Williams,SG,142,330,114,257,28,73,Center,2,Jump Shot,10.851515151515152
2005-06,677,Eric Williams,SF,29,75,24,57,5,18,Center,1,Jump Shot,12.706666666666667
2006-07,677,Eric Williams,SF,19,47,11,28,8,19,Center,4,Jump Shot,16.893617021276597
2003-04,956,Erick Dampier,C,348,650,348,648,0,2,Center,8,Layup Shot,2.8615384615384616
2004-05,956,Erick Dampier,C,202,367,202,364,0,3,Center,3,Layup Shot,2.7084468664850134
2005-06,956,Erick Dampier,C,171,347,171,347,0,0,Center,5,Layup Shot,1.5072046109510087
2006-07,956,Erick Dampier,C,209,334,209,334,0,0,Center,3,Layup Shot,1.1077844311377245
2007-08,956,Erick Dampier,C,178,277,178,277,0,0,Center,3,Layup Shot,1.0830324909747293
2008-09,956,Erick Dampier,C,182,280,182,280,0,0,Center,1,Layup Shot,1.3071428571428572
2009-10,956,Erick Dampier,C,133,213,132,210,1,3,Center,4,Layup Shot,2.0140845070422535
2010-11,956,Erick Dampier,C,52,89,52,88,0,1,Center,4,Layup Shot,3.3707865168539324
2011-12,956,Erick Dampier,C,1,8,1,8,0,0,Center,0,Tip Shot,1.875
2014-15,203475,Erick Green,PG,61,162,47,115,14,47,Center,6,Jump Shot,16.666666666666668
2015-16,203475,Erick Green,PG,5,13,4,8,1,5,Left Side Center,2,Jump Shot,17.53846153846154
2003-04,1065,Erick Strickland,PG,79,196,50,130,29,66,Center,10,Jump Shot,14.760204081632653
2004-05,1065,Erick Strickland,SG,114,304,93,221,21,83,Center,6,Jump Shot,14.9375
2004-05,2845,Erik Daniels,SF,6,18,5,16,1,2,Center,5,Jump Shot,9.444444444444445
2017-18,1628571,Erik McCree,SF,0,2,0,1,0,1,Right Side Center,0,Jump Shot,13.5
2013-14,203513,Erik Murphy,C,3,13,3,10,0,3,Center,2,Jump Shot,14.153846153846153
2006-07,101141,Ersan Ilyasova,PF,139,363,85,215,54,148,Center,13,Jump Shot,14.685950413223141
2009-10,101141,Ersan Ilyasova,PF,323,729,242,488,81,241,Center,19,Jump Shot,13.978052126200275
2010-11,101141,Ersan Ilyasova,PF,221,507,185,386,36,121,Center,8,Jump Shot,13.816568047337277
2011-12,101141,Ersan Ilyasova,PF,294,597,243,485,51,112,Center,11,Jump Shot,10.28140703517588
2012-13,101141,Ersan Ilyasova,PF,371,803,276,589,95,214,Center,12,Jump Shot,13.220423412204234
2013-14,101141,Ersan Ilyasova,PF,237,579,200,448,37,131,Center,9,Jump Shot,13.0
2014-15,101141,Ersan Ilyasova,PF,263,557,189,367,74,190,Center,8,Jump Shot,13.364452423698385
2015-16,101141,Ersan Ilyasova,PF,280,661,184,402,96,259,Center,4,Jump Shot,13.987897125567322
2016-17,101141,Ersan Ilyasova,PF,384,890,242,488,142,402,Center,15,Jump Shot,15.19438202247191
2017-18,101141,Ersan Ilyasova,PF,277,613,186,360,91,253,Center,6,Jump Shot,13.905383360522023
2018-19,101141,Ersan Ilyasova,PF,167,381,109,221,58,160,Center,5,Jump Shot,13.293963254593177
2019-20,101141,Ersan Ilyasova,PF,146,313,96,176,50,137,Center,9,Jump Shot,13.552715654952078
2020-21,101141,Ersan Ilyasova,PF,21,54,3,13,18,41,Left Side Center,2,Jump Shot,21.12962962962963
2003-04,911,Ervin Johnson,C,55,103,55,102,0,1,Center,2,Jump Shot,4.135922330097087
2004-05,911,Ervin Johnson,C,28,54,27,53,1,1,Center,1,Layup Shot,3.388888888888889
2005-06,911,Ervin Johnson,C,7,17,7,17,0,0,Center,2,Jump Shot,4.294117647058823
2005-06,101212,Esteban Batista,PF,34,80,34,79,0,1,Center,7,Layup Shot,1.175
2006-07,101212,Esteban Batista,PF,8,16,8,16,0,0,Center,2,Layup Shot,2.25
2003-04,2041,Etan Thomas,C,257,526,257,526,0,0,Center,14,Jump Shot,3.982889733840304
2004-05,2041,Etan Thomas,C,128,255,128,255,0,0,Center,5,Jump Shot,3.925490196078431
2005-06,2041,Etan Thomas,C,131,246,131,246,0,0,Center,0,Layup Shot,2.886178861788618
2006-07,2041,Etan Thomas,C,159,277,159,277,0,0,Center,0,Layup Shot,2.8231046931407944
2008-09,2041,Etan Thomas,C,32,66,32,66,0,0,Center,0,Layup Shot,3.212121212121212
2009-10,2041,Etan Thomas,C,31,68,31,68,0,0,Center,0,Layup Shot,4.25
2010-11,2041,Etan Thomas,C,10,21,10,21,0,0,Center,1,Jump Shot,5.142857142857143
2021-22,1630647,Eugene Omoruyi,SF,2,5,1,3,1,2,Right Side,0,Jump Shot,17.0
2022-23,1630647,Eugene Omoruyi,SF,101,228,76,139,25,89,Center,5,Jump Shot,11.223684210526315
2012-13,203095,Evan Fournier,SG,75,152,53,98,22,54,Center,9,Jump Shot,11.282894736842104
2013-14,203095,Evan Fournier,SG,228,544,139,307,89,237,Center,8,Jump Shot,14.299632352941176
2014-15,203095,Evan Fournier,SG,253,575,168,350,85,225,Center,11,Jump Shot,13.433043478260869
2015-16,203095,Evan Fournier,SF,429,928,273,539,156,389,Center,15,Jump Shot,14.06573275862069
2016-17,203095,Evan Fournier,SG,407,927,280,570,127,357,Center,20,Jump Shot,13.735706580366774
2017-18,203095,Evan Fournier,SF,368,802,241,467,127,335,Center,17,Jump Shot,14.963840399002494
2018-19,203095,Evan Fournier,SG,468,1069,315,619,153,450,Center,17,Jump Shot,15.21421889616464
2019-20,203095,Evan Fournier,SF,434,929,261,495,173,434,Center,21,Jump Shot,16.04090419806243
2020-21,203095,Evan Fournier,SF-SG,247,541,130,258,117,283,Center,10,Jump Shot,17.164510166358596
2021-22,203095,Evan Fournier,SG,402,965,161,346,241,619,Center,10,Jump Shot,19.081865284974093
2022-23,203095,Evan Fournier,SG,56,166,21,52,35,114,Center,1,Jump Shot,19.879518072289155
2021-22,1630596,Evan Mobley,PF,422,830,399,738,23,92,Center,17,Jump Shot,7.967469879518072
2022-23,1630596,Evan Mobley,PF,525,947,503,845,22,102,Center,11,Jump Shot,6.878563885955649
2010-11,202323,Evan Turner,SG,225,529,211,485,14,44,Center,8,Jump Shot,12.064272211720226
2011-12,202323,Evan Turner,SF,263,590,252,541,11,49,Center,11,Jump Shot,11.338983050847459
2012-13,202323,Evan Turner,SF,441,1052,383,894,58,158,Center,9,Jump Shot,12.613117870722434
2013-14,202323,Evan Turner,SF,434,1020,384,865,50,155,Center,15,Jump Shot,11.062745098039215
2014-15,202323,Evan Turner,SG,320,746,287,627,33,119,Center,24,Jump Shot,11.816353887399464
2015-16,202323,Evan Turner,SG,343,753,323,670,20,83,Center,14,Jump Shot,10.610889774236387
2016-17,202323,Evan Turner,SF,235,552,204,434,31,118,Center,5,Jump Shot,12.442028985507246
2017-18,202323,Evan Turner,SF,258,577,216,445,42,132,Center,4,Jump Shot,13.258232235701906
2018-19,202323,Evan Turner,PG,204,443,193,391,11,52,Center,3,Pullup Jump shot,9.774266365688488
2019-20,202323,Evan Turner,SG,25,67,25,62,0,5,Center,1,Pullup Jump shot,9.82089552238806
2012-13,203097,Fab Melo,C,3,6,3,6,0,0,Center,1,Fadeaway Jump Shot,2.5
2005-06,101177,Fabricio Oberto,C,44,93,44,91,0,2,Center,3,Jump Shot,6.376344086021505
2006-07,101177,Fabricio Oberto,C,158,281,158,281,0,0,Center,2,Layup Shot,5.4163701067615655
2007-08,101177,Fabricio Oberto,C,180,296,180,295,0,1,Center,1,Jump Shot,5.668918918918919
2008-09,101177,Fabricio Oberto,C,61,104,61,103,0,1,Center,2,Layup Shot,5.009615384615385
2009-10,101177,Fabricio Oberto,C,35,56,35,56,0,0,Center,0,Layup Shot,3.017857142857143
2010-11,101177,Fabricio Oberto,C,3,5,3,5,0,0,Center,0,Turnaround Jump Shot,3.6
2020-21,1630267,Facundo Campazzo,PG,120,315,44,99,76,216,Center,5,Jump Shot,19.114285714285714
2021-22,1630267,Facundo Campazzo,PG,107,296,49,103,58,193,Center,6,Jump Shot,18.91891891891892
2022-23,1630267,Facundo Campazzo,PG,3,13,0,2,3,11,Left Side Center,1,Jump Shot,21.615384615384617
2021-22,1630624,Feron Hunt,SF,0,2,0,2,0,0,Center,0,Alley Oop Dunk Shot,1.0
2012-13,203105,Festus Ezeli,C,74,169,74,169,0,0,Center,3,Jump Shot,4.171597633136095
2014-15,203105,Festus Ezeli,C,76,139,76,139,0,0,Center,4,Layup Shot,4.107913669064748
2015-16,203105,Festus Ezeli,C,125,228,125,228,0,0,Center,1,Layup Shot,2.9166666666666665
2003-04,2436,Flip Murray,PG,389,915,322,686,67,229,Center,24,Jump Shot,13.146448087431693
2004-05,2436,Flip Murray,SG,131,363,107,268,24,95,Center,7,Jump Shot,14.473829201101928
2005-06,2436,Flip Murray,SG,321,768,284,627,37,141,Center,24,Jump Shot,11.4765625
2006-07,2436,Flip Murray,SG,177,438,153,355,24,83,Center,15,Jump Shot,12.321917808219178
2007-08,2436,Flip Murray,PG,154,367,134,304,20,63,Center,5,Jump Shot,12.174386920980927
2008-09,2436,Flip Murray,SG,354,794,268,553,86,241,Center,20,Jump Shot,14.356423173803526
2009-10,2436,Flip Murray,SG,268,683,199,462,69,221,Center,15,Jump Shot,14.282576866764275
2003-04,1922,Francisco Elson,C,94,199,94,198,0,1,Center,2,Jump Shot,8.698492462311558
2004-05,1922,Francisco Elson,C,101,216,100,213,1,3,Center,3,Jump Shot,9.523148148148149
2005-06,1922,Francisco Elson,C,151,284,150,279,1,5,Center,1,Jump Shot,9.746478873239436
2006-07,1922,Francisco Elson,C,144,282,144,280,0,2,Center,2,Jump Shot,6.457446808510638
2007-08,1922,Francisco Elson,C,92,236,92,235,0,1,Center,8,Jump Shot,10.661016949152541
2008-09,1922,Francisco Elson,C,83,169,82,165,1,4,Center,4,Jump Shot,7.9171597633136095
2009-10,1922,Francisco Elson,C,5,15,5,15,0,0,Center,3,Jump Shot,13.0
2010-11,1922,Francisco Elson,C,54,113,54,113,0,0,Center,3,Jump Shot,11.79646017699115
2011-12,1922,Francisco Elson,C,1,3,1,3,0,0,Right Side,0,Jump Shot,13.333333333333334
2005-06,101128,Francisco Garcia,SF,130,325,91,188,39,137,Center,5,Jump Shot,15.273846153846154
2006-07,101128,Francisco Garcia,SF,163,380,110,231,53,149,Center,8,Jump Shot,14.944736842105263
2007-08,101128,Francisco Garcia,SF,348,752,235,463,113,289,Center,14,Jump Shot,14.78590425531915
2008-09,101128,Francisco Garcia,SF,295,665,207,444,88,221,Center,13,Jump Shot,14.984962406015038
2009-10,101128,Francisco Garcia,SG,82,176,59,117,23,59,Center,6,Jump Shot,16.823863636363637
2010-11,101128,Francisco Garcia,SF,207,475,126,251,81,224,Center,11,Jump Shot,17.063157894736843
2011-12,101128,Francisco Garcia,SF,86,229,48,98,38,131,Center,6,Jump Shot,18.733624454148472
2012-13,101128,Francisco Garcia,SG-SF,118,300,51,121,67,179,Center,2,Jump Shot,19.253333333333334
2013-14,101128,Francisco Garcia,SF,117,293,49,101,68,192,Center,7,Jump Shot,18.064846416382252
2014-15,101128,Francisco Garcia,SF,17,63,7,18,10,45,Center,0,Jump Shot,19.650793650793652
2018-19,1628402,Frank Jackson,PG,194,447,141,278,53,169,Center,13,Jump Shot,12.315436241610739
2019-20,1628402,Frank Jackson,PG,134,331,87,187,47,144,Center,11,Jump Shot,14.441087613293051
2020-21,1628402,Frank Jackson,PG,134,293,73,143,61,150,Center,9,Jump Shot,15.890784982935154
2021-22,1628402,Frank Jackson,PG,194,483,108,204,86,279,Center,4,Jump Shot,16.921325051759833
2022-23,1628402,Frank Jackson,PG,0,3,0,2,0,1,Center,0,Driving Floating Jump Shot,13.333333333333334
2015-16,1626163,Frank Kaminsky,C,215,525,147,323,68,202,Center,4,Jump Shot,12.571428571428571
2016-17,1626163,Frank Kaminsky,C,320,802,204,448,116,354,Center,8,Jump Shot,14.678304239401497
2017-18,1626163,Frank Kaminsky,PF,307,716,203,442,104,274,Center,7,Jump Shot,14.216480446927374
2018-19,1626163,Frank Kaminsky,C,138,298,88,159,50,139,Center,3,Jump Shot,14.171140939597315
2019-20,1626163,Frank Kaminsky,C,138,307,97,183,41,124,Center,3,Jump Shot,12.90228013029316
2020-21,1626163,Frank Kaminsky,C,121,257,90,172,31,85,Center,2,Jump Shot,11.700389105058365
2021-22,1626163,Frank Kaminsky,C,36,66,31,51,5,15,Center,1,Jump Shot,8.742424242424242
2022-23,1626163,Frank Kaminsky,C,31,63,18,30,13,33,Center,4,Jump Shot,15.666666666666666
2017-18,1628412,Frank Mason III,PG,144,380,113,294,31,86,Center,8,Jump Shot,12.41842105263158
2018-19,1628412,Frank Mason III,PG,71,169,57,105,14,64,Center,8,Jump Shot,14.005917159763314
2019-20,1628412,Frank Mason III,PG,23,51,17,30,6,21,Center,0,Jump Shot,13.686274509803921
2020-21,1628412,Frank Mason III,PG,9,24,7,19,2,5,Center,2,Driving Layup Shot,7.625
2017-18,1628373,Frank Ntilikina,PG,182,500,132,343,50,157,Center,7,Jump Shot,16.084
2018-19,1628373,Frank Ntilikina,PG,95,282,62,167,33,115,Center,1,Jump Shot,16.095744680851062
2019-20,1628373,Frank Ntilikina,PG,131,333,87,196,44,137,Center,4,Jump Shot,16.105105105105107
2020-21,1628373,Frank Ntilikina,PG,29,79,6,31,23,48,Center,1,Jump Shot,19.962025316455698
2021-22,1628373,Frank Ntilikina,SG,89,223,51,112,38,111,Center,11,Jump Shot,17.017937219730943
2022-23,1628373,Frank Ntilikina,PG,48,132,31,65,17,67,Center,2,Jump Shot,16.477272727272727
2003-04,2421,Frank Williams,PG,80,208,62,148,18,60,Center,4,Jump Shot,12.014423076923077
2004-05,2421,Frank Williams,SG,3,20,3,16,0,4,Center,0,Jump Shot,13.05
2021-22,1630532,Franz Wagner,SF,456,975,360,704,96,271,Center,25,Driving Layup Shot,9.925128205128205
2022-23,1630532,Franz Wagner,SF,542,1118,412,758,130,360,Center,23,Jump Shot,11.500894454382827
2003-04,697,Fred Hoiberg,SG,178,383,102,211,76,172,Center,9,Jump Shot,18.2088772845953
2004-05,697,Fred Hoiberg,SG,139,284,69,139,70,145,Center,6,Jump Shot,18.221830985915492
2003-04,2410,Fred Jones,SG,123,311,96,222,27,89,Center,4,Jump Shot,13.311897106109324
2004-05,2410,Fred Jones,SG,275,647,188,418,87,229,Center,10,Jump Shot,14.579598145285935
2005-06,2410,Fred Jones,SG,233,559,170,372,63,187,Center,8,Jump Shot,15.103756708407872
2006-07,2410,Fred Jones,SG,139,361,100,233,39,128,Center,6,Jump Shot,13.698060941828254
2007-08,2410,Fred Jones,SG,182,432,108,240,74,192,Center,10,Jump Shot,14.70138888888889
2008-09,2410,Fred Jones,SF,129,317,75,170,54,147,Center,4,Jump Shot,15.766561514195583
2016-17,1627832,Fred VanVleet,PG,39,111,28,82,11,29,Center,8,Jump Shot,11.108108108108109
2017-18,1627832,Fred VanVleet,PG,232,545,124,284,108,261,Center,12,Jump Shot,13.922935779816514
2018-19,1627832,Fred VanVleet,PG,246,600,134,304,112,296,Center,7,Jump Shot,16.098333333333333
2019-20,1627832,Fred VanVleet,SG,319,773,173,399,146,374,Center,9,Jump Shot,14.857697283311772
2020-21,1627832,Fred VanVleet,SG,338,870,164,394,174,476,Center,14,Jump Shot,17.736781609195404
2021-22,1627832,Fred VanVleet,PG,442,1097,200,455,242,642,Center,17,Jump Shot,19.43482224247949
2022-23,1627832,Fred VanVleet,PG,437,1112,230,506,207,606,Center,13,Pullup Jump shot,18.154676258992804
2020-21,1630273,Freddie Gillespie,PF,44,84,44,84,0,0,Center,3,Putback Layup Shot,4.107142857142857
2021-22,1630273,Freddie Gillespie,PF,9,22,9,21,0,1,Center,0,Jump Shot,6.136363636363637
2014-15,203128,Furkan Aldemir,PF,40,78,40,73,0,5,Center,6,Jump Shot,5.576923076923077
2017-18,1627788,Furkan Korkmaz,SG,8,28,3,11,5,17,Left Side Center,3,Jump Shot,19.535714285714285
2018-19,1627788,Furkan Korkmaz,SG,98,245,51,101,47,144,Center,14,Jump Shot,17.983673469387757
2019-20,1627788,Furkan Korkmaz,SG,242,563,99,207,143,356,Center,9,Jump Shot,18.683836589698046
2020-21,1627788,Furkan Korkmaz,SG,170,424,69,155,101,269,Center,6,Jump Shot,19.014150943396228
2021-22,1627788,Furkan Korkmaz,SG,182,470,105,204,77,266,Center,2,Jump Shot,16.93617021276596
2022-23,1627788,Furkan Korkmaz,SG,48,111,30,65,18,46,Center,12,Jump Shot,14.225225225225225
2007-08,201172,Gabe Pruitt,PG,14,39,11,27,3,12,Center,3,Jump Shot,16.17948717948718
2008-09,201172,Gabe Pruitt,SG,31,101,17,53,14,48,Center,1,Jump Shot,19.237623762376238
2019-20,1629216,Gabe Vincent,PG,8,37,2,10,6,27,Center,0,Jump Shot,20.45945945945946
2020-21,1629216,Gabe Vincent,PG,88,233,42,84,46,149,Center,9,Jump Shot,17.78969957081545
2021-22,1629216,Gabe Vincent,PG,214,513,95,190,119,323,Center,14,Jump Shot,19.03898635477583
2022-23,1629216,Gabe Vincent,PG,228,567,111,217,117,350,Center,8,Jump Shot,18.52910052910053
2021-22,1628221,Gabe York,SG,2,7,1,1,1,6,Left Side Center,1,Jump Shot,21.857142857142858
2022-23,1628221,Gabe York,SG,8,21,2,3,6,18,Center,0,Jump Shot,21.476190476190474
2020-21,1630466,Gabriel Deck,PF,32,67,30,52,2,15,Center,1,Jump Shot,11.462686567164178
2021-22,1630466,Gabriel Deck,PF,8,14,6,10,2,4,Center,4,Jump Shot,11.428571428571429
2021-22,1630994,Gabriel Lundberg,SG,5,19,2,11,3,8,Center,0,Jump Shot,18.789473684210527
2013-14,203539,Gal Mekel,PG,30,86,25,66,5,20,Center,1,Jump Shot,11.30232558139535
2014-15,203539,Gal Mekel,PG,3,20,3,17,0,3,Center,0,Jump Shot,10.85
2010-11,202081,Garret Siler,C,17,31,17,31,0,0,Center,8,Layup Shot,2.7096774193548385
2009-10,202066,Garrett Temple,SG,44,101,31,64,13,37,Center,2,Jump Shot,14.049504950495049
2010-11,202066,Garrett Temple,PG-SG,20,68,10,31,10,37,Center,2,Jump Shot,17.985294117647058
2012-13,202066,Garrett Temple,SG,105,258,79,178,26,80,Center,1,Jump Shot,14.996124031007753
2013-14,202066,Garrett Temple,SG,51,141,45,112,6,29,Center,8,Jump Shot,13.886524822695035
2014-15,202066,Garrett Temple,SG,68,170,35,82,33,88,Center,5,Jump Shot,16.805882352941175
2015-16,202066,Garrett Temple,SF,201,505,112,247,89,258,Center,10,Jump Shot,15.714851485148515
2016-17,202066,Garrett Temple,SG,183,432,101,212,82,220,Center,6,Jump Shot,16.75
2017-18,202066,Garrett Temple,SG,199,476,110,249,89,227,Center,10,Jump Shot,17.361344537815125
2018-19,202066,Garrett Temple,SG,208,493,118,229,90,264,Center,10,Jump Shot,16.20689655172414
2019-20,202066,Garrett Temple,SG,222,587,95,201,127,386,Center,1,Jump Shot,18.43100511073254
2020-21,202066,Garrett Temple,SG,158,381,91,181,67,200,Center,3,Jump Shot,15.640419947506562
2021-22,202066,Garrett Temple,SG,111,295,52,110,59,185,Center,4,Jump Shot,17.596610169491527
2022-23,202066,Garrett Temple,SG,18,45,7,19,11,26,Center,5,Jump Shot,16.822222222222223
2019-20,1629726,Garrison Mathews,SG,24,56,5,10,19,46,Left Side Center,0,Jump Shot,23.160714285714285
2020-21,1629726,Garrison Mathews,SG,97,237,21,39,76,198,Left Side Center,6,Jump Shot,22.835443037974684
2021-22,1629726,Garrison Mathews,SG,184,461,45,75,139,386,Left Side Center,8,Jump Shot,22.032537960954446
2022-23,1629726,Garrison Mathews,SG,73,201,10,21,63,180,Left Side Center,3,Jump Shot,23.248756218905474
2018-19,1629109,Gary Clark,PF,50,151,9,13,41,138,Left Side Center,2,Jump Shot,23.05298013245033
2019-20,1629109,Gary Clark,SF-PF,54,133,15,22,39,111,Left Side Center,3,Jump Shot,21.203007518796994
2020-21,1629109,Gary Clark,SF-PF,40,132,9,24,31,108,Center,1,Jump Shot,21.174242424242426
2021-22,1629109,Gary Clark,PF,33,88,5,18,28,70,Right Side,1,Jump Shot,19.59090909090909
2010-11,201814,Gary Forbes,SF,124,272,105,215,19,57,Center,7,Jump Shot,8.485294117647058
2011-12,201814,Gary Forbes,SG,112,271,83,188,29,83,Center,15,Jump Shot,14.6309963099631
2014-15,203914,Gary Harris,SG,66,217,45,114,21,103,Center,6,Jump Shot,15.80184331797235
2015-16,203914,Gary Harris,SG,359,765,254,468,105,297,Center,13,Jump Shot,13.061437908496732
2016-17,203914,Gary Harris,SG,320,636,213,382,107,254,Center,11,Jump Shot,12.716981132075471
2017-18,203914,Gary Harris,SG,440,908,284,514,156,394,Center,18,Jump Shot,14.811674008810572
2018-19,203914,Gary Harris,SG,270,637,188,395,82,242,Center,8,Jump Shot,13.145996860282574
2019-20,203914,Gary Harris,SG,218,519,148,309,70,210,Center,8,Jump Shot,13.385356454720617
2020-21,203914,Gary Harris,SG,138,345,90,204,48,141,Center,4,Jump Shot,13.797101449275363
2021-22,203914,Gary Harris,SG,240,553,124,251,116,302,Center,4,Jump Shot,16.7251356238698
2022-23,203914,Gary Harris,SG,138,307,44,89,94,218,Center,4,Jump Shot,18.912052117263844
2010-11,202390,Gary Neal,SG,285,632,156,324,129,308,Center,17,Jump Shot,17.650316455696203
2011-12,202390,Gary Neal,SG,212,486,129,288,83,198,Center,9,Jump Shot,15.98559670781893
2012-13,202390,Gary Neal,SG,246,597,157,346,89,251,Center,7,Jump Shot,17.971524288107204
2013-14,202390,Gary Neal,SG,193,471,125,291,68,180,Center,6,Jump Shot,16.866242038216562
2014-15,202390,Gary Neal,SG,188,503,138,339,50,164,Center,4,Jump Shot,16.332007952286283
2015-16,202390,Gary Neal,SG,151,324,110,225,41,99,Center,7,Jump Shot,16.367283950617285
2016-17,202390,Gary Neal,SG,0,7,0,5,0,2,Right Side Center,0,Jump Shot,19.142857142857142
2003-04,56,Gary Payton,PG,482,1024,427,859,55,165,Center,15,Jump Shot,9.2255859375
2004-05,56,Gary Payton,PG,339,725,297,596,42,129,Center,11,Jump Shot,9.318620689655173
2005-06,56,Gary Payton,PG,230,547,164,317,66,230,Center,9,Jump Shot,13.946983546617917
2006-07,56,Gary Payton,PG,144,366,112,243,32,123,Center,1,Jump Shot,13.155737704918034
2016-17,1627780,Gary Payton II,PG,8,22,7,13,1,9,Center,0,Jump Shot,12.363636363636363
2017-18,1627780,Gary Payton II,PG,30,74,24,49,6,25,Center,2,Jump Shot,10.662162162162161
2018-19,1627780,Gary Payton II,PG,5,8,4,6,1,2,Center,0,Cutting Layup Shot,6.125
2019-20,1627780,Gary Payton II,SF,48,116,35,70,13,46,Center,6,Jump Shot,11.206896551724139
2020-21,1627780,Gary Payton II,PG,10,13,8,9,2,4,Center,2,Jump Shot,8.153846153846153
2021-22,1627780,Gary Payton II,SG,212,344,169,224,43,120,Center,9,Jump Shot,9.956395348837209
2022-23,1627780,Gary Payton II,PG,41,69,28,43,13,26,Center,0,Jump Shot,10.130434782608695
2003-04,718,Gary Trent,C,155,328,155,322,0,6,Center,7,Jump Shot,6.7439024390243905
2018-19,1629018,Gary Trent Jr.,SG,16,50,11,29,5,21,Center,4,Pullup Jump shot,17.16
2019-20,1629018,Gary Trent Jr.,SF,196,441,84,173,112,268,Center,14,Jump Shot,18.94331065759637
2020-21,1629018,Gary Trent Jr.,SG,320,785,155,356,165,429,Center,6,Jump Shot,18.145222929936306
2021-22,1629018,Gary Trent Jr.,SG,450,1086,241,541,209,545,Center,17,Jump Shot,17.997237569060772
2022-23,1629018,Gary Trent Jr.,SG,405,935,239,485,166,450,Center,13,Jump Shot,17.294117647058822
2004-05,2367,Geno Carlisle,SG,2,3,2,3,0,0,Center,0,Driving Layup Shot,5.666666666666667
2008-09,201588,George Hill,PG,150,372,126,299,24,73,Center,11,Jump Shot,11.63978494623656
2009-10,201588,George Hill,PG,353,738,278,550,75,188,Center,12,Jump Shot,12.311653116531165
2010-11,201588,George Hill,PG,287,633,210,429,77,204,Center,7,Jump Shot,13.477093206951027
2011-12,201588,George Hill,PG,168,380,114,233,54,147,Center,5,Jump Shot,15.147368421052631
2012-13,201588,George Hill,PG,386,871,256,518,130,353,Center,21,Jump Shot,15.727898966704936
2013-14,201588,George Hill,PG,272,616,177,356,95,260,Center,9,Jump Shot,15.74025974025974
2014-15,201588,George Hill,PG,255,535,186,342,69,193,Center,22,Jump Shot,14.457943925233645
2015-16,201588,George Hill,PG,325,736,198,425,127,311,Center,9,Jump Shot,15.27445652173913
2016-17,201588,George Hill,PG,289,606,195,373,94,233,Center,9,Jump Shot,14.745874587458745
2017-18,201588,George Hill,PG,236,513,151,308,85,205,Center,6,Jump Shot,15.282651072124755
2018-19,201588,George Hill,PG,170,376,122,223,48,153,Center,4,Jump Shot,14.207446808510639
2019-20,201588,George Hill,PG,194,376,113,200,81,176,Center,9,Jump Shot,14.492021276595745
2020-21,201588,George Hill,PG,95,197,64,117,31,80,Center,1,Jump Shot,13.908629441624365
2021-22,201588,George Hill,PG,118,275,77,141,41,134,Center,5,Jump Shot,14.934545454545454
2022-23,201588,George Hill,PG,78,166,44,71,34,95,Center,2,Jump Shot,17.265060240963855
2021-22,1628994,George King,SF,0,5,0,1,0,4,Right Side,0,Jump Shot,19.2
2003-04,248,George Lynch,SF,149,375,106,236,43,139,Center,9,Jump Shot,13.893333333333333
2004-05,248,George Lynch,SF,68,189,57,152,11,37,Center,2,Jump Shot,13.08994708994709
2016-17,1627777,Georges Niang,PF,9,36,8,24,1,12,Center,4,Jump Shot,11.555555555555555
2017-18,1627777,Georges Niang,PF,4,11,4,7,0,4,Center,2,Jump Shot,11.909090909090908
2018-19,1627777,Georges Niang,PF,86,181,43,76,43,105,Center,14,Jump Shot,16.132596685082873
2019-20,1627777,Georges Niang,PF,141,322,51,97,90,225,Center,9,Jump Shot,18.62111801242236
2020-21,1627777,Georges Niang,PF,177,405,53,113,124,292,Center,3,Jump Shot,19.33827160493827
2021-22,1627777,Georges Niang,PF,246,563,90,176,156,387,Center,6,Jump Shot,18.612788632326822
2022-23,1627777,Georges Niang,PF,222,502,68,118,154,384,Center,4,Jump Shot,20.304780876494025
2021-22,1630686,Georgios Kalaitzakis,SF,31,67,21,41,10,26,Center,1,Jump Shot,13.373134328358208
2016-17,1627834,Georgios Papagiannis,C,56,102,56,100,0,2,Center,4,Hook Shot,6.078431372549019
2017-18,1627834,Georgios Papagiannis,C,18,42,18,42,0,0,Center,6,Jump Shot,7.214285714285714
2005-06,2809,Gerald Fitch,PG,30,89,23,63,7,26,Center,3,Jump Shot,15.146067415730338
2005-06,101123,Gerald Green,SG,66,138,60,118,6,20,Center,10,Jump Shot,12.934782608695652
2006-07,101123,Gerald Green,SF,310,739,215,481,95,258,Center,28,Jump Shot,15.125845737483084
2007-08,101123,Gerald Green,SF,52,151,37,112,15,39,Center,7,Jump Shot,15.264900662251655
2008-09,101123,Gerald Green,SG,79,180,65,134,14,46,Center,12,Jump Shot,13.811111111111112
2011-12,101123,Gerald Green,SF,154,320,111,210,43,110,Center,6,Jump Shot,15.88125
2012-13,101123,Gerald Green,SF,155,424,96,236,59,188,Center,8,Jump Shot,17.34198113207547
2013-14,101123,Gerald Green,SG,447,1005,244,496,203,509,Center,6,Jump Shot,17.49054726368159
2014-15,101123,Gerald Green,SG,324,778,187,391,137,387,Center,5,Jump Shot,17.5012853470437
2015-16,101123,Gerald Green,SG,229,586,146,327,83,259,Center,8,Jump Shot,16.77815699658703
2016-17,101123,Gerald Green,SF,95,232,56,121,39,111,Center,1,Jump Shot,17.021551724137932
2017-18,101123,Gerald Green,SG,168,413,58,115,110,298,Center,10,Jump Shot,20.048426150121067
2018-19,101123,Gerald Green,SG,231,578,75,137,156,441,Center,8,Jump Shot,20.365051903114185
2009-10,201945,Gerald Henderson,SG,37,104,33,85,4,19,Center,7,Jump Shot,11.471153846153847
2010-11,201945,Gerald Henderson,SG,259,570,252,534,7,36,Center,15,Jump Shot,12.012280701754387
2011-12,201945,Gerald Henderson,SG,332,723,321,676,11,47,Center,11,Jump Shot,12.406639004149378
2012-13,201945,Gerald Henderson,SG,382,855,349,755,33,100,Center,14,Jump Shot,11.996491228070175
2013-14,201945,Gerald Henderson,SG,403,929,363,815,40,114,Center,15,Jump Shot,13.08826695371367
2014-15,201945,Gerald Henderson,SG,370,847,325,711,45,136,Center,10,Jump Shot,13.16646989374262
2015-16,201945,Gerald Henderson,SG,232,529,184,393,48,136,Center,1,Jump Shot,14.93194706994329
2016-17,201945,Gerald Henderson,SG,233,551,173,380,60,171,Center,4,Jump Shot,14.105263157894736
2003-04,2222,Gerald Wallace,SF,32,89,32,87,0,2,Center,3,Jump Shot,9.359550561797754
2004-05,2222,Gerald Wallace,SF,286,637,269,575,17,62,Center,8,Jump Shot,9.339089481946624
2005-06,2222,Gerald Wallace,SF,317,589,303,539,14,50,Center,12,Layup Shot,5.071307300509337
2006-07,2222,Gerald Wallace,SF,478,952,439,832,39,120,Center,18,Layup Shot,6.59453781512605
2007-08,2222,Gerald Wallace,PF,408,908,337,687,71,221,Center,10,Jump Shot,10.549559471365638
2008-09,2222,Gerald Wallace,SF,389,811,350,680,39,131,Center,11,Layup Shot,6.196054254007398
2009-10,2222,Gerald Wallace,SF,456,943,404,803,52,140,Center,7,Jump Shot,7.6680805938494165
2010-11,2222,Gerald Wallace,SF-PF,386,851,324,665,62,186,Center,16,Jump Shot,10.82843713278496
2011-12,2222,Gerald Wallace,SF,287,632,241,482,46,150,Center,6,Jump Shot,9.534810126582279
2012-13,2222,Gerald Wallace,SF,182,457,136,295,46,162,Center,3,Jump Shot,11.61925601750547
2013-14,2222,Gerald Wallace,SF,116,230,97,166,19,64,Center,2,Jump Shot,8.960869565217392
2014-15,2222,Gerald Wallace,SF,14,34,13,31,1,3,Center,0,Layup Shot,5.705882352941177
2017-18,1628492,Gian Clavell,SG,6,18,0,3,6,15,Right Side,1,Jump Shot,22.0
2013-14,203507,Giannis Antetokounmpo,SF,173,418,132,300,41,118,Center,11,Jump Shot,10.342105263157896
2014-15,203507,Giannis Antetokounmpo,SG,383,780,376,736,7,44,Center,15,Jump Shot,7.171794871794872
2015-16,203507,Giannis Antetokounmpo,PG,512,1011,485,904,27,107,Center,20,Jump Shot,7.48862512363996
2016-17,203507,Giannis Antetokounmpo,SF,656,1258,607,1079,49,179,Center,24,Jump Shot,8.310015898251192
2017-18,203507,Giannis Antetokounmpo,PF,742,1402,699,1262,43,140,Center,39,Jump Shot,8.427246790299572
2018-19,203507,Giannis Antetokounmpo,PF,721,1247,669,1044,52,203,Center,32,Jump Shot,7.22935044105854
2019-20,203507,Giannis Antetokounmpo,PF,685,1238,596,945,89,293,Center,18,Jump Shot,9.284329563812602
2020-21,203507,Giannis Antetokounmpo,PF,626,1100,559,879,67,221,Center,23,Jump Shot,9.015454545454546
2021-22,203507,Giannis Antetokounmpo,PF,689,1245,618,1003,71,242,Center,32,Pullup Jump shot,9.539759036144579
2022-23,203507,Giannis Antetokounmpo,PF,707,1278,660,1107,47,171,Center,18,Driving Layup Shot,7.582942097026604
2013-14,203540,Gigi Datome,SF,34,97,27,58,7,39,Center,9,Jump Shot,17.95876288659794
2014-15,203540,Gigi Datome,SF,43,89,25,49,18,40,Center,6,Jump Shot,17.168539325842698
2003-04,2240,Gilbert Arenas,PG,358,914,233,581,125,333,Center,10,Jump Shot,15.089715536105032
2004-05,2240,Gilbert Arenas,PG,656,1523,451,961,205,562,Center,27,Jump Shot,14.749179251477347
2005-06,2240,Gilbert Arenas,PG,746,1668,547,1128,199,540,Center,24,Jump Shot,14.922062350119903
2006-07,2240,Gilbert Arenas,PG,647,1548,442,964,205,584,Center,28,Jump Shot,15.775839793281653
2007-08,2240,Gilbert Arenas,PG,78,196,56,118,22,78,Center,2,Jump Shot,16.81122448979592
2008-09,2240,Gilbert Arenas,PG,6,23,4,16,2,7,Center,0,Jump Shot,13.826086956521738
2009-10,2240,Gilbert Arenas,PG,253,616,190,435,63,181,Center,9,Jump Shot,15.126623376623376
2010-11,2240,Gilbert Arenas,PG,269,734,172,407,97,327,Center,16,Jump Shot,17.79291553133515
2011-12,2240,Gilbert Arenas,PG,26,64,13,25,13,39,Left Side Center,0,Jump Shot,20.40625
2007-08,201175,Glen Davis,C,107,221,107,221,0,0,Center,4,Layup Shot,4.6968325791855206
2008-09,201175,Glen Davis,C,199,450,197,445,2,5,Center,11,Jump Shot,10.248888888888889
2009-10,201175,Glen Davis,PF,122,279,122,275,0,4,Center,3,Layup Shot,6.326164874551972
2010-11,201175,Glen Davis,C,359,801,357,786,2,15,Center,19,Jump Shot,10.769038701622971
2011-12,201175,Glen Davis,PF,225,534,223,520,2,14,Center,9,Jump Shot,9.382022471910112
2012-13,201175,Glen Davis,PF,214,478,214,476,0,2,Center,6,Jump Shot,8.901673640167363
2013-14,201175,Glen Davis,PF,271,593,267,582,4,11,Center,5,Jump Shot,10.539629005059021
2014-15,201175,Glen Davis,PF,117,255,117,251,0,4,Center,6,Jump Shot,6.905882352941177
2003-04,779,Glen Rice,SF,22,76,17,48,5,28,Center,1,Jump Shot,16.94736842105263
2013-14,203318,Glen Rice,SG,11,37,6,20,5,17,Center,4,Jump Shot,17.91891891891892
2014-15,203318,Glen Rice,SG,3,15,2,8,1,7,Center,0,Jump Shot,14.666666666666666
2003-04,299,Glenn Robinson,SF,275,614,241,514,34,100,Center,4,Jump Shot,13.617263843648209
2004-05,299,Glenn Robinson,SF,34,77,32,71,2,6,Center,0,Jump Shot,13.207792207792208
2014-15,203922,Glenn Robinson III,SG-SF,26,67,21,48,5,19,Center,6,Jump Shot,12.805970149253731
2015-16,203922,Glenn Robinson III,SF,65,151,51,114,14,37,Center,7,Jump Shot,11.900662251655628
2016-17,203922,Glenn Robinson III,SF,158,337,109,213,49,124,Center,11,Jump Shot,14.890207715133531
2017-18,203922,Glenn Robinson III,SF,36,85,22,51,14,34,Center,1,Jump Shot,14.905882352941177
2018-19,203922,Glenn Robinson III,SF,74,176,56,114,18,62,Center,5,Jump Shot,13.107954545454545
2019-20,203922,Glenn Robinson III,SF,288,592,211,395,77,197,Center,14,Jump Shot,13.934121621621621
2020-21,203922,Glenn Robinson III,SF,42,99,26,55,16,44,Center,1,Jump Shot,13.717171717171718
2019-20,1629048,Goga Bitadze,C,70,150,62,108,8,42,Center,6,Jump Shot,12.92
2020-21,1629048,Goga Bitadze,C,83,194,63,115,20,79,Center,2,Jump Shot,12.469072164948454
2021-22,1629048,Goga Bitadze,C,131,252,108,172,23,80,Center,6,Jump Shot,9.932539682539682
2022-23,1629048,Goga Bitadze,C,69,125,63,99,6,26,Center,5,Jump Shot,7.416
2008-09,201609,Goran Dragic,PG,88,224,68,170,20,54,Center,11,Jump Shot,13.294642857142858
2009-10,201609,Goran Dragic,PG,222,491,148,303,74,188,Center,13,Jump Shot,14.19755600814664
2010-11,201609,Goran Dragic,PG,192,441,136,286,56,155,Center,6,Jump Shot,13.378684807256235
2011-12,201609,Goran Dragic,PG,277,600,209,398,68,202,Center,19,Jump Shot,12.67
2012-13,201609,Goran Dragic,PG,401,906,313,630,88,276,Center,20,Jump Shot,12.975717439293598
2013-14,201609,Goran Dragic,SG,552,1093,430,794,122,299,Center,30,Jump Shot,11.591948764867338
2014-15,201609,Goran Dragic,SG-PG,502,1002,412,743,90,259,Center,23,Jump Shot,10.55189620758483
2015-16,201609,Goran Dragic,PG,417,875,353,670,64,205,Center,12,Jump Shot,11.342857142857143
2016-17,201609,Goran Dragic,PG,534,1123,417,835,117,288,Center,20,Jump Shot,11.943009795191452
2017-18,201609,Goran Dragic,PG,484,1075,373,775,111,300,Center,21,Jump Shot,12.300465116279069
2018-19,201609,Goran Dragic,PG,179,433,122,269,57,164,Center,6,Jump Shot,13.288683602771362
2019-20,201609,Goran Dragic,PG,319,724,195,386,124,338,Center,8,Jump Shot,15.675414364640885
2020-21,201609,Goran Dragic,PG,240,555,149,311,91,244,Center,14,Jump Shot,14.796396396396396
2021-22,201609,Goran Dragic,PG,57,151,41,88,16,63,Center,0,Jump Shot,14.741721854304636
2022-23,201609,Goran Dragic,PG,141,335,89,190,52,145,Center,5,Jump Shot,15.280597014925373
2003-04,1921,Gordan Giricek,SF-SG,316,724,256,572,60,152,Center,15,Jump Shot,14.337016574585636
2004-05,1921,Gordan Giricek,SG,283,632,245,527,38,105,Center,7,Jump Shot,13.906645569620252
2005-06,1921,Gordan Giricek,SG,166,383,148,324,18,59,Center,1,Jump Shot,15.182767624020888
2006-07,1921,Gordan Giricek,SG,176,381,124,259,52,122,Center,3,Jump Shot,16.78477690288714
2007-08,1921,Gordan Giricek,SG,133,302,97,203,36,99,Center,6,Jump Shot,15.834437086092715
2010-11,202330,Gordon Hayward,SF,142,293,107,219,35,74,Center,7,Jump Shot,13.34470989761092
2011-12,202330,Gordon Hayward,SF,267,586,212,427,55,159,Center,9,Jump Shot,13.11433447098976
2012-13,202330,Gordon Hayward,SF,336,773,234,527,102,246,Center,9,Jump Shot,14.416558861578267
2013-14,202330,Gordon Hayward,SF,426,1032,341,752,85,280,Center,17,Jump Shot,14.556201550387597
2014-15,202330,Gordon Hayward,SF,484,1087,364,757,120,330,Center,23,Jump Shot,13.822447102115916
2015-16,202330,Gordon Hayward,SF,521,1202,378,792,143,410,Center,30,Jump Shot,13.636439267886855
2016-17,202330,Gordon Hayward,SF,545,1156,396,782,149,374,Center,16,Jump Shot,13.991349480968859
2017-18,202330,Gordon Hayward,SF,1,2,1,1,0,1,Center,0,Fadeaway Jump Shot,17.0
2018-19,202330,Gordon Hayward,PF,296,635,219,404,77,231,Center,10,Jump Shot,14.135433070866142
2019-20,202330,Gordon Hayward,SF,350,700,265,478,85,222,Center,5,Jump Shot,13.49
2020-21,202330,Gordon Hayward,SF,311,658,226,453,85,205,Center,7,Jump Shot,13.238601823708207
2021-22,202330,Gordon Hayward,SF,283,617,197,397,86,220,Center,1,Jump Shot,13.871961102106969
2022-23,202330,Gordon Hayward,SF,276,581,224,421,52,160,Center,10,Jump Shot,13.907056798623064
2013-14,203476,Gorgui Dieng,C,113,227,112,226,1,1,Center,10,Jump Shot,5.026431718061674
2014-15,203476,Gorgui Dieng,C,259,512,258,506,1,6,Center,10,Jump Shot,7.1796875
2015-16,203476,Gorgui Dieng,C,308,579,302,559,6,20,Center,19,Jump Shot,8.233160621761659
2016-17,203476,Gorgui Dieng,PF,332,661,316,618,16,43,Center,12,Jump Shot,9.915279878971255
2017-18,203476,Gorgui Dieng,C,186,388,167,327,19,61,Center,7,Jump Shot,12.38659793814433
2018-19,203476,Gorgui Dieng,C,189,377,170,321,19,56,Center,6,Jump Shot,12.360742705570292
2019-20,203476,Gorgui Dieng,C,166,364,112,212,54,152,Center,5,Jump Shot,14.085164835164836
2020-21,203476,Gorgui Dieng,C,85,163,55,93,30,70,Center,11,Jump Shot,14.116564417177914
2021-22,203476,Gorgui Dieng,C,53,112,24,44,29,68,Center,8,Jump Shot,18.660714285714285
2022-23,203476,Gorgui Dieng,C,45,117,24,42,21,75,Center,10,Jump Shot,18.82051282051282
2004-05,255,Grant Hill,SF,517,1015,514,1002,3,13,Center,17,Jump Shot,10.801970443349754
2005-06,255,Grant Hill,SF,119,243,117,235,2,8,Center,7,Jump Shot,10.164609053497943
2006-07,255,Grant Hill,SG,342,660,340,648,2,12,Center,19,Jump Shot,9.415151515151516
2007-08,255,Grant Hill,SF,358,712,325,608,33,104,Center,11,Jump Shot,11.123595505617978
2008-09,255,Grant Hill,SF,390,745,366,669,24,76,Center,13,Jump Shot,9.346308724832214
2009-10,255,Grant Hill,SF,336,703,301,623,35,80,Center,9,Jump Shot,10.736842105263158
2010-11,255,Grant Hill,SF,399,825,354,711,45,114,Center,13,Jump Shot,11.185454545454546
2011-12,255,Grant Hill,SF,201,451,187,398,14,53,Center,8,Jump Shot,12.649667405764967
2012-13,255,Grant Hill,SF,38,98,35,87,3,11,Center,2,Jump Shot,11.989795918367347
2014-15,203511,Grant Jerrett,PF,7,26,6,11,1,15,Center,1,Jump Shot,17.5
2020-21,1630203,Grant Riller,PG,8,12,6,8,2,4,Center,7,Jump Shot,16.25
2019-20,1629684,Grant Williams,PF,87,211,63,115,24,96,Center,4,Jump Shot,13.72037914691943
2020-21,1629684,Grant Williams,PF,108,247,60,118,48,129,Center,2,Jump Shot,14.979757085020243
2021-22,1629684,Grant Williams,PF,205,432,99,174,106,258,Center,3,Jump Shot,16.09027777777778
2022-23,1629684,Grant Williams,PF,216,476,101,185,115,291,Center,11,Jump Shot,16.98949579831933
2018-19,1628960,Grayson Allen,SG,67,178,35,79,32,99,Center,7,Jump Shot,16.95505617977528
2019-20,1628960,Grayson Allen,SG,117,251,60,110,57,141,Center,8,Jump Shot,16.46613545816733
2020-21,1628960,Grayson Allen,SG,173,414,66,140,107,274,Center,5,Jump Shot,18.683574879227052
2021-22,1628960,Grayson Allen,SG,255,569,96,180,159,389,Center,9,Jump Shot,18.715289982425308
2022-23,1628960,Grayson Allen,SG,245,557,99,191,146,366,Center,5,Jump Shot,18.24955116696589
2021-22,1630535,Greg Brown III,SF,81,190,62,129,19,61,Center,11,Jump Shot,10.215789473684211
2022-23,1630535,Greg Brown III,PF,11,28,10,21,1,7,Center,2,Jump Shot,8.607142857142858
2003-04,1761,Greg Buckner,SG,66,175,54,131,12,44,Center,3,Jump Shot,12.211428571428572
2004-05,1761,Greg Buckner,SG,160,303,111,182,49,121,Center,7,Jump Shot,12.049504950495049
2005-06,1761,Greg Buckner,SG,181,417,95,174,86,243,Center,5,Jump Shot,16.443645083932854
2006-07,1761,Greg Buckner,SG,123,299,91,196,32,103,Center,6,Jump Shot,12.832775919732441
2007-08,1761,Greg Buckner,SG,45,117,30,67,15,50,Center,0,Jump Shot,16.504273504273506
2008-09,1761,Greg Buckner,SF,61,159,48,108,13,51,Center,4,Jump Shot,12.364779874213836
2010-11,202328,Greg Monroe,C,303,550,303,549,0,1,Center,10,Layup Shot,2.6672727272727275
2011-12,202328,Greg Monroe,C,407,781,407,780,0,1,Center,18,Layup Shot,3.9295774647887325
2012-13,202328,Greg Monroe,C,514,1058,514,1054,0,4,Center,24,Layup Shot,4.686200378071834
2013-14,202328,Greg Monroe,PF,504,1015,504,1014,0,1,Center,2,Layup Shot,4.467980295566503
2014-15,202328,Greg Monroe,PF,423,853,423,853,0,0,Center,14,Layup Shot,3.5134818288393905
2015-16,202328,Greg Monroe,C,491,941,491,940,0,1,Center,16,Layup Shot,4.1434643995749205
2016-17,202328,Greg Monroe,C,387,726,387,722,0,4,Center,13,Layup Shot,4.012396694214876
2017-18,202328,Greg Monroe,C,218,386,218,386,0,0,Center,3,Layup Shot,3.7590673575129534
2018-19,202328,Greg Monroe,C,92,189,91,184,1,5,Center,8,Layup Shot,4.01058201058201
2021-22,202328,Greg Monroe,C,32,57,32,57,0,0,Center,3,Layup Shot,2.6491228070175437
2008-09,201141,Greg Oden,C,198,351,198,351,0,0,Center,6,Layup Shot,2.45014245014245
2009-10,201141,Greg Oden,C,92,152,92,152,0,0,Center,2,Layup Shot,2.223684210526316
2013-14,201141,Greg Oden,C,27,49,27,49,0,0,Center,1,Dunk Shot,2.6122448979591835
2003-04,731,Greg Ostertag,C,208,437,208,436,0,1,Center,10,Layup Shot,3.347826086956522
2004-05,731,Greg Ostertag,C,37,84,37,82,0,2,Center,1,Layup Shot,4.035714285714286
2005-06,731,Greg Ostertag,C,61,124,61,124,0,0,Center,0,Layup Shot,3.193548387096774
2011-12,202962,Greg Smith,C,7,11,7,11,0,0,Center,1,Layup Shot,2.6363636363636362
2012-13,202962,Greg Smith,C,170,274,170,273,0,1,Center,6,Layup Shot,2.291970802919708
2013-14,202962,Greg Smith,C,18,28,18,28,0,0,Center,0,Layup Shot,1.8571428571428572
2014-15,202962,Greg Smith,PF,30,49,30,49,0,0,Center,5,Layup Shot,1.653061224489796
2015-16,202962,Greg Smith,PF,18,32,18,32,0,0,Center,2,Layup Shot,1.4375
2011-12,201880,Greg Stiemsma,C,66,121,66,121,0,0,Center,3,Jump Shot,8.272727272727273
2012-13,201880,Greg Stiemsma,C,127,278,127,278,0,0,Center,2,Jump Shot,9.70503597122302
2013-14,201880,Greg Stiemsma,C,70,122,70,121,0,1,Center,3,Jump Shot,4.729508196721311
2014-15,201880,Greg Stiemsma,C,6,8,6,8,0,0,Center,2,Jump Shot,3.5
2020-21,204222,Greg Whittington,PF,0,3,0,1,0,2,Center,0,Jump Shot,21.0
2010-11,202349,Greivis Vasquez,PG,95,233,70,147,25,86,Center,5,Jump Shot,14.909871244635193
2011-12,202349,Greivis Vasquez,PG,225,523,182,388,43,135,Center,12,Jump Shot,13.045889101338432
2012-13,202349,Greivis Vasquez,PG,438,1012,355,769,83,243,Center,26,Jump Shot,11.394268774703557
2013-14,202349,Greivis Vasquez,PG,277,658,168,369,109,289,Center,10,Jump Shot,15.655015197568389
2014-15,202349,Greivis Vasquez,PG,296,725,163,374,133,351,Center,10,Jump Shot,16.310344827586206
2015-16,202349,Greivis Vasquez,PG,45,138,27,65,18,73,Center,2,Jump Shot,16.869565217391305
2016-17,202349,Greivis Vasquez,PG,2,8,1,5,1,3,Center,0,Jump Shot,13.75
2017-18,1627824,Guerschon Yabusele,PF,26,61,14,24,12,37,Center,5,Jump Shot,17.737704918032787
2018-19,1627824,Guerschon Yabusele,PF,35,77,26,49,9,28,Center,15,Jump Shot,11.857142857142858
2007-08,200799,Guillermo Diaz,SG,1,4,1,3,0,1,Center,1,Jump Shot,14.5
2011-12,202970,Gustavo Ayon,PF,140,261,140,260,0,1,Center,10,Jump Shot,5.057471264367816
2012-13,202970,Gustavo Ayon,C,92,167,92,167,0,0,Center,7,Layup Shot,4.718562874251497
2013-14,202970,Gustavo Ayon,C,52,102,52,102,0,0,Center,5,Layup Shot,3.5588235294117645
2004-05,2775,Ha Ha,C,10,23,10,23,0,0,Center,3,Layup Shot,2.391304347826087
2005-06,2775,Ha Ha,C,18,31,18,31,0,0,Center,2,Layup Shot,1.4193548387096775
2005-06,101124,Hakim Warrick,PF,101,228,101,228,0,0,Center,5,Jump Shot,4.732456140350878
2006-07,101124,Hakim Warrick,PF,373,712,373,704,0,8,Center,18,Jump Shot,6.71067415730337
2007-08,101124,Hakim Warrick,PF,328,653,315,605,13,48,Center,13,Jump Shot,10.324655436447166
2008-09,101124,Hakim Warrick,PF,340,693,335,670,5,23,Center,21,Jump Shot,7.842712842712842
2009-10,101124,Hakim Warrick,PF,265,550,264,543,1,7,Center,8,Jump Shot,7.96
2010-11,101124,Hakim Warrick,PF,228,446,227,435,1,11,Center,9,Jump Shot,7.4125560538116595
2011-12,101124,Hakim Warrick,PF,74,180,73,170,1,10,Center,2,Jump Shot,9.5
2012-13,101124,Hakim Warrick,PF,67,165,67,162,0,3,Center,3,Jump Shot,9.903030303030302
2010-11,202380,Hamady Ndiaye,C,4,5,4,5,0,0,Center,2,Dunk Shot,6.4
2011-12,202380,Hamady Ndiaye,C,0,1,0,1,0,0,Center,0,Layup Shot,1.0
2013-14,202380,Hamady Ndiaye,C,3,9,3,9,0,0,Center,1,Dunk Shot,4.888888888888889
2008-09,201632,Hamed Haddadi,C,15,31,15,31,0,0,Center,2,Jump Shot,6.161290322580645
2009-10,201632,Hamed Haddadi,C,24,62,24,59,0,3,Center,1,Layup Shot,5.967741935483871
2010-11,201632,Hamed Haddadi,C,30,58,30,57,0,1,Center,4,Layup Shot,3.8448275862068964
2011-12,201632,Hamed Haddadi,C,26,48,26,47,0,1,Center,2,Layup Shot,4.625
2012-13,201632,Hamed Haddadi,C,35,82,35,82,0,0,Center,6,Jump Shot,5.7317073170731705
2018-19,1628977,Hamidou Diallo,SG,75,165,71,141,4,24,Center,1,Jump Shot,5.848484848484849
2019-20,1628977,Hamidou Diallo,SF,132,296,116,239,16,57,Center,4,Jump Shot,7.875
2020-21,1628977,Hamidou Diallo,SG-SF,224,470,196,388,28,82,Center,4,Driving Layup Shot,8.86595744680851
2021-22,1628977,Hamidou Diallo,SG,261,526,238,433,23,93,Center,7,Jump Shot,9.024714828897338
2022-23,1628977,Hamidou Diallo,SG,215,375,210,354,5,21,Center,11,Driving Layup Shot,6.336
2012-13,203084,Harrison Barnes,SF,276,628,224,483,52,145,Center,9,Jump Shot,10.882165605095542
2013-14,203084,Harrison Barnes,SF,271,679,205,489,66,190,Center,12,Jump Shot,12.42120765832106
2014-15,203084,Harrison Barnes,SF,316,656,229,441,87,215,Center,16,Jump Shot,12.850609756097562
2015-16,203084,Harrison Barnes,SF,295,633,213,419,82,214,Center,13,Jump Shot,13.849921011058452
2016-17,203084,Harrison Barnes,PF,598,1279,521,1058,77,221,Center,18,Jump Shot,12.616888193901486
2017-18,203084,Harrison Barnes,PF,537,1208,418,875,119,333,Center,23,Jump Shot,13.16225165562914
2018-19,203084,Harrison Barnes,PF-SF,431,1027,257,586,174,441,Center,15,Jump Shot,14.437195715676728
2019-20,203084,Harrison Barnes,PF,365,793,263,525,102,268,Center,12,Jump Shot,11.313997477931904
2020-21,203084,Harrison Barnes,PF,319,642,219,386,100,256,Center,15,Jump Shot,12.037383177570094
2021-22,203084,Harrison Barnes,PF,391,834,249,474,142,360,Center,16,Jump Shot,13.06115107913669
2022-23,203084,Harrison Barnes,PF,374,791,242,438,132,353,Center,4,Jump Shot,13.269279393173198
2018-19,1628385,Harry Giles III,PF,175,348,175,342,0,6,Center,8,Jump Shot,6.600574712643678
2019-20,1628385,Harry Giles III,C,139,251,139,249,0,2,Center,5,Jump Shot,7.075697211155378
2020-21,1628385,Harry Giles III,C,42,97,34,74,8,23,Center,7,Jump Shot,9.948453608247423
2009-10,201934,Hasheem Thabeet,C,77,131,77,131,0,0,Center,5,Layup Shot,2.213740458015267
2010-11,201934,Hasheem Thabeet,C,17,40,17,40,0,0,Center,2,Jump Shot,3.15
2011-12,201934,Hasheem Thabeet,C,11,21,11,21,0,0,Center,2,Layup Shot,2.4761904761904763
2012-13,201934,Hasheem Thabeet,C,64,106,64,106,0,0,Center,7,Layup Shot,2.481132075471698
2013-14,201934,Hasheem Thabeet,C,13,23,13,23,0,0,Center,3,Jump Shot,6.826086956521739
2006-07,200801,Hassan Adams,SG,75,135,75,134,0,1,Center,5,Layup Shot,4.9185185185185185
2008-09,200801,Hassan Adams,SG,4,13,4,13,0,0,Center,3,Jump Shot,7.615384615384615
2011-12,202355,Hassan Whiteside,C,12,27,12,27,0,0,Center,3,Jump Shot,5.185185185185185
2014-15,202355,Hassan Whiteside,C,243,387,243,387,0,0,Center,11,Jump Shot,3.656330749354005
2015-16,202355,Hassan Whiteside,C,413,682,413,682,0,0,Center,18,Jump Shot,4.712609970674487
2016-17,202355,Hassan Whiteside,C,542,973,542,973,0,0,Center,20,Jump Shot,5.052415210688592
2017-18,202355,Hassan Whiteside,C,312,578,310,576,2,2,Center,9,Jump Shot,5.666089965397924
2018-19,202355,Hassan Whiteside,C,388,680,386,664,2,16,Center,7,Jump Shot,4.251470588235295
2019-20,202355,Hassan Whiteside,C,436,702,432,695,4,7,Center,20,Tip Layup Shot,4.535612535612535
2020-21,202355,Hassan Whiteside,C,126,224,126,223,0,1,Center,2,Hook Shot,5.383928571428571
2021-22,202355,Hassan Whiteside,C,215,330,215,330,0,0,Center,7,Layup Shot,3.378787878787879
2021-22,1629755,Hassani Gravett,PG,18,38,7,12,11,26,Center,2,Jump Shot,20.44736842105263
2018-19,1629312,Haywood Highsmith,SF,4,10,3,5,1,5,Center,0,Jump Shot,14.8
2021-22,1629312,Haywood Highsmith,SF,16,46,7,18,9,28,Center,0,Jump Shot,16.282608695652176
2022-23,1629312,Haywood Highsmith,SF,93,216,56,107,37,109,Center,7,Jump Shot,14.958333333333334
2003-04,2045,Hedo Turkoglu,SF,262,645,161,404,101,241,Center,10,Jump Shot,15.795348837209302
2004-05,2045,Hedo Turkoglu,SF,328,782,235,537,93,245,Center,10,Jump Shot,14.847826086956522
2005-06,2045,Hedo Turkoglu,SF,398,877,284,594,114,283,Center,25,Jump Shot,14.766248574686431
2006-07,2045,Hedo Turkoglu,SF,345,823,236,542,109,281,Center,15,Jump Shot,14.742405832320777
2007-08,2045,Hedo Turkoglu,SF,556,1219,390,804,166,415,Center,31,Jump Shot,13.243642329778506
2008-09,2045,Hedo Turkoglu,SF,423,1025,289,649,134,376,Center,17,Jump Shot,14.67609756097561
2009-10,2045,Hedo Turkoglu,SF,276,674,168,385,108,289,Center,14,Jump Shot,16.18694362017804
2010-11,2045,Hedo Turkoglu,SF-PF,322,722,195,412,127,310,Center,19,Jump Shot,17.397506925207757
2011-12,2045,Hedo Turkoglu,SF,209,504,118,246,91,258,Center,13,Jump Shot,17.634920634920636
2012-13,2045,Hedo Turkoglu,SF,14,53,13,29,1,24,Center,0,Jump Shot,14.81132075471698
2013-14,2045,Hedo Turkoglu,SF,42,109,20,59,22,50,Center,2,Jump Shot,16.844036697247706
2014-15,2045,Hedo Turkoglu,SF,83,188,23,49,60,139,Left Side Center,2,Jump Shot,21.0531914893617
2016-17,1627740,Henry Ellenson,PF,23,64,13,29,10,35,Center,4,Jump Shot,17.25
2017-18,1627740,Henry Ellenson,PF,53,146,33,86,20,60,Center,9,Jump Shot,14.595890410958905
2018-19,1627740,Henry Ellenson,PF,39,95,22,57,17,38,Center,7,Jump Shot,13.263157894736842
2019-20,1627740,Henry Ellenson,C,1,7,1,3,0,4,Center,1,Jump Shot,15.428571428571429
2020-21,1627740,Henry Ellenson,PF,5,14,3,5,2,9,Center,1,Jump Shot,17.214285714285715
2012-13,203156,Henry Sims,C,2,3,2,3,0,0,Center,1,Layup Shot,1.0
2013-14,203156,Henry Sims,C,130,274,130,273,0,1,Center,8,Jump Shot,6.894160583941606
2014-15,203156,Henry Sims,C,238,502,234,480,4,22,Center,6,Jump Shot,9.852589641434262
2015-16,203156,Henry Sims,C,33,77,33,77,0,0,Center,0,Jump Shot,7.779220779220779
2008-09,201611,Henry Walker,SF,36,58,36,57,0,1,Center,10,Jump Shot,5.844827586206897
2009-10,201611,Henry Walker,SG-SF,120,232,70,116,50,116,Center,10,Jump Shot,14.34051724137931
2010-11,201611,Henry Walker,SG,104,236,45,83,59,153,Center,2,Jump Shot,18.152542372881356
2011-12,201611,Henry Walker,SG,68,171,32,58,36,113,Center,2,Jump Shot,18.39766081871345
2014-15,201611,Henry Walker,SF,58,168,13,36,45,132,Center,3,Jump Shot,20.714285714285715
2021-22,1630529,Herbert Jones,PF,274,576,217,407,57,169,Center,10,Jump Shot,10.258680555555555
2022-23,1630529,Herbert Jones,SF,235,501,179,334,56,167,Center,10,Jump Shot,10.42315369261477
2006-07,200756,Hilton Armstrong,C,68,125,68,125,0,0,Center,4,Jump Shot,5.248
2007-08,200756,Hilton Armstrong,C,67,148,67,148,0,0,Center,5,Layup Shot,3.858108108108108
2008-09,200756,Hilton Armstrong,C,138,246,138,244,0,2,Center,5,Jump Shot,4.90650406504065
2009-10,200756,Hilton Armstrong,PF-C,28,79,28,78,0,1,Center,4,Jump Shot,6.506329113924051
2010-11,200756,Hilton Armstrong,C,37,76,35,72,2,4,Center,5,Jump Shot,8.171052631578947
2013-14,200756,Hilton Armstrong,C,9,19,9,19,0,0,Center,0,Jump Shot,6.421052631578948
2003-04,2673,Hiram Fuller,PF,3,8,3,8,0,0,Center,0,Jump Shot,4.875
2013-14,203138,Hollis Thompson,SF,171,372,104,205,67,167,Center,9,Jump Shot,14.38978494623656
2014-15,203138,Hollis Thompson,SG,224,543,109,256,115,287,Center,12,Jump Shot,16.668508287292816
2015-16,203138,Hollis Thompson,SG,270,679,121,288,149,391,Center,20,Jump Shot,17.8100147275405
2016-17,203138,Hollis Thompson,SG,77,200,45,105,32,95,Center,4,Jump Shot,15.105
2003-04,270,Horace Grant,PF,92,224,92,223,0,1,Center,3,Jump Shot,10.933035714285714
2004-05,2798,Horace Jenkins,PG,15,45,15,36,0,9,Center,4,Jump Shot,11.333333333333334
2003-04,458,Howard Eisley,PG,166,451,114,288,52,163,Center,9,Jump Shot,15.605321507760532
2004-05,458,Howard Eisley,PG,161,405,134,302,27,103,Center,7,Jump Shot,16.039506172839506
2005-06,458,Howard Eisley,PG,34,103,21,61,13,42,Right Side Center,0,Jump Shot,18.300970873786408
2003-04,93,Hubert Davis,SG,1,11,1,10,0,1,Center,0,Jump Shot,11.818181818181818
2013-14,203546,Ian Clark,SG,26,67,15,36,11,31,Center,9,Jump Shot,15.582089552238806
2014-15,203546,Ian Clark,SG,19,55,9,25,10,30,Center,1,Jump Shot,16.854545454545455
2015-16,203546,Ian Clark,SG,88,201,59,118,29,83,Center,17,Jump Shot,14.398009950248756
2016-17,203546,Ian Clark,SG,211,433,150,270,61,163,Center,22,Jump Shot,14.491916859122401
2017-18,203546,Ian Clark,SG,222,495,160,300,62,195,Center,13,Jump Shot,15.296969696969697
2018-19,203546,Ian Clark,SG,151,383,85,181,66,202,Center,9,Jump Shot,17.10182767624021
2007-08,101133,Ian Mahinmi,C,6,12,6,12,0,0,Center,1,Jump Shot,2.4166666666666665
2009-10,101133,Ian Mahinmi,C,35,55,35,55,0,0,Center,5,Layup Shot,4.254545454545455
2010-11,101133,Ian Mahinmi,C,55,98,55,96,0,2,Center,9,Jump Shot,6.163265306122449
2011-12,101133,Ian Mahinmi,C,130,238,130,237,0,1,Center,3,Jump Shot,4.701680672268908
2012-13,101133,Ian Mahinmi,C,149,329,149,327,0,2,Center,0,Jump Shot,8.209726443768997
2013-14,101133,Ian Mahinmi,C,91,189,91,188,0,1,Center,3,Layup Shot,4.64021164021164
2014-15,101133,Ian Mahinmi,C,117,212,117,212,0,0,Center,2,Layup Shot,3.6462264150943398
2015-16,101133,Ian Mahinmi,C,264,448,264,448,0,0,Center,6,Layup Shot,3.763392857142857
2016-17,101133,Ian Mahinmi,C,65,111,65,111,0,0,Center,0,Layup Shot,2.675675675675676
2017-18,101133,Ian Mahinmi,C,138,248,138,246,0,2,Center,1,Layup Shot,3.338709677419355
2018-19,101133,Ian Mahinmi,C,47,104,44,88,3,16,Center,0,Jump Shot,6.269230769230769
2019-20,101133,Ian Mahinmi,C,104,210,99,184,5,26,Center,0,Jump Shot,6.185714285714286
2004-05,2825,Ibrahim Kutluay,SG,0,1,0,1,0,0,Right Side,0,Jump Shot,15.0
2019-20,1629649,Ignas Brazdeikis,SF,6,22,5,13,1,9,Center,2,Jump Shot,15.136363636363637
2020-21,1629649,Ignas Brazdeikis,SF,35,83,24,55,11,28,Center,2,Jump Shot,12.578313253012048
2021-22,1629649,Ignas Brazdeikis,SF,81,188,54,101,27,87,Center,5,Jump Shot,13.558510638297872
2017-18,1628387,Ike Anigbogu,C,4,9,4,9,0,0,Center,4,Jump Shot,10.444444444444445
2018-19,1628387,Ike Anigbogu,C,0,3,0,3,0,0,Center,0,Jump Shot,12.333333333333334
2005-06,101113,Ike Diogu,PF,175,334,175,334,0,0,Center,10,Jump Shot,5.404191616766467
2006-07,101113,Ike Diogu,PF,127,266,127,266,0,0,Center,9,Jump Shot,5.176691729323308
2007-08,101113,Ike Diogu,PF,64,134,64,134,0,0,Center,6,Jump Shot,6.119402985074627
2008-09,101113,Ike Diogu,PF,39,74,38,72,1,2,Center,5,Jump Shot,7.162162162162162
2010-11,101113,Ike Diogu,PF,83,148,83,148,0,0,Center,7,Layup Shot,4.743243243243243
2011-12,101113,Ike Diogu,PF,0,2,0,2,0,0,Center,0,Driving Layup Shot,3.5
2011-12,202697,Iman Shumpert,PG,214,534,166,377,48,157,Center,9,Jump Shot,13.754681647940075
2012-13,202697,Iman Shumpert,SG,109,275,58,148,51,127,Center,1,Jump Shot,15.247272727272728
2013-14,202697,Iman Shumpert,SG,183,484,107,256,76,228,Center,7,Jump Shot,16.617768595041323
2014-15,202697,Iman Shumpert,SG,193,471,126,275,67,196,Center,8,Jump Shot,16.220806794055203
2015-16,202697,Iman Shumpert,SG,114,304,71,159,43,145,Center,4,Jump Shot,16.69407894736842
2016-17,202697,Iman Shumpert,SG,200,488,107,228,93,260,Center,5,Jump Shot,17.83606557377049
2017-18,202697,Iman Shumpert,SG,22,58,15,32,7,26,Center,1,Jump Shot,18.086206896551722
2018-19,202697,Iman Shumpert,SG,167,446,72,173,95,273,Center,6,Jump Shot,19.47085201793722
2019-20,202697,Iman Shumpert,SF,21,64,13,31,8,33,Center,0,Jump Shot,18.0625
2020-21,202697,Iman Shumpert,SG,1,4,1,1,0,3,Left Side Center,0,Pullup Jump shot,21.5
2003-04,2137,Ime Udoka,SF,3,9,3,8,0,1,Right Side,2,Jump Shot,10.777777777777779
2005-06,2137,Ime Udoka,SF,9,24,8,21,1,3,Left Side,1,Jump Shot,13.416666666666666
2006-07,2137,Ime Udoka,SF,237,514,148,295,89,219,Center,5,Jump Shot,14.69260700389105
2007-08,2137,Ime Udoka,PF,159,375,98,210,61,165,Left Side,11,Jump Shot,15.906666666666666
2008-09,2137,Ime Udoka,SF,110,287,69,162,41,125,Right Side,6,Jump Shot,16.337979094076655
2009-10,2137,Ime Udoka,SG,90,240,65,150,25,90,Center,3,Jump Shot,14.154166666666667
2010-11,2137,Ime Udoka,SF,5,21,5,13,0,8,Right Side,1,Jump Shot,16.238095238095237
2020-21,1630193,Immanuel Quickley,PG,229,580,111,277,118,303,Center,10,Jump Shot,17.905172413793103
2021-22,1630193,Immanuel Quickley,PG,284,724,147,328,137,396,Center,13,Jump Shot,17.903314917127073
2022-23,1630193,Immanuel Quickley,PG,419,936,251,482,168,454,Center,13,Jump Shot,15.988247863247864
2003-04,1956,Ira Newble,SF,108,276,106,257,2,19,Center,4,Jump Shot,11.880434782608695
2004-05,1956,Ira Newble,SG,182,424,163,371,19,53,Center,2,Jump Shot,11.377358490566039
2005-06,1956,Ira Newble,SG,17,57,14,44,3,13,Center,0,Jump Shot,12.701754385964913
2006-07,1956,Ira Newble,SF,16,37,8,22,8,15,Center,4,Jump Shot,12.027027027027026
2007-08,1956,Ira Newble,SG-SF,76,174,60,125,16,49,Center,9,Jump Shot,11.71264367816092
2018-19,1629067,Isaac Bonga,PG,5,33,5,25,0,8,Center,0,Jump Shot,10.575757575757576
2019-20,1629067,Isaac Bonga,SF,118,234,93,163,25,71,Center,8,Jump Shot,9.615384615384615
2020-21,1629067,Isaac Bonga,SF,30,81,17,34,13,47,Center,1,Jump Shot,15.530864197530864
2021-22,1629067,Isaac Bonga,SF,3,13,2,9,1,4,Center,2,Jump Shot,10.538461538461538
2018-19,1629353,Isaac Humphries,C,6,21,3,10,3,11,Center,0,Jump Shot,14.476190476190476
2020-21,1630171,Isaac Okoro,SG,235,559,173,345,62,214,Center,11,Jump Shot,11.33273703041145
2021-22,1630171,Isaac Okoro,SF,207,431,152,274,55,157,Center,5,Jump Shot,9.930394431554525
2022-23,1630171,Isaac Okoro,SF,175,354,113,183,62,171,Center,7,Jump Shot,12.313559322033898
2018-19,1628515,Isaiah Briscoe,PG,55,138,44,104,11,34,Center,8,Jump Shot,12.485507246376812
2013-14,203477,Isaiah Canaan,PG,31,87,13,32,18,55,Center,3,Jump Shot,17.95402298850575
2014-15,203477,Isaiah Canaan,PG,146,378,55,132,91,246,Center,8,Jump Shot,18.566137566137566
2015-16,203477,Isaiah Canaan,SG,260,722,84,237,176,485,Center,8,Jump Shot,19.024930747922436
2016-17,203477,Isaiah Canaan,SG,63,173,38,79,25,94,Center,3,Jump Shot,17.069364161849713
2017-18,203477,Isaiah Canaan,PG-SG,52,137,30,71,22,66,Center,3,Jump Shot,14.423357664233576
2018-19,203477,Isaiah Canaan,PG,64,164,30,68,34,96,Center,2,Jump Shot,16.932926829268293
2018-19,1628392,Isaiah Hartenstein,PF,20,41,18,35,2,6,Center,2,Cutting Dunk Shot,4.902439024390244
2019-20,1628392,Isaiah Hartenstein,C,44,67,44,62,0,5,Center,5,Tip Layup Shot,3.7761194029850746
2020-21,1628392,Isaiah Hartenstein,C,94,171,92,165,2,6,Center,4,Floating Jump shot,4.017543859649122
2021-22,1628392,Isaiah Hartenstein,C,229,366,215,336,14,30,Center,17,Floating Jump shot,5.478142076502732
2022-23,1628392,Isaiah Hartenstein,C,175,327,167,290,8,37,Center,5,Floating Jump shot,5.617737003058104
2017-18,1628439,Isaiah Hicks,PF,33,72,31,63,2,9,Center,5,Jump Shot,7.25
2018-19,1628439,Isaiah Hicks,PF,4,8,4,8,0,0,Center,0,Jump Shot,7.125
2021-22,1630543,Isaiah Jackson,PF,116,206,111,190,5,16,Center,6,Tip Layup Shot,4.567961165048544
2022-23,1630543,Isaiah Jackson,C,179,318,177,304,2,14,Center,5,Tip Layup Shot,3.789308176100629
2020-21,1630198,Isaiah Joe,SG,48,133,9,27,39,106,Center,11,Jump Shot,22.7593984962406
2021-22,1630198,Isaiah Joe,SG,62,177,17,42,45,135,Center,9,Jump Shot,21.73446327683616
2022-23,1630198,Isaiah Joe,SG,224,508,63,114,161,394,Left Side Center,7,Jump Shot,22.112204724409448
2021-22,1630587,Isaiah Livers,SF,41,90,14,26,27,64,Right Side Center,2,Jump Shot,19.666666666666668
2022-23,1630587,Isaiah Livers,PF,120,288,46,85,74,203,Center,1,Jump Shot,20.24652777777778
2022-23,1630600,Isaiah Mobley,PF,12,28,9,20,3,8,Center,3,Jump Shot,10.642857142857142
2019-20,1629676,Isaiah Roby,PF,0,1,0,1,0,0,Center,0,Floating Jump shot,3.0
2020-21,1629676,Isaiah Roby,PF,207,429,175,320,32,109,Center,16,Jump Shot,9.044289044289044
2021-22,1629676,Isaiah Roby,PF,166,323,122,224,44,99,Center,7,Jump Shot,10.30030959752322
2022-23,1629676,Isaiah Roby,PF,67,155,49,95,18,60,Center,6,Jump Shot,12.606451612903227
2020-21,1630191,Isaiah Stewart,C,226,409,205,346,21,63,Center,8,Jump Shot,6.943765281173594
2021-22,1630191,Isaiah Stewart,C,250,490,235,444,15,46,Center,10,Layup Shot,5.206122448979592
2022-23,1630191,Isaiah Stewart,C,195,441,128,236,67,205,Center,4,Jump Shot,13.08390022675737
2016-17,1627819,Isaiah Taylor,PG,1,7,1,5,0,2,Center,0,Driving Layup Shot,11.285714285714286
2017-18,1627819,Isaiah Taylor,PG,163,390,143,310,20,80,Center,11,Driving Layup Shot,9.558974358974359
2011-12,202738,Isaiah Thomas,PG,256,571,173,352,83,219,Center,20,Jump Shot,14.148861646234677
2012-13,202738,Isaiah Thomas,PG,366,832,251,511,115,321,Center,19,Jump Shot,13.640625
2013-14,202738,Isaiah Thomas,PG,496,1096,369,732,127,364,Center,24,Jump Shot,13.99087591240876
2014-15,202738,Isaiah Thomas,PG,335,796,206,450,129,346,Center,12,Jump Shot,14.85175879396985
2015-16,202738,Isaiah Thomas,PG,591,1382,424,917,167,465,Center,31,Jump Shot,12.218523878437047
2016-17,202738,Isaiah Thomas,PG,682,1473,437,827,245,646,Center,40,Jump Shot,13.811269517990496
2017-18,202738,Isaiah Thomas,PG,157,421,102,233,55,188,Center,1,Jump Shot,15.78147268408551
2018-19,202738,Isaiah Thomas,SG,34,99,22,56,12,43,Center,2,Jump Shot,14.333333333333334
2019-20,202738,Isaiah Thomas,PG,174,426,96,237,78,189,Center,2,Jump Shot,17.21361502347418
2020-21,202738,Isaiah Thomas,PG,9,27,6,15,3,12,Center,1,Jump Shot,16.666666666666668
2021-22,202738,Isaiah Thomas,PG,67,167,39,84,28,83,Center,3,Jump Shot,16.32934131736527
2021-22,1630225,Isaiah Todd,PF,7,26,3,10,4,16,Center,3,Jump Shot,17.46153846153846
2022-23,1630225,Isaiah Todd,PF,3,19,2,9,1,10,Center,2,Jump Shot,16.526315789473685
2016-17,1627785,Isaiah Whitehead,PG,204,507,160,358,44,149,Center,9,Jump Shot,11.250493096646943
2017-18,1627785,Isaiah Whitehead,PG,40,86,33,68,7,18,Center,5,Driving Layup Shot,9.093023255813954
2010-11,202397,Ish Smith,PG,43,115,40,105,3,10,Center,2,Jump Shot,8.6
2011-12,202397,Ish Smith,PG,31,81,28,72,3,9,Center,2,Jump Shot,9.320987654320987
2012-13,202397,Ish Smith,PG,56,159,48,132,8,27,Center,3,Jump Shot,11.163522012578616
2013-14,202397,Ish Smith,PG,119,281,118,258,1,23,Center,5,Jump Shot,7.903914590747331
2014-15,202397,Ish Smith,PG,143,367,125,307,18,60,Center,11,Jump Shot,7.844686648501362
2015-16,202397,Ish Smith,PG,397,967,341,797,56,170,Center,21,Jump Shot,10.79110651499483
2016-17,202397,Ish Smith,PG,329,749,301,644,28,105,Center,17,Jump Shot,11.289719626168225
2017-18,202397,Ish Smith,PG,389,801,354,700,35,101,Center,11,Jump Shot,10.932584269662922
2018-19,202397,Ish Smith,PG,205,489,161,354,44,135,Center,11,Jump Shot,13.137014314928425
2019-20,202397,Ish Smith,PG,308,689,246,520,62,169,Center,7,Pullup Jump shot,12.685050798258345
2020-21,202397,Ish Smith,PG,129,297,111,248,18,49,Center,2,Pullup Jump shot,12.518518518518519
2021-22,202397,Ish Smith,PG,185,430,160,363,25,67,Center,8,Pullup Jump shot,12.732558139534884
2022-23,202397,Ish Smith,PG,52,131,50,119,2,12,Center,8,Pullup Jump shot,12.916030534351146
2021-22,1630688,Ish Wainright,PF,41,104,22,45,19,59,Center,10,Jump Shot,15.307692307692308
2022-23,1630688,Ish Wainright,SF,84,227,27,54,57,173,Center,10,Jump Shot,19.31718061674009
2011-12,201274,Ivan Johnson,PF,141,275,139,269,2,6,Center,6,Jump Shot,7.425454545454546
2012-13,201274,Ivan Johnson,PF,185,356,184,343,1,13,Center,10,Jump Shot,8.047752808988765
2006-07,200829,Ivan McFarlin,PF,5,13,5,12,0,1,Center,2,Layup Shot,3.3846153846153846
2017-18,1628397,Ivan Rabb,PF,86,152,86,152,0,0,Center,6,Jump Shot,7.453947368421052
2018-19,1628397,Ivan Rabb,PF,116,212,113,197,3,15,Center,10,Jump Shot,7.136792452830188
2016-17,1627826,Ivica Zubac,C,126,238,126,235,0,3,Center,5,Jump Shot,5.7899159663865545
2017-18,1627826,Ivica Zubac,C,61,122,61,121,0,1,Center,3,Tip Layup Shot,3.819672131147541
2018-19,1627826,Ivica Zubac,C,212,379,212,379,0,0,Center,8,Hook Shot,2.8733509234828496
2019-20,1627826,Ivica Zubac,C,236,385,236,383,0,2,Center,1,Tip Layup Shot,2.916883116883117
2020-21,1627826,Ivica Zubac,C,257,394,256,390,1,4,Center,5,Cutting Dunk Shot,2.4619289340101522
2021-22,1627826,Ivica Zubac,C,310,495,310,495,0,0,Center,4,Turnaround Hook Shot,3.026262626262626
2022-23,1627826,Ivica Zubac,C,326,514,326,512,0,2,Center,6,Turnaround Hook Shot,2.842412451361868
2006-07,200826,J.J. Barea,PG,28,78,22,57,6,21,Center,4,Jump Shot,12.371794871794872
2007-08,200826,J.J. Barea,PG,71,170,50,116,21,54,Center,12,Jump Shot,11.070588235294117
2008-09,200826,J.J. Barea,SG,246,557,191,403,55,154,Center,11,Jump Shot,11.360861759425493
2009-10,200826,J.J. Barea,PG,232,527,176,370,56,157,Center,7,Jump Shot,12.318785578747628
2010-11,200826,J.J. Barea,PG,285,649,219,460,66,189,Center,9,Jump Shot,11.92295839753467
2011-12,200826,J.J. Barea,PG,167,418,114,275,53,143,Center,4,Jump Shot,12.729665071770334
2012-13,200826,J.J. Barea,PG,316,758,219,478,97,280,Center,18,Jump Shot,13.365435356200528
2013-14,200826,J.J. Barea,PG,254,656,181,425,73,231,Center,2,Jump Shot,13.24390243902439
2014-15,200826,J.J. Barea,PG,225,536,171,369,54,167,Center,8,Jump Shot,12.28544776119403
2015-16,200826,J.J. Barea,PG,317,711,217,451,100,260,Center,10,Jump Shot,13.524613220815752
2016-17,200826,J.J. Barea,PG,142,343,89,195,53,148,Center,4,Jump Shot,15.845481049562682
2017-18,200826,J.J. Barea,PG,303,690,188,377,115,313,Center,7,Jump Shot,15.610144927536233
2018-19,200826,J.J. Barea,PG,161,385,123,257,38,128,Center,1,Jump Shot,13.537662337662338
2019-20,200826,J.J. Barea,PG,85,207,53,122,32,85,Center,5,Pullup Jump shot,14.342995169082126
2018-19,1629122,J.P. Macura,SG,3,9,3,5,0,4,Center,2,Jump Shot,12.555555555555555
2003-04,2452,J.R. Bremer,PG,43,158,24,84,19,74,Center,4,Jump Shot,16.61392405063291
2008-09,201592,J.R. Giddens,SF,2,3,2,3,0,0,Center,0,Jump Shot,11.0
2009-10,201592,J.R. Giddens,SF,28,60,28,50,0,10,Center,6,Jump Shot,10.283333333333333
2022-23,1631120,JD Davison,PG,8,19,6,12,2,7,Center,3,Jump Shot,15.368421052631579
2008-09,201581,JJ Hickson,C,100,194,100,194,0,0,Center,12,Jump Shot,4.664948453608248
2009-10,201581,JJ Hickson,PF,289,522,289,521,0,1,Center,5,Layup Shot,4.695402298850575
2010-11,201581,JJ Hickson,C,429,936,429,931,0,5,Center,15,Jump Shot,6.990384615384615
2011-12,201581,JJ Hickson,PF,183,392,183,390,0,2,Center,6,Jump Shot,7.002551020408164
2012-13,201581,JJ Hickson,C,418,744,418,742,0,2,Center,7,Layup Shot,4.780913978494624
2013-14,201581,JJ Hickson,PF,332,654,332,646,0,8,Center,16,Jump Shot,5.681957186544342
2014-15,201581,JJ Hickson,C,218,459,218,457,0,2,Center,5,Jump Shot,4.294117647058823
2015-16,201581,JJ Hickson,C,80,155,80,154,0,1,Center,5,Jump Shot,4.941935483870968
2015-16,1626266,JJ O'Brien,SF,0,1,0,1,0,0,Right Side,0,Turnaround Bank shot,9.0
2006-07,200755,JJ Redick,PG,80,195,42,97,38,98,Right Side Center,11,Jump Shot,20.005128205128205
2007-08,200755,JJ Redick,SG,48,108,31,65,17,43,Center,11,Jump Shot,17.203703703703702
2008-09,200755,JJ Redick,SG,117,299,50,120,67,179,Right Side Center,8,Jump Shot,20.210702341137125
2009-10,200755,JJ Redick,SG,243,553,132,279,111,274,Center,16,Jump Shot,18.0
2010-11,200755,JJ Redick,SG,197,447,110,228,87,219,Center,11,Jump Shot,17.65324384787472
2011-12,200755,JJ Redick,SG,248,584,136,316,112,268,Center,10,Jump Shot,17.919520547945204
2012-13,200755,JJ Redick,SG,382,880,217,429,165,451,Center,14,Jump Shot,18.401136363636365
2013-14,200755,JJ Redick,SG,181,398,108,213,73,185,Center,2,Jump Shot,18.394472361809044
2014-15,200755,JJ Redick,SG,447,938,247,480,200,458,Left Side Center,8,Jump Shot,19.017057569296377
2015-16,200755,JJ Redick,SG,419,872,222,459,197,413,Center,12,Jump Shot,19.386467889908257
2016-17,200755,JJ Redick,SG,389,882,195,422,194,460,Center,4,Jump Shot,19.736961451247165
2017-18,200755,JJ Redick,SG,404,879,211,419,193,460,Center,17,Jump Shot,20.13196814562002
2018-19,200755,JJ Redick,SG,452,1027,212,422,240,605,Center,12,Jump Shot,20.386562804284324
2019-20,200755,JJ Redick,SG,286,631,106,234,180,397,Center,11,Jump Shot,20.59904912836767
2020-21,200755,JJ Redick,SG,106,267,40,89,66,178,Right Side Center,3,Jump Shot,21.868913857677903
2004-05,2747,JR Smith,SG,295,748,214,467,81,281,Center,14,Jump Shot,15.21524064171123
2005-06,2747,JR Smith,SG,144,366,92,226,52,140,Center,6,Jump Shot,15.360655737704919
2006-07,2747,JR Smith,SG,284,644,135,262,149,382,Center,13,Jump Shot,17.279503105590063
2007-08,2747,JR Smith,SG,311,674,154,284,157,390,Center,18,Jump Shot,16.416913946587538
2008-09,2747,JR Smith,SG,424,950,244,497,180,453,Center,15,Jump Shot,17.29578947368421
2009-10,2747,JR Smith,SG,428,1033,270,566,158,467,Center,19,Jump Shot,16.90997095837367
2010-11,2747,JR Smith,SF,341,784,217,466,124,318,Center,20,Jump Shot,16.1390306122449
2011-12,2747,JR Smith,SG,165,405,98,212,67,193,Center,8,Jump Shot,17.958024691358023
2012-13,2747,JR Smith,SG,527,1249,372,813,155,436,Center,23,Jump Shot,15.899919935948759
2013-14,2747,JR Smith,SF,396,955,207,475,189,480,Center,17,Jump Shot,18.860732984293193
2014-15,2747,JR Smith,SG,315,755,152,329,163,426,Center,15,Jump Shot,19.388079470198676
2015-16,2747,JR Smith,SG,352,849,149,340,203,509,Center,16,Jump Shot,19.111896348645466
2016-17,2747,JR Smith,SG,123,355,28,85,95,270,Right Side Center,4,Jump Shot,21.571830985915494
2017-18,2747,JR Smith,SG,240,595,97,214,143,381,Center,4,Jump Shot,19.658823529411766
2018-19,2747,JR Smith,SG,27,79,15,40,12,39,Center,1,Jump Shot,19.88607594936709
2019-20,2747,JR Smith,SG,7,22,6,11,1,11,Center,0,Jump Shot,17.09090909090909
2021-22,1630550,JT Thor,PF,24,55,17,28,7,27,Center,6,Jump Shot,15.327272727272728
2022-23,1630550,JT Thor,PF,95,238,56,115,39,123,Center,9,Jump Shot,15.294117647058824
2019-20,1629630,Ja Morant,PG,447,937,387,758,60,179,Center,33,Driving Floating Jump Shot,9.034151547491996
2020-21,1629630,Ja Morant,PG,430,957,357,716,73,241,Center,19,Jump Shot,10.23092998955068
2021-22,1629630,Ja Morant,PG,580,1177,492,921,88,256,Center,24,Driving Floating Jump Shot,9.822429906542055
2022-23,1629630,Ja Morant,PG,566,1214,474,914,92,300,Center,20,Driving Floating Jump Shot,10.57660626029654
2011-12,202707,JaJuan Johnson,PF,54,121,54,121,0,0,Center,11,Jump Shot,10.264462809917354
2014-15,203960,JaKarr Sampson,SF,146,345,115,219,31,126,Center,12,Jump Shot,11.428985507246377
2015-16,203960,JaKarr Sampson,SF,140,316,126,254,14,62,Center,10,Jump Shot,7.94620253164557
2017-18,203960,JaKarr Sampson,SF,44,81,39,71,5,10,Center,0,Jump Shot,6.753086419753086
2018-19,203960,JaKarr Sampson,SF,29,54,24,40,5,14,Center,0,Jump Shot,10.75925925925926
2019-20,203960,JaKarr Sampson,PF,68,115,66,102,2,13,Center,1,Jump Shot,6.104347826086957
2020-21,203960,JaKarr Sampson,PF,56,113,53,98,3,15,Center,3,Jump Shot,6.31858407079646
2014-15,203210,JaMychal Green,PF,27,47,27,41,0,6,Center,6,Jump Shot,7.957446808510638
2015-16,203210,JaMychal Green,PF,230,495,215,450,15,45,Center,10,Jump Shot,8.165656565656565
2016-17,203210,JaMychal Green,PF,250,499,195,355,55,144,Center,4,Jump Shot,10.937875751503006
2017-18,203210,JaMychal Green,PF,223,488,180,361,43,127,Center,11,Jump Shot,10.504098360655737
2018-19,203210,JaMychal Green,PF,230,476,159,300,71,176,Center,3,Jump Shot,12.506302521008404
2019-20,203210,JaMychal Green,PF,151,352,59,114,92,238,Center,7,Jump Shot,17.87215909090909
2020-21,203210,JaMychal Green,PF,173,374,94,176,79,198,Center,2,Jump Shot,15.050802139037433
2021-22,203210,JaMychal Green,PF,159,327,126,203,33,124,Center,0,Jump Shot,11.691131498470948
2022-23,203210,JaMychal Green,PF,136,252,94,141,42,111,Center,0,Jump Shot,12.444444444444445
2021-22,1630605,JaQuori McLaughlin,PG,0,2,0,1,0,1,Left Side,0,Turnaround Fadeaway shot,21.5
2008-09,201580,JaVale McGee,C,191,387,191,387,0,0,Center,14,Jump Shot,3.9224806201550386
2009-10,201580,JaVale McGee,C,156,307,156,306,0,1,Center,14,Jump Shot,3.729641693811075
2010-11,201580,JaVale McGee,C,332,604,332,601,0,3,Center,10,Jump Shot,3.6804635761589406
2011-12,201580,JaVale McGee,C,307,552,307,552,0,0,Center,7,Jump Shot,3.625
2012-13,201580,JaVale McGee,C,303,527,302,526,1,1,Center,4,Jump Shot,3.444022770398482
2013-14,201580,JaVale McGee,C,17,38,17,38,0,0,Center,0,Jump Shot,5.052631578947368
2014-15,201580,JaVale McGee,C,42,79,42,79,0,0,Center,3,Jump Shot,4.139240506329114
2015-16,201580,JaVale McGee,C,77,134,77,133,0,1,Center,2,Alley Oop Dunk Shot,3.6044776119402986
2016-17,201580,JaVale McGee,C,208,319,208,316,0,3,Center,14,Alley Oop Dunk Shot,2.1253918495297808
2017-18,201580,JaVale McGee,C,136,219,136,213,0,6,Center,8,Jump Shot,4.52054794520548
2018-19,201580,JaVale McGee,C,400,641,399,629,1,12,Center,7,Hook Shot,3.499219968798752
2019-20,201580,JaVale McGee,C,195,306,192,300,3,6,Center,6,Alley Oop Dunk Shot,3.107843137254902
2020-21,201580,JaVale McGee,C,144,282,139,258,5,24,Center,2,Jump Shot,6.1453900709219855
2021-22,201580,JaVale McGee,C,288,458,286,449,2,9,Center,0,Tip Layup Shot,3.8253275109170306
2022-23,201580,JaVale McGee,C,80,125,78,120,2,5,Center,3,Alley Oop Layup shot,3.536
2017-18,1628444,Jabari Bird,SG,15,26,12,19,3,7,Center,2,Jump Shot,8.423076923076923
2014-15,203913,Jabari Brown,SG,70,170,47,108,23,62,Center,4,Jump Shot,14.08235294117647
2014-15,203953,Jabari Parker,PF,129,263,125,247,4,16,Center,5,Jump Shot,7.749049429657795
2015-16,203953,Jabari Parker,PF,443,899,434,864,9,35,Center,13,Jump Shot,7.727474972191324
2016-17,203953,Jabari Parker,PF,399,813,334,636,65,177,Center,15,Jump Shot,10.136531365313653
2017-18,203953,Jabari Parker,PF,160,332,129,251,31,81,Center,3,Jump Shot,11.759036144578314
2018-19,203953,Jabari Parker,PF,369,749,308,554,61,195,Center,17,Jump Shot,11.275033377837117
2019-20,203953,Jabari Parker,PF,219,429,187,310,32,119,Center,6,Jump Shot,9.967365967365968
2020-21,203953,Jabari Parker,PF,30,55,28,44,2,11,Center,2,Jump Shot,10.454545454545455
2021-22,203953,Jabari Parker,PF,18,38,10,22,8,16,Center,0,Jump Shot,16.105263157894736
2003-04,2074,Jabari Smith,C,26,70,26,67,0,3,Center,12,Jump Shot,12.614285714285714
2004-05,2074,Jabari Smith,PF,62,148,61,146,1,2,Center,3,Jump Shot,11.64864864864865
2022-23,1631095,Jabari Smith Jr.,PF,364,892,244,501,120,391,Center,12,Jump Shot,15.725336322869955
2022-23,1631133,Jabari Walker,SF,83,198,67,142,16,56,Center,10,Jump Shot,10.045454545454545
2014-15,204022,Jack Cooley,C,9,22,9,22,0,0,Center,3,Layup Shot,5.863636363636363
2017-18,204022,Jack Cooley,PF,13,27,13,27,0,0,Center,0,Layup Shot,4.666666666666667
2022-23,1631298,Jack White,SF,8,19,5,10,3,9,Center,4,Jump Shot,12.421052631578947
2004-05,2866,Jackie Butler,C,4,4,4,4,0,0,Center,4,Layup Shot,1.0
2005-06,2866,Jackie Butler,C,117,215,117,215,0,0,Center,11,Layup Shot,3.7255813953488373
2006-07,2866,Jackie Butler,C,16,35,16,35,0,0,Center,2,Jump Shot,5.9714285714285715
2004-05,2761,Jackson Vroman,C-PF,82,199,82,196,0,3,Center,10,Layup Shot,5.080402010050252
2005-06,2761,Jackson Vroman,PF,26,66,26,66,0,0,Center,4,Layup Shot,2.9696969696969697
2018-19,1628980,Jacob Evans,SG,18,53,14,38,4,15,Center,6,Jump Shot,15.547169811320755
2019-20,1628980,Jacob Evans,SG,45,134,32,95,13,39,Center,3,Jump Shot,15.723880597014926
2022-23,1631367,Jacob Gilyard,PG,1,3,0,0,1,3,Left Side Center,0,Jump Shot,23.666666666666668
2017-18,1626643,Jacob Pullen,PG,1,2,1,1,0,1,Left Side,0,Driving Floating Jump Shot,20.0
2017-18,1628451,Jacob Wiley,PF,1,4,0,2,1,2,Center,0,Jump Shot,16.25
2003-04,1521,Jacque Vaughn,PG,107,277,104,257,3,20,Left Side,3,Jump Shot,14.216606498194945
2004-05,1521,Jacque Vaughn,SG,146,325,141,310,5,15,Center,3,Jump Shot,12.618461538461538
2005-06,1521,Jacque Vaughn,SG,107,245,106,239,1,6,Center,5,Jump Shot,12.726530612244899
2006-07,1521,Jacque Vaughn,PG,71,167,70,165,1,2,Center,8,Jump Shot,12.023952095808383
2007-08,1521,Jacque Vaughn,PG,121,283,118,273,3,10,Center,5,Jump Shot,11.985865724381625
2008-09,1521,Jacque Vaughn,PG,24,75,23,74,1,1,Center,3,Jump Shot,11.213333333333333
2022-23,1630702,Jaden Hardy,SG,146,333,83,177,63,156,Center,9,Jump Shot,14.483483483483484
2022-23,1631093,Jaden Ivey,SG,409,983,289,633,120,350,Center,23,Pullup Jump shot,13.566632756866735
2020-21,1630183,Jaden McDaniels,PF,164,367,92,169,72,198,Center,11,Jump Shot,15.53133514986376
2021-22,1630183,Jaden McDaniels,PF,255,554,175,302,80,252,Center,4,Jump Shot,13.321299638989169
2022-23,1630183,Jaden McDaniels,SF,370,716,263,447,107,269,Center,10,Jump Shot,12.032122905027933
2021-22,1630531,Jaden Springer,SG,1,1,1,1,0,0,Center,1,Turnaround Jump Shot,9.0
2022-23,1630531,Jaden Springer,SG,17,35,15,30,2,5,Center,6,Driving Layup Shot,8.428571428571429
2012-13,203109,Jae Crowder,SF,141,367,78,175,63,192,Center,7,Jump Shot,17.38692098092643
2013-14,203109,Jae Crowder,SF,130,296,80,145,50,151,Center,13,Jump Shot,15.699324324324325
2014-15,203109,Jae Crowder,SF,229,544,168,337,61,207,Center,15,Jump Shot,14.590073529411764
2015-16,203109,Jae Crowder,SF,360,812,238,450,122,362,Center,21,Jump Shot,15.123152709359607
2016-17,203109,Jae Crowder,SF,333,720,176,326,157,394,Center,7,Jump Shot,17.45277777777778
2017-18,203109,Jae Crowder,SF,271,671,161,330,110,341,Center,5,Jump Shot,16.12369597615499
2018-19,203109,Jae Crowder,SF,318,797,145,275,173,522,Center,8,Jump Shot,18.19573400250941
2019-20,203109,Jae Crowder,SF-PF,226,563,91,169,135,394,Center,6,Jump Shot,18.99644760213144
2020-21,203109,Jae Crowder,PF,199,492,51,112,148,380,Center,7,Jump Shot,21.408536585365855
2021-22,203109,Jae Crowder,PF,217,544,90,179,127,365,Center,9,Jump Shot,20.279411764705884
2022-23,203109,Jae Crowder,SF,45,94,21,39,24,55,Center,2,Jump Shot,18.319148936170212
2020-21,1630256,Jae'Sean Tate,SF,316,625,256,430,60,195,Center,11,Jump Shot,9.7248
2021-22,1630256,Jae'Sean Tate,PF,363,729,300,527,63,202,Center,11,Jump Shot,8.76406035665295
2022-23,1630256,Jae'Sean Tate,SF,110,229,97,183,13,46,Center,1,Driving Layup Shot,8.039301310043669
2003-04,1751,Jahidi White,C,99,190,99,190,0,0,Center,0,Layup Shot,1.4789473684210526
2004-05,1751,Jahidi White,C,14,31,14,31,0,0,Center,0,Layup Shot,0.4838709677419355
2015-16,1626143,Jahlil Okafor,C,397,781,396,775,1,6,Center,4,Jump Shot,6.3047375160051216
2016-17,1626143,Jahlil Okafor,C,242,471,242,471,0,0,Center,4,Jump Shot,5.439490445859873
2017-18,1626143,Jahlil Okafor,C,77,138,76,134,1,4,Center,5,Layup Shot,5.2898550724637685
2018-19,1626143,Jahlil Okafor,C,212,362,211,357,1,5,Center,7,Layup Shot,4.124309392265193
2019-20,1626143,Jahlil Okafor,C,101,162,100,159,1,3,Center,1,Layup Shot,3.4012345679012346
2020-21,1626143,Jahlil Okafor,C,63,102,61,93,2,9,Center,0,Layup Shot,5.421568627450981
2020-21,1630186,Jahmi'us Ramsey,SG,15,38,10,19,5,19,Center,5,Jump Shot,14.763157894736842
2021-22,1630186,Jahmi'us Ramsey,SG,24,58,19,40,5,18,Center,9,Jump Shot,11.982758620689655
2022-23,1631222,Jake LaRavia,PF,37,95,13,24,24,71,Center,1,Jump Shot,19.557894736842105
2016-17,1627774,Jake Layman,SF,26,89,13,38,13,51,Center,6,Jump Shot,18.303370786516854
2017-18,1627774,Jake Layman,SF,14,47,10,27,4,20,Center,10,Jump Shot,15.212765957446809
2018-19,1627774,Jake Layman,SF,216,424,157,243,59,181,Center,7,Jump Shot,12.841981132075471
2019-20,1627774,Jake Layman,SF,81,179,57,107,24,72,Center,3,Jump Shot,12.798882681564246
2020-21,1627774,Jake Layman,SF,91,184,68,106,23,78,Center,3,Jump Shot,12.179347826086957
2021-22,1627774,Jake Layman,SF,30,73,22,38,8,35,Center,12,Jump Shot,13.972602739726028
2003-04,2054,Jake Tsakalidis,C,67,133,67,133,0,0,Center,1,Jump Shot,5.473684210526316
2004-05,2054,Jake Tsakalidis,C,32,64,32,64,0,0,Center,6,Layup Shot,5.78125
2005-06,2054,Jake Tsakalidis,C,100,165,100,165,0,0,Center,0,Layup Shot,2.987878787878788
2006-07,2054,Jake Tsakalidis,C,29,72,29,72,0,0,Center,0,Layup Shot,3.8472222222222223
2003-04,2063,Jake Voskuhl,C,152,300,152,300,0,0,Center,7,Layup Shot,4.1433333333333335
2004-05,2063,Jake Voskuhl,C,27,59,27,59,0,0,Center,3,Layup Shot,6.288135593220339
2005-06,2063,Jake Voskuhl,C,114,261,113,258,1,3,Center,3,Jump Shot,12.134099616858238
2006-07,2063,Jake Voskuhl,C,121,255,121,255,0,0,Center,4,Jump Shot,8.458823529411765
2007-08,2063,Jake Voskuhl,C,37,80,37,80,0,0,Center,2,Jump Shot,6.225
2008-09,2063,Jake Voskuhl,C,12,45,12,45,0,0,Center,0,Jump Shot,10.466666666666667
2016-17,1627751,Jakob Poeltl,C,67,115,67,115,0,0,Center,7,Layup Shot,2.1565217391304348
2017-18,1627751,Jakob Poeltl,C,253,384,252,382,1,2,Center,4,Layup Shot,2.4453125
2018-19,1627751,Jakob Poeltl,C,187,290,187,290,0,0,Center,9,Layup Shot,2.43448275862069
2019-20,1627751,Jakob Poeltl,C,166,266,166,266,0,0,Center,0,Layup Shot,2.906015037593985
2020-21,1627751,Jakob Poeltl,C,265,430,265,430,0,0,Center,1,Floating Jump shot,3.255813953488372
2021-22,1627751,Jakob Poeltl,C,410,663,409,662,1,1,Center,9,Floating Jump shot,4.291101055806938
2022-23,1627751,Jakob Poeltl,C,389,618,389,617,0,1,Center,7,Floating Jump shot,4.333333333333333
2018-19,1628973,Jalen Brunson,PG,264,565,201,384,63,181,Center,12,Jump Shot,12.794690265486725
2019-20,1628973,Jalen Brunson,PG,181,388,138,268,43,120,Center,8,Jump Shot,13.152061855670103
2020-21,1628973,Jalen Brunson,PG,328,627,247,427,81,200,Center,12,Jump Shot,12.763955342902712
2021-22,1628973,Jalen Brunson,SG,506,1008,412,756,94,252,Center,12,Pullup Jump shot,12.58234126984127
2022-23,1628973,Jalen Brunson,PG,587,1195,453,873,134,322,Center,27,Pullup Jump shot,12.421757322175733
2022-23,1631105,Jalen Duren,C,258,398,258,396,0,2,Center,14,Layup Shot,2.821608040201005
2021-22,1630224,Jalen Green,SG,406,954,249,496,157,458,Center,18,Jump Shot,15.157232704402515
2022-23,1630224,Jalen Green,SG,566,1359,379,805,187,554,Center,18,Pullup Jump shot,14.68064753495217
2020-21,1630223,Jalen Harris,SG,36,72,19,36,17,36,Center,2,Jump Shot,15.305555555555555
2021-22,1630552,Jalen Johnson,PF,22,41,19,28,3,13,Center,8,Jump Shot,10.365853658536585
2022-23,1630552,Jalen Johnson,SF,158,322,128,218,30,104,Center,7,Jump Shot,10.79192546583851
2017-18,1627883,Jalen Jones,SF,26,68,16,42,10,26,Center,3,Jump Shot,11.735294117647058
2018-19,1627883,Jalen Jones,SF,26,62,16,34,10,28,Center,2,Jump Shot,14.274193548387096
2019-20,1629665,Jalen Lecque,SG,4,10,4,6,0,4,Center,2,Jump Shot,12.9
2020-21,1629665,Jalen Lecque,PG,1,9,1,8,0,1,Center,1,Driving Layup Shot,9.777777777777779
2019-20,1629667,Jalen McDaniels,SF,33,70,24,46,9,24,Center,2,Jump Shot,11.157142857142857
2020-21,1629667,Jalen McDaniels,SF,133,284,98,179,35,105,Center,7,Jump Shot,11.109154929577464
2021-22,1629667,Jalen McDaniels,SF,123,254,82,146,41,108,Center,3,Jump Shot,12.88976377952756
2022-23,1629667,Jalen McDaniels,SF,281,617,204,385,77,232,Center,8,Jump Shot,11.909238249594814
2003-04,147,Jalen Rose,PG-SF,383,952,314,750,69,202,Center,27,Jump Shot,13.713235294117647
2004-05,147,Jalen Rose,SF,527,1159,419,885,108,274,Center,26,Jump Shot,13.607420189818809
2005-06,147,Jalen Rose,SF-SG,290,685,231,513,59,172,Center,9,Jump Shot,13.397080291970802
2006-07,147,Jalen Rose,SF,38,86,17,39,21,47,Right Side Center,10,Jump Shot,20.023255813953487
2020-21,1630188,Jalen Smith,PF,22,50,18,33,4,17,Center,8,Jump Shot,10.58
2021-22,1630188,Jalen Smith,PF,176,350,136,228,40,122,Center,8,Jump Shot,11.96
2022-23,1630188,Jalen Smith,PF,242,508,188,317,54,191,Center,7,Jump Shot,12.01771653543307
2021-22,1630591,Jalen Suggs,PG,198,548,156,352,42,196,Center,7,Jump Shot,12.835766423357665
2022-23,1630591,Jalen Suggs,PG,186,444,120,242,66,202,Center,7,Jump Shot,15.326576576576576
2022-23,1631114,Jalen Williams,SG,414,794,341,589,73,205,Center,32,Jump Shot,9.964735516372796
2013-14,203479,Jamaal Franklin,SG,16,39,11,28,5,11,Center,5,Jump Shot,13.794871794871796
2014-15,203479,Jamaal Franklin,SG,1,2,0,0,1,2,Center,0,Pullup Jump shot,26.0
2003-04,2048,Jamaal Magloire,C,383,809,383,808,0,1,Center,11,Layup Shot,4.3250927070457355
2004-05,2048,Jamaal Magloire,C,98,227,98,227,0,0,Center,5,Layup Shot,4.854625550660793
2005-06,2048,Jamaal Magloire,C,287,615,287,615,0,0,Center,6,Hook Shot,3.6796747967479675
2006-07,2048,Jamaal Magloire,C,199,395,199,395,0,0,Center,3,Layup Shot,3.1012658227848102
2007-08,2048,Jamaal Magloire,C,18,55,18,55,0,0,Center,2,Layup Shot,4.218181818181818
2008-09,2048,Jamaal Magloire,C,65,131,65,131,0,0,Center,0,Layup Shot,2.50381679389313
2009-10,2048,Jamaal Magloire,C,28,56,28,56,0,0,Center,5,Layup Shot,2.1607142857142856
2010-11,2048,Jamaal Magloire,C,13,22,13,22,0,0,Center,5,Layup Shot,2.4545454545454546
2011-12,2048,Jamaal Magloire,C,17,45,17,45,0,0,Center,0,Layup Shot,2.511111111111111
2003-04,2224,Jamaal Tinsley,PG,153,370,76,163,77,207,Center,4,Jump Shot,17.002702702702702
2004-05,2224,Jamaal Tinsley,PG,218,522,160,366,58,156,Center,7,Jump Shot,12.375478927203066
2005-06,2224,Jamaal Tinsley,PG,158,386,142,316,16,70,Center,4,Jump Shot,11.577720207253886
2006-07,2224,Jamaal Tinsley,PG,346,889,285,696,61,193,Center,23,Jump Shot,12.686164229471316
2007-08,2224,Jamaal Tinsley,PG,176,463,136,322,40,141,Center,10,Jump Shot,14.453563714902808
2009-10,2224,Jamaal Tinsley,PG,52,140,45,101,7,39,Center,2,Jump Shot,13.557142857142857
2011-12,2224,Jamaal Tinsley,PG,57,141,47,104,10,37,Center,1,Jump Shot,14.574468085106384
2012-13,2224,Jamaal Tinsley,PG,86,234,47,107,39,127,Center,3,Jump Shot,17.65811965811966
2013-14,2224,Jamaal Tinsley,PG,4,20,3,5,1,15,Center,0,Jump Shot,20.1
2022-23,1631288,Jamal Cain,SF,37,66,30,46,7,20,Center,4,Jump Shot,10.075757575757576
2003-04,2037,Jamal Crawford,SG,509,1318,344,797,165,521,Center,25,Jump Shot,17.020485584218513
2004-05,2037,Jamal Crawford,SG,437,1097,252,585,185,512,Center,18,Jump Shot,17.456700091157703
2005-06,2037,Jamal Crawford,SG,366,879,265,586,101,293,Center,32,Jump Shot,14.773606370875996
2006-07,2037,Jamal Crawford,SG,354,886,251,564,103,322,Center,25,Jump Shot,14.858916478555305
2007-08,2037,Jamal Crawford,SG,570,1391,394,897,176,494,Center,22,Jump Shot,16.177570093457945
2008-09,2037,Jamal Crawford,PG-SG,419,1021,277,628,142,393,Center,16,Jump Shot,16.854064642507346
2009-10,2037,Jamal Crawford,SG,496,1105,333,678,163,427,Center,26,Jump Shot,16.257918552036198
2010-11,2037,Jamal Crawford,SG,368,874,249,525,119,349,Center,19,Jump Shot,16.72425629290618
2011-12,2037,Jamal Crawford,PG,283,737,203,477,80,260,Center,21,Jump Shot,16.274084124830395
2012-13,2037,Jamal Crawford,SG,445,1015,296,620,149,395,Center,14,Jump Shot,16.910344827586208
2013-14,2037,Jamal Crawford,SG,420,1008,260,565,160,443,Center,18,Jump Shot,17.48015873015873
2014-15,2037,Jamal Crawford,SG,332,839,213,475,119,364,Center,18,Jump Shot,18.087008343265794
2015-16,2037,Jamal Crawford,SG,378,935,262,595,116,340,Center,9,Jump Shot,16.745454545454546
2016-17,2037,Jamal Crawford,SG,358,867,243,548,115,319,Center,19,Jump Shot,17.24336793540946
2017-18,2037,Jamal Crawford,SG,308,742,204,428,104,314,Center,7,Jump Shot,18.816711590296496
2018-19,2037,Jamal Crawford,SG,174,438,107,236,67,202,Center,11,Pullup Jump shot,19.166666666666668
2019-20,2037,Jamal Crawford,SG,2,4,1,2,1,2,Right Side Center,0,Pullup Jump shot,23.75
2003-04,469,Jamal Mashburn,SF,156,398,137,331,19,67,Center,5,Jump Shot,13.889447236180905
2016-17,1627750,Jamal Murray,SG,295,728,180,386,115,342,Center,18,Jump Shot,15.986263736263735
2017-18,1627750,Jamal Murray,PG,479,1062,314,626,165,436,Center,26,Jump Shot,15.059322033898304
2018-19,1627750,Jamal Murray,PG,513,1173,361,759,152,414,Center,24,Jump Shot,14.595907928388748
2019-20,1627750,Jamal Murray,PG,408,894,296,570,112,324,Center,22,Jump Shot,15.0413870246085
2020-21,1627750,Jamal Murray,PG,378,792,249,476,129,316,Center,20,Jump Shot,16.36111111111111
2022-23,1627750,Jamal Murray,PG,473,1041,301,609,172,432,Center,12,Jump Shot,16.00384245917387
2003-04,2441,Jamal Sampson,C,11,23,11,23,0,0,Center,1,Jump Shot,5.869565217391305
2004-05,2441,Jamal Sampson,PF,28,62,28,62,0,0,Center,1,Jump Shot,7.209677419354839
2005-06,2441,Jamal Sampson,PF,5,7,5,7,0,0,Center,3,Turnaround Jump Shot,4.285714285714286
2006-07,2441,Jamal Sampson,C,9,14,9,13,0,1,Center,1,Dunk Shot,5.714285714285714
2022-23,1631123,Jamaree Bouyea,PG,6,14,4,8,2,6,Center,0,Jump Shot,14.142857142857142
2007-08,200081,Jamario Moon,SF,279,575,239,453,40,122,Center,11,Jump Shot,13.205217391304348
2008-09,200081,Jamario Moon,SF,222,474,157,291,65,183,Center,4,Jump Shot,16.09493670886076
2009-10,200081,Jamario Moon,SF,114,247,82,147,32,100,Center,3,Jump Shot,15.02834008097166
2010-11,200081,Jamario Moon,SF,101,248,63,125,38,123,Center,5,Jump Shot,17.443548387096776
2011-12,200081,Jamario Moon,SF,7,24,5,14,2,10,Center,2,Jump Shot,18.375
2017-18,1627866,Jameel Warney,PF,7,12,7,12,0,0,Center,0,Putback Layup Shot,5.583333333333333
2004-05,2749,Jameer Nelson,PG,286,628,242,487,44,141,Center,6,Jump Shot,13.872611464968152
2005-06,2749,Jameer Nelson,PG,347,719,277,554,70,165,Center,30,Jump Shot,13.873435326842838
2006-07,2749,Jameer Nelson,PG,376,875,311,681,65,194,Center,25,Jump Shot,13.097142857142858
2007-08,2749,Jameer Nelson,PG,283,603,219,449,64,154,Center,14,Jump Shot,12.837479270315091
2008-09,2749,Jameer Nelson,PG,267,531,185,350,82,181,Center,15,Jump Shot,15.141242937853107
2009-10,2749,Jameer Nelson,PG,317,706,231,480,86,226,Center,19,Jump Shot,14.225212464589235
2010-11,2749,Jameer Nelson,PG,374,838,255,541,119,297,Center,27,Jump Shot,15.145584725536994
2011-12,2749,Jameer Nelson,PG,259,606,172,375,87,231,Center,16,Jump Shot,14.57920792079208
2012-13,2749,Jameer Nelson,PG,306,780,185,425,121,355,Center,9,Jump Shot,16.05897435897436
2013-14,2749,Jameer Nelson,PG,293,746,158,356,135,390,Center,13,Jump Shot,17.092493297587133
2014-15,2749,Jameer Nelson,PG,205,504,116,246,89,258,Center,9,Jump Shot,17.761904761904763
2015-16,2749,Jameer Nelson,PG,113,307,70,163,43,144,Center,8,Jump Shot,17.309446254071663
2016-17,2749,Jameer Nelson,PG,268,603,162,331,106,272,Center,13,Jump Shot,16.59038142620232
2017-18,2749,Jameer Nelson,PG,95,244,54,120,41,124,Center,3,Jump Shot,18.508196721311474
2017-18,1628503,Jamel Artis,SG,31,79,23,50,8,29,Center,1,Jump Shot,14.60759493670886
2010-11,202341,James Anderson,SF,31,81,13,35,18,46,Center,6,Jump Shot,17.382716049382715
2011-12,202341,James Anderson,SG,66,174,47,106,19,68,Center,9,Jump Shot,13.545977011494253
2012-13,202341,James Anderson,SG-SF,52,126,31,66,21,60,Center,9,Jump Shot,15.063492063492063
2013-14,202341,James Anderson,SG,309,716,194,366,115,350,Center,16,Jump Shot,14.578212290502794
2015-16,202341,James Anderson,SG,67,178,44,92,23,86,Center,4,Jump Shot,14.831460674157304
2006-07,200788,James Augustine,PF,1,3,1,3,0,0,Center,0,Layup Shot,0.0
2007-08,200788,James Augustine,PF,18,34,18,34,0,0,Center,5,Layup Shot,4.676470588235294
2021-22,1630547,James Bouknight,SG,49,141,32,92,17,49,Center,7,Jump Shot,11.51063829787234
2022-23,1630547,James Bouknight,SG,69,193,36,84,33,109,Center,4,Jump Shot,17.4559585492228
2014-15,203516,James Ennis III,SF,101,247,70,152,31,95,Center,6,Jump Shot,12.692307692307692
2015-16,203516,James Ennis III,SF,54,112,28,55,26,57,Center,5,Jump Shot,14.232142857142858
2016-17,203516,James Ennis III,SF,145,320,95,184,50,136,Center,3,Jump Shot,12.60625
2017-18,203516,James Ennis III,SF,182,384,131,231,51,153,Center,5,Jump Shot,12.721354166666666
2018-19,203516,James Ennis III,SF,138,294,83,138,55,156,Center,3,Jump Shot,13.768707482993197
2019-20,203516,James Ennis III,SF-SG,160,359,105,190,55,169,Center,6,Jump Shot,13.534818941504179
2020-21,203516,James Ennis III,SF,115,243,70,139,45,104,Center,3,Jump Shot,13.382716049382717
2021-22,203516,James Ennis III,SF,11,24,8,16,3,8,Center,3,Jump Shot,10.125
2009-10,201935,James Harden,SG,233,578,140,330,93,248,Center,12,Jump Shot,14.406574394463668
2010-11,201935,James Harden,SG,298,684,185,360,113,324,Center,10,Jump Shot,14.915204678362572
2011-12,201935,James Harden,SG,309,629,195,337,114,292,Center,3,Jump Shot,13.839427662957075
2012-13,201935,James Harden,SG,585,1337,406,851,179,486,Center,24,Jump Shot,13.213163799551234
2013-14,201935,James Harden,SG,549,1205,372,722,177,483,Center,25,Jump Shot,14.262240663900416
2014-15,201935,James Harden,SG,647,1470,439,915,208,555,Center,34,Jump Shot,13.50952380952381
2015-16,201935,James Harden,SG,710,1617,474,960,236,657,Center,28,Jump Shot,14.418058132343846
2016-17,201935,James Harden,PG,674,1531,412,777,262,754,Center,26,Jump Shot,15.411495754408882
2017-18,201935,James Harden,SG,651,1449,386,727,265,722,Center,28,Jump Shot,15.296066252587991
2018-19,201935,James Harden,PG,843,1909,465,881,378,1028,Center,39,Step Back Jump shot,15.859612362493452
2019-20,201935,James Harden,SG,672,1514,373,671,299,843,Center,17,Step Back Jump shot,16.085204755614267
2020-21,201935,James Harden,PG-SG,342,734,221,400,121,334,Center,13,Step Back Jump shot,14.024523160762943
2021-22,201935,James Harden,PG,407,992,259,544,148,448,Center,10,Step Back Jump shot,14.151209677419354
2022-23,201935,James Harden,PG,371,842,210,424,161,418,Center,13,Step Back Jump shot,16.1353919239905
2009-10,201949,James Johnson,PF,95,210,80,164,15,46,Center,9,Jump Shot,9.976190476190476
2010-11,201949,James Johnson,SF,108,237,100,203,8,34,Center,3,Jump Shot,9.713080168776372
2011-12,201949,James Johnson,SF,233,518,214,458,19,60,Center,10,Jump Shot,9.5984555984556
2012-13,201949,James Johnson,SF,117,283,115,262,2,21,Center,4,Jump Shot,8.837455830388693
2013-14,201949,James Johnson,SF,143,308,121,221,22,87,Center,6,Jump Shot,9.902597402597403
2014-15,201949,James Johnson,PF,238,404,227,353,11,51,Center,5,Jump Shot,6.341584158415841
2015-16,201949,James Johnson,PF,114,240,94,174,20,66,Center,1,Jump Shot,9.325
2016-17,201949,James Johnson,PF,368,768,281,513,87,255,Center,15,Jump Shot,12.009114583333334
2017-18,201949,James Johnson,PF,309,614,252,429,57,185,Center,15,Jump Shot,10.855048859934854
2018-19,201949,James Johnson,PF,164,379,114,230,50,149,Center,5,Jump Shot,12.74934036939314
2019-20,201949,James Johnson,PF-C,103,215,70,124,33,91,Center,6,Jump Shot,12.655813953488373
2020-21,201949,James Johnson,PF,146,327,115,207,31,120,Center,0,Jump Shot,11.256880733944953
2021-22,201949,James Johnson,PF,144,307,121,222,23,85,Center,4,Jump Shot,8.938110749185668
2022-23,201949,James Johnson,PF,22,49,19,34,3,15,Center,2,Jump Shot,10.918367346938776
2003-04,2592,James Jones,SF,2,9,1,5,1,4,Right Side Center,1,Jump Shot,21.11111111111111
2004-05,2592,James Jones,SF,126,318,60,152,66,166,Center,12,Jump Shot,18.79559748427673
2005-06,2592,James Jones,SF,243,581,133,296,110,285,Right Side Center,4,Jump Shot,19.924268502581757
2006-07,2592,James Jones,SF,162,440,72,202,90,238,Right Side Center,6,Jump Shot,20.575
2007-08,2592,James Jones,SF,143,327,52,122,91,205,Left Side,8,Jump Shot,19.761467889908257
2008-09,2592,James Jones,SF,55,148,22,53,33,95,Right Side,4,Jump Shot,21.2027027027027
2009-10,2592,James Jones,SF,43,119,6,29,37,90,Right Side,4,Jump Shot,22.07563025210084
2010-11,2592,James Jones,SF,146,346,23,59,123,287,Right Side,9,Jump Shot,22.985549132947977
2011-12,2592,James Jones,SG,57,150,11,36,46,114,Right Side Center,7,Jump Shot,22.393333333333334
2012-13,2592,James Jones,SF,21,61,5,8,16,53,Left Side Center,7,Jump Shot,23.0
2013-14,2592,James Jones,SF,31,68,3,14,28,54,Right Side,3,Jump Shot,21.5
2014-15,2592,James Jones,SF,74,201,11,26,63,175,Right Side Center,8,Jump Shot,23.00497512437811
2015-16,2592,James Jones,SF,58,142,17,38,41,104,Right Side Center,7,Jump Shot,21.654929577464788
2016-17,2592,James Jones,SF,44,92,13,26,31,66,Right Side Center,11,Jump Shot,20.847826086956523
2006-07,2591,James Lang,C,4,9,4,9,0,0,Center,0,Layup Shot,2.111111111111111
2014-15,203949,James Michael McAdoo,PF,24,44,24,44,0,0,Center,8,Jump Shot,2.227272727272727
2015-16,203949,James Michael McAdoo,PF,45,84,44,82,1,2,Center,7,Layup Shot,3.7857142857142856
2016-17,203949,James Michael McAdoo,PF,62,117,60,109,2,8,Center,4,Jump Shot,5.410256410256411
2017-18,203949,James Michael McAdoo,PF,2,7,0,0,2,7,Left Side Center,0,Jump Shot,24.857142857142858
2013-14,203263,James Nunnally,SF,15,46,7,21,8,25,Center,3,Jump Shot,17.391304347826086
2018-19,203263,James Nunnally,SF,12,34,4,9,8,25,Center,1,Jump Shot,19.352941176470587
2020-21,203263,James Nunnally,SF,5,13,1,1,4,12,Left Side,2,Jump Shot,23.384615384615383
2003-04,1899,James Posey,SG,368,770,256,480,112,290,Center,16,Jump Shot,12.124675324675325
2004-05,1899,James Posey,SF,127,356,72,178,55,178,Center,5,Jump Shot,14.634831460674157
2005-06,1899,James Posey,SF,159,395,42,105,117,290,Center,1,Jump Shot,19.253164556962027
2006-07,1899,James Posey,SF,186,432,89,173,97,259,Center,8,Jump Shot,16.391203703703702
2007-08,1899,James Posey,PF,173,414,67,135,106,279,Center,10,Jump Shot,17.905797101449274
2008-09,1899,James Posey,SG,215,523,100,210,115,313,Center,11,Jump Shot,16.90057361376673
2009-10,1899,James Posey,SF,126,345,45,103,81,242,Center,4,Jump Shot,18.530434782608694
2010-11,1899,James Posey,SF,81,241,14,29,67,212,Left Side Center,6,Jump Shot,22.556016597510375
2005-06,101189,James Singleton,SF,77,151,67,131,10,20,Center,10,Jump Shot,9.52980132450331
2006-07,101189,James Singleton,PF,30,82,27,68,3,14,Center,6,Jump Shot,12.060975609756097
2008-09,101189,James Singleton,PF,117,221,104,181,13,40,Center,9,Jump Shot,9.149321266968325
2009-10,101189,James Singleton,PF-SF,97,254,90,217,7,37,Center,5,Jump Shot,11.61023622047244
2011-12,101189,James Singleton,PF,41,75,39,66,2,9,Center,4,Jump Shot,11.16
2013-14,203480,James Southerland,SF,5,15,2,9,3,6,Right Side,0,Jump Shot,18.866666666666667
2004-05,2839,James Thomas,PF,12,20,12,20,0,0,Center,0,Layup Shot,1.75
2005-06,2839,James Thomas,PF,10,19,10,19,0,0,Center,2,Layup Shot,0.6842105263157895
2017-18,1627821,James Webb III,SF,6,24,2,5,4,19,Left Side,1,Jump Shot,19.708333333333332
2006-07,200778,James White,SG,18,41,16,34,2,7,Center,1,Jump Shot,10.121951219512194
2008-09,200778,James White,SF,3,5,2,3,1,2,Right Side,2,Jump Shot,16.8
2012-13,200778,James White,SF,50,116,36,75,14,41,Center,5,Jump Shot,13.931034482758621
2020-21,1630164,James Wiseman,C,191,368,179,330,12,38,Center,7,Jump Shot,8.565217391304348
2022-23,1630164,James Wiseman,C,189,339,185,319,4,20,Center,13,Jump Shot,6.1415929203539825
2014-15,203923,James Young,SG,36,102,19,36,17,66,Left Side Center,4,Jump Shot,19.745098039215687
2015-16,203923,James Young,SG,11,36,5,10,6,26,Right Side,4,Jump Shot,20.13888888888889
2016-17,203923,James Young,SG,24,57,13,23,11,34,Center,3,Jump Shot,17.473684210526315
2017-18,203923,James Young,SG,5,14,2,4,3,10,Center,1,Jump Shot,19.642857142857142
2017-18,203966,Jamil Wilson,SF,38,81,11,18,27,63,Center,3,Jump Shot,21.444444444444443
2003-04,2249,Jamison Brewer,PG,13,35,8,21,5,14,Center,2,Jump Shot,15.885714285714286
2004-05,2249,Jamison Brewer,PG,11,37,8,22,3,15,Center,0,Jump Shot,13.054054054054054
2021-22,1630691,Jamorko Pickett,PF,18,50,5,11,13,39,Left Side Center,0,Jump Shot,20.64
2011-12,202686,Jan Vesely,PF,117,218,117,217,0,1,Center,3,Jump Shot,3.8440366972477062
2012-13,202686,Jan Vesely,PF,57,114,57,113,0,1,Center,3,Jump Shot,5.192982456140351
2013-14,202686,Jan Vesely,PF,89,173,89,173,0,0,Center,5,Layup Shot,3.4739884393063583
2003-04,2457,Jannero Pargo,PG,81,199,59,137,22,62,Center,5,Jump Shot,17.814070351758794
2004-05,2457,Jannero Pargo,PG,82,213,59,147,23,66,Center,7,Jump Shot,18.154929577464788
2005-06,2457,Jannero Pargo,PG,109,292,70,189,39,103,Center,6,Jump Shot,18.886986301369863
2006-07,2457,Jannero Pargo,PG,283,692,202,483,81,209,Center,19,Jump Shot,16.137283236994218
2007-08,2457,Jannero Pargo,SG,254,652,189,466,65,186,Center,19,Jump Shot,16.411042944785276
2009-10,2457,Jannero Pargo,PG,132,381,94,243,38,138,Center,14,Jump Shot,17.482939632545932
2011-12,2457,Jannero Pargo,PG,105,253,52,115,53,138,Center,7,Jump Shot,20.102766798418973
2012-13,2457,Jannero Pargo,PG,78,212,39,96,39,116,Left Side Center,1,Jump Shot,20.56132075471698
2013-14,2457,Jannero Pargo,PG,52,118,28,58,24,60,Right Side Center,12,Jump Shot,20.6864406779661
2014-15,2457,Jannero Pargo,PG,15,35,6,13,9,22,Right Side Center,2,Jump Shot,23.114285714285714
2021-22,1630215,Jared Butler,SG,61,151,33,63,28,88,Center,9,Jump Shot,17.94701986754967
2022-23,1630215,Jared Butler,SG,15,32,8,18,7,14,Center,1,Jump Shot,13.96875
2012-13,203099,Jared Cunningham,SG,6,14,4,11,2,3,Center,4,Jump Shot,10.928571428571429
2013-14,203099,Jared Cunningham,SG,6,21,5,14,1,7,Center,1,Jump Shot,14.952380952380953
2014-15,203099,Jared Cunningham,SG,12,33,8,20,4,13,Center,7,Jump Shot,13.848484848484848
2015-16,203099,Jared Cunningham,SG,36,105,24,66,12,39,Center,6,Jump Shot,12.466666666666667
2007-08,201162,Jared Dudley,PF,163,348,154,307,9,41,Center,9,Jump Shot,11.218390804597702
2008-09,201162,Jared Dudley,SF,136,285,107,211,29,74,Center,4,Jump Shot,12.971929824561403
2009-10,201162,Jared Dudley,SF,225,490,105,228,120,262,Center,2,Jump Shot,15.53265306122449
2010-11,201162,Jared Dudley,SF,300,629,195,376,105,253,Center,10,Jump Shot,14.756756756756756
2011-12,201162,Jared Dudley,SG,312,643,232,434,80,209,Center,12,Jump Shot,14.433903576982893
2012-13,201162,Jared Dudley,SF,313,669,207,398,106,271,Center,11,Jump Shot,15.904334828101645
2013-14,201162,Jared Dudley,SF,196,446,115,222,81,224,Right Side Center,2,Jump Shot,18.524663677130047
2014-15,201162,Jared Dudley,SG,198,423,124,231,74,192,Center,6,Jump Shot,16.81323877068558
2015-16,201162,Jared Dudley,PF,233,487,133,249,100,238,Right Side Center,9,Jump Shot,18.679671457905545
2016-17,201162,Jared Dudley,PF,157,345,80,143,77,202,Center,2,Jump Shot,18.80289855072464
2017-18,201162,Jared Dudley,PF,48,122,19,42,29,80,Center,0,Jump Shot,18.737704918032787
2018-19,201162,Jared Dudley,PF,101,239,48,88,53,151,Center,4,Jump Shot,17.698744769874477
2019-20,201162,Jared Dudley,PF,24,60,6,18,18,42,Center,1,Jump Shot,19.016666666666666
2020-21,201162,Jared Dudley,PF,2,9,0,3,2,6,Center,1,Jump Shot,21.0
2019-20,1629607,Jared Harper,PG,1,4,1,2,0,2,Center,1,Jump Shot,15.5
2020-21,1629607,Jared Harper,PG,0,4,0,3,0,1,Center,0,Driving Floating Jump Shot,12.0
2021-22,1629607,Jared Harper,PG,14,26,9,14,5,12,Center,4,Jump Shot,16.26923076923077
2003-04,2407,Jared Jeffries,PF,178,470,172,439,6,31,Center,10,Jump Shot,7.885106382978724
2004-05,2407,Jared Jeffries,SF,203,434,187,383,16,51,Center,7,Jump Shot,6.423963133640553
2005-06,2407,Jared Jeffries,PF,187,415,171,365,16,50,Center,5,Jump Shot,8.26265060240964
2006-07,2407,Jared Jeffries,SF,95,206,93,186,2,20,Center,0,Jump Shot,7.733009708737864
2007-08,2407,Jared Jeffries,SF,108,270,104,245,4,25,Center,1,Jump Shot,7.92962962962963
2008-09,2407,Jared Jeffries,SF,120,273,119,261,1,12,Center,2,Jump Shot,6.791208791208791
2009-10,2407,Jared Jeffries,PF-SF,138,314,117,243,21,71,Center,5,Jump Shot,8.585987261146498
2010-11,2407,Jared Jeffries,PF,30,86,28,77,2,9,Center,2,Jump Shot,6.906976744186046
2011-12,2407,Jared Jeffries,PF,59,144,56,128,3,16,Center,1,Jump Shot,7.326388888888889
2012-13,2407,Jared Jeffries,PF,16,54,16,52,0,2,Center,1,Jump Shot,8.74074074074074
2004-05,2876,Jared Reiner,C,10,30,10,30,0,0,Center,3,Jump Shot,9.1
2006-07,2876,Jared Reiner,C,15,43,15,43,0,0,Center,0,Layup Shot,4.069767441860465
2022-23,1631197,Jared Rhoden,SG,17,44,12,24,5,20,Center,1,Jump Shot,14.386363636363637
2012-13,203096,Jared Sullinger,PF,111,225,110,220,1,5,Center,5,Jump Shot,7.155555555555556
2013-14,203096,Jared Sullinger,PF,384,899,328,691,56,208,Center,18,Jump Shot,10.880978865406007
2014-15,203096,Jared Sullinger,PF,311,708,259,524,52,184,Center,16,Jump Shot,11.88135593220339
2015-16,203096,Jared Sullinger,PF,351,806,322,703,29,103,Center,11,Jump Shot,11.290322580645162
2016-17,203096,Jared Sullinger,PF,15,47,12,29,3,18,Center,0,Jump Shot,14.680851063829786
2018-19,1629123,Jared Terrell,SG,12,39,8,22,4,17,Center,3,Jump Shot,16.58974358974359
2015-16,204067,Jarell Eddie,SF,20,65,5,18,15,47,Right Side Center,7,Jump Shot,22.06153846153846
2016-17,204067,Jarell Eddie,SF,6,19,2,3,4,16,Center,1,Jump Shot,21.42105263157895
2017-18,204067,Jarell Eddie,SF,0,2,0,0,0,2,Right Side Center,0,Running Jump Shot,25.0
2015-16,1626185,Jarell Martin,PF,54,116,54,114,0,2,Center,2,Jump Shot,7.7844827586206895
2016-17,1626185,Jarell Martin,PF,58,151,49,126,9,25,Center,3,Jump Shot,9.092715231788079
2017-18,1626185,Jarell Martin,PF,221,496,187,398,34,98,Center,10,Jump Shot,10.788306451612904
2018-19,1626185,Jarell Martin,PF,43,104,23,47,20,57,Center,5,Jump Shot,17.923076923076923
2018-19,1628991,Jaren Jackson Jr.,PF,298,589,247,447,51,142,Center,16,Jump Shot,9.390492359932088
2019-20,1628991,Jaren Jackson Jr.,C,353,753,208,385,145,368,Center,7,Jump Shot,14.401062416998672
2020-21,1628991,Jaren Jackson Jr.,C,53,125,36,65,17,60,Center,1,Jump Shot,14.168
2021-22,1628991,Jaren Jackson Jr.,PF,430,1036,302,635,128,401,Center,12,Jump Shot,12.582046332046332
2022-23,1628991,Jaren Jackson Jr.,C,416,822,316,540,100,282,Center,12,Jump Shot,10.978102189781023
2014-15,203950,Jarnell Stokes,PF,21,37,21,37,0,0,Center,4,Layup Shot,3.324324324324324
2015-16,203950,Jarnell Stokes,C,3,5,3,5,0,0,Center,1,Jump Shot,8.2
2016-17,203950,Jarnell Stokes,C,1,1,1,1,0,0,Center,0,Layup Shot,1.0
2018-19,1628417,Jaron Blossomgame,SF,47,106,37,67,10,39,Center,3,Jump Shot,11.367924528301886
2018-19,1629020,Jarred Vanderbilt,PF,9,19,9,18,0,1,Center,3,Cutting Layup Shot,3.8421052631578947
2019-20,1629020,Jarred Vanderbilt,PF,5,8,5,7,0,1,Center,2,Layup Shot,3.625
2020-21,1629020,Jarred Vanderbilt,PF,143,236,142,231,1,5,Center,3,Layup Shot,2.1652542372881354
2021-22,1629020,Jarred Vanderbilt,PF,212,361,210,347,2,14,Center,4,Cutting Dunk Shot,2.670360110803324
2022-23,1629020,Jarred Vanderbilt,PF,247,451,218,361,29,90,Center,5,Jump Shot,6.76940133037694
2019-20,1629714,Jarrell Brantley,PF,10,28,7,15,3,13,Center,0,Jump Shot,13.071428571428571
2020-21,1629714,Jarrell Brantley,PF,25,52,13,24,12,28,Center,13,Jump Shot,15.0
2022-23,1629714,Jarrell Brantley,PF,8,14,4,5,4,9,Center,1,Jump Shot,17.428571428571427
2017-18,1628386,Jarrett Allen,C,234,397,229,382,5,15,Center,7,Cutting Dunk Shot,3.53904282115869
2018-19,1628386,Jarrett Allen,C,335,568,329,523,6,45,Center,7,Cutting Dunk Shot,3.7711267605633805
2019-20,1628386,Jarrett Allen,C,302,465,302,459,0,6,Center,9,Cutting Dunk Shot,2.075268817204301
2020-21,1628386,Jarrett Allen,C,298,482,292,463,6,19,Center,4,Turnaround Hook Shot,3.991701244813278
2021-22,1628386,Jarrett Allen,C,369,545,368,535,1,10,Center,14,Alley Oop Dunk Shot,3.3908256880733947
2022-23,1628386,Jarrett Allen,C,403,626,402,616,1,10,Center,6,Cutting Dunk Shot,3.9345047923322682
2019-20,1629633,Jarrett Culver,SG,230,569,164,348,66,221,Center,9,Jump Shot,11.60456942003515
2020-21,1629633,Jarrett Culver,SG,69,168,56,115,13,53,Center,1,Jump Shot,9.68452380952381
2021-22,1629633,Jarrett Culver,SG,51,135,39,88,12,47,Center,12,Jump Shot,13.022222222222222
2022-23,1629633,Jarrett Culver,SG,17,43,16,31,1,12,Center,0,Jump Shot,10.976744186046512
2005-06,101127,Jarrett Jack,SG,189,428,169,352,20,76,Center,10,Jump Shot,12.906542056074766
2006-07,101127,Jarrett Jack,PG,320,705,257,525,63,180,Center,12,Jump Shot,13.584397163120567
2007-08,101127,Jarrett Jack,SG,267,620,202,430,65,190,Center,16,Jump Shot,13.191935483870967
2008-09,101127,Jarrett Jack,SG,386,853,308,632,78,221,Center,31,Jump Shot,13.199296600234467
2009-10,101127,Jarrett Jack,PG,323,671,241,472,82,199,Center,19,Jump Shot,13.19672131147541
2010-11,101127,Jarrett Jack,SG-PG,260,637,227,529,33,108,Center,15,Jump Shot,13.061224489795919
2011-12,101127,Jarrett Jack,PG,266,583,227,471,39,112,Center,17,Jump Shot,13.540308747855917
2012-13,101127,Jarrett Jack,SG,387,857,305,654,82,203,Center,18,Jump Shot,15.31855309218203
2013-14,101127,Jarrett Jack,PG,286,698,223,513,63,185,Center,15,Jump Shot,15.859598853868194
2014-15,101127,Jarrett Jack,PG,359,817,320,671,39,146,Center,24,Jump Shot,13.735618115055079
2015-16,101127,Jarrett Jack,PG,140,358,109,256,31,102,Center,10,Jump Shot,15.446927374301676
2016-17,101127,Jarrett Jack,PG,2,3,2,2,0,1,Center,0,Running Layup Shot,14.666666666666666
2017-18,101127,Jarrett Jack,PG,189,443,164,357,25,86,Center,10,Jump Shot,14.15801354401806
2016-17,1627784,Jarrod Uthoff,PF,16,38,13,29,3,9,Center,4,Jump Shot,11.421052631578947
2019-20,1627784,Jarrod Uthoff,PF,7,18,4,9,3,9,Center,1,Jump Shot,17.61111111111111
2003-04,2260,Jarron Collins,C,147,295,147,294,0,1,Center,6,Jump Shot,6.311864406779661
2004-05,2260,Jarron Collins,C,65,157,65,156,0,1,Center,0,Jump Shot,8.0
2005-06,2260,Jarron Collins,C,129,280,129,280,0,0,Center,2,Jump Shot,7.725
2006-07,2260,Jarron Collins,C,75,170,75,170,0,0,Center,2,Jump Shot,7.752941176470588
2007-08,2260,Jarron Collins,C,36,82,36,81,0,1,Center,2,Jump Shot,10.21951219512195
2008-09,2260,Jarron Collins,C,16,35,16,35,0,0,Center,0,Jump Shot,6.771428571428571
2009-10,2260,Jarron Collins,C,12,31,12,31,0,0,Center,1,Jump Shot,4.774193548387097
2010-11,2260,Jarron Collins,C,6,21,6,21,0,0,Center,0,Jump Shot,8.380952380952381
2021-22,1629600,Jarron Cumberland,SG,1,2,1,1,0,1,Center,1,Jump Shot,15.5
2003-04,2553,Jarvis Hayes,SF,278,695,238,564,40,131,Center,20,Jump Shot,12.555395683453238
2004-05,2553,Jarvis Hayes,SF,206,530,164,407,42,123,Center,7,Jump Shot,14.760377358490565
2005-06,2553,Jarvis Hayes,SG,77,183,60,136,17,47,Center,5,Jump Shot,14.885245901639344
2006-07,2553,Jarvis Hayes,SF,224,546,158,363,66,183,Center,6,Jump Shot,16.412087912087912
2007-08,2553,Jarvis Hayes,SF,217,504,144,310,73,194,Center,7,Jump Shot,16.740079365079364
2008-09,2553,Jarvis Hayes,SF,257,577,163,333,94,244,Center,11,Jump Shot,16.535528596187174
2009-10,2553,Jarvis Hayes,SF,138,328,78,149,60,179,Right Side Center,12,Jump Shot,19.274390243902438
2012-13,202363,Jarvis Varnado,PF,3,7,3,7,0,0,Center,2,Jump Shot,3.857142857142857
2013-14,202363,Jarvis Varnado,PF,36,60,36,60,0,0,Center,2,Jump Shot,6.3
2003-04,2044,Jason Collier,C,79,165,78,161,1,4,Center,2,Jump Shot,8.545454545454545
2004-05,2044,Jason Collier,C,174,376,168,362,6,14,Center,8,Jump Shot,9.590425531914894
2003-04,2215,Jason Collins,C,163,384,163,382,0,2,Center,4,Jump Shot,7.190104166666667
2004-05,2215,Jason Collins,C,186,451,184,445,2,6,Center,6,Jump Shot,9.541019955654102
2005-06,2215,Jason Collins,C,104,262,101,250,3,12,Center,2,Jump Shot,12.755725190839694
2006-07,2215,Jason Collins,PF,55,151,55,149,0,2,Center,1,Jump Shot,7.596026490066225
2007-08,2215,Jason Collins,C,53,113,53,112,0,1,Center,1,Jump Shot,5.734513274336283
2008-09,2215,Jason Collins,C,22,70,22,70,0,0,Center,0,Jump Shot,8.014285714285714
2009-10,2215,Jason Collins,C,8,23,8,22,0,1,Right Side,4,Jump Shot,14.304347826086957
2010-11,2215,Jason Collins,C,34,71,33,70,1,1,Center,1,Jump Shot,8.95774647887324
2011-12,2215,Jason Collins,C,16,40,16,40,0,0,Center,0,Jump Shot,8.15
2012-13,2215,Jason Collins,C,9,29,9,29,0,0,Center,0,Jump Shot,6.689655172413793
2013-14,2215,Jason Collins,C,11,24,11,21,0,3,Center,2,Jump Shot,9.75
2003-04,2078,Jason Hart,PG,71,159,69,150,2,9,Center,11,Jump Shot,12.132075471698114
2004-05,2078,Jason Hart,PG,257,573,222,478,35,95,Center,25,Jump Shot,14.408376963350785
2005-06,2078,Jason Hart,PG,86,221,77,190,9,31,Center,9,Jump Shot,15.027149321266968
2006-07,2078,Jason Hart,PG,100,224,93,195,7,29,Center,7,Jump Shot,15.651785714285714
2007-08,2078,Jason Hart,PG,58,180,47,149,11,31,Center,7,Jump Shot,15.772222222222222
2008-09,2078,Jason Hart,PG,30,94,30,88,0,6,Center,7,Jump Shot,13.329787234042554
2009-10,2078,Jason Hart,PG,1,2,1,2,0,0,Right Side Center,0,Jump Shot,17.0
2003-04,2574,Jason Kapono,SF,52,129,31,85,21,44,Right Side,6,Jump Shot,16.82170542635659
2004-05,2574,Jason Kapono,SF,269,671,189,477,80,194,Right Side,13,Jump Shot,16.576751117734723
2005-06,2574,Jason Kapono,SF,79,177,58,124,21,53,Right Side,8,Jump Shot,16.819209039548024
2006-07,2574,Jason Kapono,SF,278,563,170,353,108,210,Right Side Center,10,Jump Shot,18.49378330373002
2007-08,2574,Jason Kapono,SF,243,498,186,380,57,118,Right Side,12,Jump Shot,16.48995983935743
2008-09,2574,Jason Kapono,SG,261,604,163,375,98,229,Right Side,11,Jump Shot,18.14072847682119
2009-10,2574,Jason Kapono,SF,126,301,63,130,63,171,Right Side,1,Jump Shot,20.488372093023255
2010-11,2574,Jason Kapono,SF,7,28,6,20,1,8,Center,1,Jump Shot,16.178571428571427
2011-12,2574,Jason Kapono,SG,21,55,13,28,8,27,Right Side,0,Jump Shot,20.2
2003-04,467,Jason Kidd,PG,368,959,274,666,94,293,Center,9,Jump Shot,15.526590198123046
2004-05,467,Jason Kidd,PG,340,855,211,497,129,358,Center,15,Jump Shot,16.726315789473684
2005-06,467,Jason Kidd,PG,366,905,227,510,139,395,Center,17,Jump Shot,16.860773480662985
2006-07,467,Jason Kidd,PG,369,908,245,547,124,361,Center,11,Jump Shot,15.769823788546255
2007-08,467,Jason Kidd,PG,305,793,186,481,119,312,Center,14,Jump Shot,16.383354350567465
2008-09,467,Jason Kidd,PG,257,618,126,295,131,323,Center,6,Jump Shot,17.881877022653722
2009-10,467,Jason Kidd,PG,284,671,108,257,176,414,Center,9,Jump Shot,19.326378539493295
2010-11,467,Jason Kidd,PG,215,596,82,205,133,391,Center,6,Jump Shot,20.355704697986578
2011-12,467,Jason Kidd,PG,99,273,20,50,79,223,Left Side Center,2,Jump Shot,22.315018315018314
2012-13,467,Jason Kidd,SG,152,409,38,84,114,325,Right Side Center,6,Jump Shot,21.511002444987774
2005-06,101131,Jason Maxiell,PF,23,54,23,54,0,0,Center,7,Jump Shot,8.74074074074074
2006-07,101131,Jason Maxiell,C,131,262,131,262,0,0,Center,6,Jump Shot,5.824427480916031
2007-08,101131,Jason Maxiell,C,240,446,240,445,0,1,Center,7,Jump Shot,6.670403587443946
2008-09,101131,Jason Maxiell,C,184,320,184,319,0,1,Center,8,Jump Shot,5.803125
2009-10,101131,Jason Maxiell,C,212,415,212,414,0,1,Center,4,Jump Shot,7.667469879518072
2010-11,101131,Jason Maxiell,PF,93,189,93,189,0,0,Center,1,Jump Shot,6.015873015873016
2011-12,101131,Jason Maxiell,PF,183,383,183,381,0,2,Center,3,Jump Shot,8.550913838120104
2012-13,101131,Jason Maxiell,PF,204,457,204,457,0,0,Center,4,Jump Shot,9.168490153172867
2013-14,101131,Jason Maxiell,PF,47,105,47,105,0,0,Center,0,Jump Shot,8.295238095238096
2014-15,101131,Jason Maxiell,PF,81,192,81,192,0,0,Center,3,Jump Shot,7.088541666666667
2022-23,1630554,Jason Preston,PG,18,41,13,23,5,18,Center,6,Jump Shot,16.585365853658537
2003-04,2202,Jason Richardson,SG,563,1284,486,1011,77,273,Center,24,Jump Shot,11.30607476635514
2004-05,2202,Jason Richardson,SG,610,1368,485,998,125,370,Center,34,Jump Shot,12.67251461988304
2005-06,2202,Jason Richardson,SG,641,1438,458,961,183,477,Center,27,Jump Shot,13.713490959666203
2006-07,2202,Jason Richardson,SG,306,734,196,434,110,300,Center,4,Jump Shot,15.141689373297003
2007-08,2202,Jason Richardson,SF,648,1468,405,869,243,599,Center,18,Jump Shot,14.880790190735695
2008-09,2202,Jason Richardson,SG,465,974,336,649,129,325,Center,11,Jump Shot,12.944558521560575
2009-10,2202,Jason Richardson,SG,473,998,316,598,157,400,Center,9,Jump Shot,13.585170340681362
2010-11,2202,Jason Richardson,SG,472,1055,283,577,189,478,Center,28,Jump Shot,15.686255924170617
2011-12,2202,Jason Richardson,SG,243,596,141,319,102,277,Center,7,Jump Shot,15.419463087248323
2012-13,2202,Jason Richardson,SG,135,336,78,169,57,167,Center,6,Jump Shot,17.285714285714285
2014-15,2202,Jason Richardson,SG,62,178,31,82,31,96,Center,2,Jump Shot,17.674157303370787
2007-08,201160,Jason Smith,PF,141,310,137,296,4,14,Center,9,Jump Shot,9.135483870967741
2009-10,201160,Jason Smith,PF,75,174,65,145,10,29,Center,3,Jump Shot,10.425287356321839
2010-11,201160,Jason Smith,C,136,307,136,305,0,2,Center,7,Jump Shot,13.635179153094462
2011-12,201160,Jason Smith,PF,181,348,180,339,1,9,Center,3,Jump Shot,12.298850574712644
2012-13,201160,Jason Smith,C,167,341,167,337,0,4,Center,2,Jump Shot,11.841642228739003
2013-14,201160,Jason Smith,PF,131,282,131,282,0,0,Center,2,Jump Shot,13.542553191489361
2014-15,201160,Jason Smith,C,257,592,242,550,15,42,Center,6,Jump Shot,13.469594594594595
2015-16,201160,Jason Smith,C,244,503,240,487,4,16,Center,2,Jump Shot,15.003976143141154
2016-17,201160,Jason Smith,C,173,328,137,251,36,77,Center,1,Jump Shot,15.265243902439025
2017-18,201160,Jason Smith,C,45,115,41,83,4,32,Center,5,Jump Shot,14.608695652173912
2018-19,201160,Jason Smith,C-PF,21,59,12,33,9,26,Center,0,Jump Shot,14.559322033898304
2003-04,1891,Jason Terry,PG,499,1196,353,775,146,421,Center,24,Jump Shot,15.686454849498327
2004-05,1891,Jason Terry,PG,372,743,269,498,103,245,Center,24,Jump Shot,14.507402422611037
2005-06,1891,Jason Terry,PG,516,1099,345,683,171,416,Center,20,Jump Shot,15.936305732484076
2006-07,1891,Jason Terry,SG,514,1063,352,693,162,370,Center,25,Jump Shot,15.820319849482596
2007-08,1891,Jason Terry,SG,471,1008,335,645,136,363,Center,23,Jump Shot,15.930555555555555
2008-09,1891,Jason Terry,SG,541,1168,374,712,167,456,Center,32,Jump Shot,16.28082191780822
2009-10,1891,Jason Terry,SG,456,1041,320,668,136,373,Center,12,Jump Shot,16.027857829010568
2010-11,1891,Jason Terry,SG,492,1091,365,740,127,351,Center,28,Jump Shot,15.898258478460129
2011-12,1891,Jason Terry,SG,357,830,219,465,138,365,Center,16,Jump Shot,17.272289156626506
2012-13,1891,Jason Terry,SG,281,647,158,317,123,330,Center,8,Jump Shot,18.23338485316847
2013-14,1891,Jason Terry,PG,55,152,16,49,39,103,Right Side Center,1,Jump Shot,20.61842105263158
2014-15,1891,Jason Terry,SG,188,446,62,123,126,323,Right Side,6,Jump Shot,20.192825112107624
2015-16,1891,Jason Terry,SG,151,374,58,115,93,259,Right Side,10,Jump Shot,19.558823529411764
2016-17,1891,Jason Terry,SG,104,241,32,72,72,169,Center,2,Jump Shot,19.24896265560166
2017-18,1891,Jason Terry,SG,59,154,19,39,40,115,Right Side,0,Jump Shot,20.792207792207794
2008-09,201574,Jason Thompson,PF,356,717,356,709,0,8,Center,10,Jump Shot,5.95676429567643
2009-10,201574,Jason Thompson,C,370,784,369,774,1,10,Center,18,Jump Shot,8.14923469387755
2010-11,201574,Jason Thompson,PF,271,534,271,531,0,3,Center,6,Jump Shot,7.543071161048689
2011-12,201574,Jason Thompson,PF,237,443,237,441,0,2,Center,7,Jump Shot,5.142212189616253
2012-13,201574,Jason Thompson,PF,374,745,374,742,0,3,Center,7,Jump Shot,7.699328859060403
2013-14,201574,Jason Thompson,PF,251,496,251,496,0,0,Center,6,Jump Shot,7.235887096774194
2014-15,201574,Jason Thompson,PF,201,428,201,427,0,1,Center,6,Jump Shot,8.373831775700934
2015-16,201574,Jason Thompson,C,52,108,47,93,5,15,Center,8,Jump Shot,8.13888888888889
2003-04,1715,Jason Williams,PG,290,713,170,349,120,364,Center,17,Jump Shot,17.94109396914446
2004-05,1715,Jason Williams,PG,266,644,159,314,107,330,Center,14,Jump Shot,17.86335403726708
2005-06,1715,Jason Williams,PG,268,606,161,318,107,288,Center,8,Jump Shot,15.585808580858085
2006-07,1715,Jason Williams,PG,235,569,135,274,100,295,Center,6,Jump Shot,17.423550087873462
2007-08,1715,Jason Williams,PG,211,550,114,275,97,275,Center,5,Jump Shot,17.334545454545456
2009-10,1715,Jason Williams,PG,189,426,105,205,84,221,Center,2,Jump Shot,18.260563380281692
2010-11,1715,Jason Williams,PG,22,67,12,29,10,38,Center,0,Jump Shot,22.223880597014926
2007-08,201159,Javaris Crittenton,SG,98,233,88,196,10,37,Center,16,Jump Shot,9.111587982832617
2008-09,201159,Javaris Crittenton,PG-SG,131,285,129,270,2,15,Center,11,Jump Shot,6.6456140350877195
2019-20,1629750,Javonte Green,SG,63,126,54,93,9,33,Center,10,Jump Shot,8.666666666666666
2020-21,1629750,Javonte Green,SF-SG,53,102,43,72,10,30,Center,1,Jump Shot,9.46078431372549
2021-22,1629750,Javonte Green,SF,176,325,140,224,36,101,Center,2,Jump Shot,8.68923076923077
2022-23,1629750,Javonte Green,SG,61,108,48,73,13,35,Center,4,Jump Shot,9.351851851851851
2021-22,1630606,Javonte Smart,PG,19,60,11,33,8,27,Center,1,Jump Shot,15.883333333333333
2008-09,101214,Jawad Williams,SF,5,12,3,6,2,6,Left Side,2,Jump Shot,17.25
2009-10,101214,Jawad Williams,PG,81,206,51,113,30,93,Center,4,Jump Shot,15.927184466019417
2010-11,101214,Jawad Williams,SF,41,126,28,81,13,45,Center,4,Jump Shot,15.952380952380953
2017-18,1628393,Jawun Evans,PG,89,253,74,199,15,54,Center,10,Jump Shot,12.395256916996047
2018-19,1628393,Jawun Evans,PG,3,14,3,11,0,3,Center,0,Pullup Jump shot,15.785714285714286
2019-20,1629637,Jaxson Hayes,C,174,259,173,255,1,4,Center,5,Cutting Dunk Shot,2.324324324324324
2020-21,1629637,Jaxson Hayes,C,175,280,169,266,6,14,Center,13,Jump Shot,3.992857142857143
2021-22,1629637,Jaxson Hayes,C,245,398,225,341,20,57,Center,8,Jump Shot,6.201005025125628
2022-23,1629637,Jaxson Hayes,C,86,156,83,127,3,29,Center,13,Jump Shot,6.9743589743589745
2021-22,1630643,Jay Huff,C,0,3,0,1,0,2,Center,0,Jump Shot,19.333333333333332
2022-23,1630643,Jay Huff,C,15,25,9,13,6,12,Center,2,Jump Shot,15.04
2020-21,1630206,Jay Scrubb,SG,14,36,12,27,2,9,Center,1,Jump Shot,12.472222222222221
2021-22,1630206,Jay Scrubb,SG,18,46,12,25,6,21,Center,5,Jump Shot,15.673913043478262
2022-23,1630206,Jay Scrubb,SG,5,7,3,5,2,2,Center,1,Driving Layup Shot,9.142857142857142
2018-19,1629121,Jaylen Adams,PG,38,110,13,36,25,74,Center,4,Jump Shot,19.654545454545456
2020-21,1629121,Jaylen Adams,PG,1,8,1,6,0,2,Center,0,Driving Layup Shot,10.5
2016-17,1627759,Jaylen Brown,SF,192,422,146,288,46,134,Center,5,Jump Shot,11.203791469194313
2017-18,1627759,Jaylen Brown,SG,373,803,252,497,121,306,Center,11,Jump Shot,12.408468244084682
2018-19,1627759,Jaylen Brown,SG,368,792,273,516,95,276,Center,12,Jump Shot,12.202020202020202
2019-20,1627759,Jaylen Brown,SG,427,887,298,549,129,338,Center,13,Jump Shot,13.149943630214205
2020-21,1627759,Jaylen Brown,SG,538,1111,375,700,163,411,Center,21,Jump Shot,13.766876687668766
2021-22,1627759,Jaylen Brown,SF,576,1217,410,753,166,464,Center,18,Jump Shot,14.031224322103533
2022-23,1627759,Jaylen Brown,SF,679,1383,516,896,163,487,Center,17,Jump Shot,13.370932754880695
2019-20,1629658,Jaylen Hoard,PF,15,32,15,29,0,3,Center,3,Driving Layup Shot,5.15625
2020-21,1629658,Jaylen Hoard,SF,44,88,44,77,0,11,Center,3,Layup Shot,5.534090909090909
2021-22,1629658,Jaylen Hoard,SF,44,90,35,65,9,25,Center,2,Jump Shot,9.588888888888889
2017-18,1628537,Jaylen Morris,SG,13,32,11,22,2,10,Center,1,Jump Shot,11.90625
2018-19,1628537,Jaylen Morris,SG,4,10,3,7,1,3,Center,0,Jump Shot,9.9
2021-22,1628537,Jaylen Morris,SG,0,6,0,4,0,2,Center,0,Driving Layup Shot,11.166666666666666
2019-20,1629669,Jaylen Nowell,SG,19,53,16,27,3,26,Center,2,Jump Shot,13.981132075471699
2020-21,1629669,Jaylen Nowell,SG,142,335,92,185,50,150,Center,9,Jump Shot,15.450746268656717
2021-22,1629669,Jaylen Nowell,SG,196,413,133,253,63,160,Center,8,Jump Shot,13.581113801452785
2022-23,1629669,Jaylen Nowell,SG,280,625,213,393,67,232,Center,6,Jump Shot,13.0256
2022-23,1631119,Jaylin Williams,PF,102,234,56,121,46,113,Center,1,Jump Shot,15.764957264957266
2021-22,1629873,Jaysean Paige,PG,0,3,0,1,0,2,Right Side Center,0,Jump Shot,23.333333333333332
2017-18,1628369,Jayson Tatum,SF,397,835,292,593,105,242,Center,25,Jump Shot,12.740119760479041
2018-19,1628369,Jayson Tatum,SF,466,1036,350,725,116,311,Center,20,Jump Shot,13.14864864864865
2019-20,1628369,Jayson Tatum,PF,552,1226,363,757,189,469,Center,24,Jump Shot,13.898858075040783
2020-21,1628369,Jayson Tatum,SF,605,1318,418,833,187,485,Center,32,Jump Shot,14.12670713201821
2021-22,1628369,Jayson Tatum,SF,708,1564,478,913,230,651,Center,17,Jump Shot,14.703324808184144
2022-23,1628369,Jayson Tatum,PF,727,1559,487,873,240,686,Center,21,Jump Shot,14.341885824246312
2022-23,1631466,Jeenathan Williams,SG,24,39,21,31,3,8,Center,2,Jump Shot,6.743589743589744
2010-11,202399,Jeff Adrien,PF,23,54,23,54,0,0,Center,4,Jump Shot,3.7962962962962963
2011-12,202399,Jeff Adrien,PF,7,16,7,16,0,0,Center,2,Jump Shot,8.0
2012-13,202399,Jeff Adrien,PF,72,168,72,166,0,2,Center,5,Jump Shot,8.5
2013-14,202399,Jeff Adrien,PF,143,275,143,275,0,0,Center,9,Layup Shot,4.952727272727273
2014-15,202399,Jeff Adrien,PF,19,44,19,44,0,0,Center,3,Jump Shot,4.863636363636363
2009-10,201965,Jeff Ayres,C,43,65,43,65,0,0,Center,3,Jump Shot,4.6923076923076925
2011-12,201965,Jeff Ayres,C,15,36,15,36,0,0,Center,5,Jump Shot,7.166666666666667
2012-13,201965,Jeff Ayres,PF,61,126,59,122,2,4,Center,7,Jump Shot,11.515873015873016
2013-14,201965,Jeff Ayres,PF,101,174,101,174,0,0,Center,8,Jump Shot,4.275862068965517
2014-15,201965,Jeff Ayres,PF,55,95,55,95,0,0,Center,12,Layup Shot,3.8105263157894735
2015-16,201965,Jeff Ayres,C,12,22,12,22,0,0,Center,2,Jump Shot,5.818181818181818
2021-22,1630288,Jeff Dowtin,,8,26,7,17,1,9,Center,3,Jump Shot,14.384615384615385
2022-23,1630288,Jeff Dowtin Jr.,,25,57,20,41,5,16,Center,3,Pullup Jump shot,12.964912280701755
2011-12,202880,Jeff Foote,C,2,6,2,6,0,0,Center,0,Layup Shot,3.0
2003-04,1902,Jeff Foster,C,197,362,197,358,0,4,Center,1,Layup Shot,4.168508287292818
2004-05,1902,Jeff Foster,C,168,324,168,319,0,5,Center,6,Layup Shot,4.54320987654321
2005-06,1902,Jeff Foster,C,138,250,138,246,0,4,Center,1,Layup Shot,2.028
2006-07,1902,Jeff Foster,C,122,260,122,259,0,1,Center,2,Layup Shot,2.8423076923076924
2007-08,1902,Jeff Foster,C,205,373,205,370,0,3,Center,0,Layup Shot,5.729222520107238
2008-09,1902,Jeff Foster,C,177,353,175,346,2,7,Center,5,Layup Shot,5.81586402266289
2009-10,1902,Jeff Foster,C,22,46,22,45,0,1,Center,0,Jump Shot,6.173913043478261
2010-11,1902,Jeff Foster,C,80,167,80,164,0,3,Center,1,Jump Shot,5.173652694610778
2011-12,1902,Jeff Foster,C,9,18,8,17,1,1,Center,0,Jump Shot,6.055555555555555
2007-08,201145,Jeff Green,SF,320,749,299,673,21,76,Center,6,Jump Shot,9.36448598130841
2008-09,201145,Jeff Green,PF,476,1068,380,821,96,247,Center,16,Jump Shot,11.803370786516854
2009-10,201145,Jeff Green,PF,485,1070,381,758,104,312,Center,20,Jump Shot,11.929906542056075
2010-11,201145,Jeff Green,PF-SF,368,820,304,609,64,211,Center,13,Jump Shot,11.751219512195123
2012-13,201145,Jeff Green,PF,376,806,306,624,70,182,Center,15,Jump Shot,11.004962779156328
2013-14,201145,Jeff Green,SF,482,1171,347,775,135,396,Center,20,Jump Shot,14.095644748078564
2014-15,201145,Jeff Green,SF,416,967,319,675,97,292,Center,19,Jump Shot,12.553257497414684
2015-16,201145,Jeff Green,SF,354,823,287,611,67,212,Center,14,Jump Shot,11.289185905224787
2016-17,201145,Jeff Green,PF,220,558,167,365,53,193,Center,8,Jump Shot,14.329749103942651
2017-18,201145,Jeff Green,PF,295,618,242,448,53,170,Center,8,Jump Shot,11.174757281553399
2018-19,201145,Jeff Green,PF,326,687,215,367,111,320,Center,7,Jump Shot,15.473071324599708
2019-20,201145,Jeff Green,PF-C,159,344,97,161,62,183,Center,1,Jump Shot,15.526162790697674
2020-21,201145,Jeff Green,PF,261,530,158,280,103,250,Center,9,Jump Shot,13.939622641509434
2021-22,201145,Jeff Green,PF,277,529,224,361,53,168,Center,5,Jump Shot,10.76937618147448
2022-23,201145,Jeff Green,PF,160,328,130,224,30,104,Center,3,Jump Shot,11.079268292682928
2003-04,976,Jeff McInnis,SG-PG,334,747,288,620,46,127,Center,22,Jump Shot,12.717536813922356
2004-05,976,Jeff McInnis,PG,377,915,286,651,91,264,Center,13,Jump Shot,14.34207650273224
2005-06,976,Jeff McInnis,SG,63,143,60,127,3,16,Center,6,Jump Shot,12.34965034965035
2006-07,976,Jeff McInnis,PG,71,181,70,173,1,8,Center,3,Jump Shot,10.80110497237569
2007-08,976,Jeff McInnis,PG,108,249,105,230,3,19,Center,5,Jump Shot,14.06425702811245
2009-10,201952,Jeff Teague,PG,90,227,83,195,7,32,Center,7,Jump Shot,10.030837004405287
2010-11,201952,Jeff Teague,PG,133,304,115,256,18,48,Center,15,Jump Shot,10.0
2011-12,201952,Jeff Teague,PG,320,672,269,523,51,149,Center,8,Jump Shot,9.456845238095237
2012-13,201952,Jeff Teague,PG,439,974,350,726,89,248,Center,23,Jump Shot,10.905544147843942
2013-14,201952,Jeff Teague,PG,456,1039,382,815,74,224,Center,33,Jump Shot,10.41097208854668
2014-15,201952,Jeff Teague,PG,408,887,337,680,71,207,Center,23,Jump Shot,9.995490417136415
2015-16,201952,Jeff Teague,PG,434,987,324,714,110,273,Center,16,Jump Shot,10.92806484295846
2016-17,201952,Jeff Teague,PG,401,908,312,657,89,251,Center,20,Jump Shot,11.886563876651982
2017-18,201952,Jeff Teague,PG,354,794,270,566,84,228,Center,12,Jump Shot,12.29345088161209
2018-19,201952,Jeff Teague,PG,176,416,141,311,35,105,Center,6,Jump Shot,11.276442307692308
2019-20,201952,Jeff Teague,PG,213,489,170,372,43,117,Center,8,Driving Layup Shot,10.441717791411042
2020-21,201952,Jeff Teague,PG,123,284,87,202,36,82,Center,2,Driving Floating Jump Shot,12.274647887323944
2003-04,2244,Jeff Trepagnier,SG,10,38,8,34,2,4,Center,0,Jump Shot,9.68421052631579
2013-14,203481,Jeff Withey,C,69,129,69,128,0,1,Center,3,Layup Shot,3.4031007751937983
2014-15,203481,Jeff Withey,C,32,64,32,64,0,0,Center,4,Jump Shot,3.828125
2015-16,203481,Jeff Withey,C,87,162,87,160,0,2,Center,6,Jump Shot,4.234567901234568
2016-17,203481,Jeff Withey,C,55,103,55,102,0,1,Center,4,Layup Shot,2.8446601941747574
2017-18,203481,Jeff Withey,C,6,16,4,6,2,10,Center,4,Jump Shot,16.8125
2012-13,203106,Jeffery Taylor,,172,399,119,245,53,154,Center,8,Jump Shot,13.218045112781954
2013-14,203106,Jeffery Taylor,,82,217,64,151,18,66,Center,1,Jump Shot,12.050691244239632
2014-15,203106,Jeffery Taylor,,45,114,34,78,11,36,Center,3,Jump Shot,12.657894736842104
2004-05,1741,Jelani McCoy,C,7,13,7,13,0,0,Center,0,Layup Shot,0.23076923076923078
2007-08,1741,Jelani McCoy,C,1,1,1,1,0,0,Center,0,Dunk Shot,0.0
2018-19,1629203,Jemerrio Jones,SF,12,33,10,23,2,10,Center,0,Jump Shot,10.030303030303031
2021-22,1629203,Jemerrio Jones,SF,2,3,2,3,0,0,Center,1,Turnaround Hook Shot,2.3333333333333335
2014-15,203924,Jerami Grant,SF,124,352,75,196,49,156,Center,7,Jump Shot,13.568181818181818
2015-16,203924,Jerami Grant,PF,251,599,216,453,35,146,Center,5,Jump Shot,8.365609348914859
2016-17,203924,Jerami Grant,PF,152,328,109,212,43,116,Center,9,Jump Shot,11.61890243902439
2017-18,203924,Jerami Grant,PF,244,456,212,346,32,110,Center,11,Jump Shot,7.842105263157895
2018-19,203924,Jerami Grant,PF,409,823,294,530,115,293,Center,16,Jump Shot,10.882138517618468
2019-20,203924,Jerami Grant,PF,303,634,205,382,98,252,Center,5,Jump Shot,12.949526813880126
2020-21,203924,Jerami Grant,SF,400,932,285,603,115,329,Center,15,Jump Shot,14.080472103004292
2021-22,203924,Jerami Grant,PF,298,699,207,445,91,254,Center,15,Jump Shot,14.722460658082976
2022-23,203924,Jerami Grant,PF,434,913,290,554,144,359,Center,12,Jump Shot,13.736035049288061
2014-15,202077,Jerel McNeal,PG,3,11,2,9,1,2,Center,0,Jump Shot,12.0
2019-20,1629725,Jeremiah Martin,PG,24,53,19,35,5,18,Center,3,Driving Layup Shot,12.226415094339623
2020-21,1629725,Jeremiah Martin,PG,9,33,6,21,3,12,Center,1,Driving Layup Shot,12.515151515151516
2021-22,1630526,Jeremiah Robinson-Earl,C,134,324,76,159,58,165,Center,4,Jump Shot,14.851851851851851
2022-23,1630526,Jeremiah Robinson-Earl,PF,110,248,73,137,37,111,Center,5,Jump Shot,12.459677419354838
2010-11,202379,Jeremy Evans,SF,76,115,76,114,0,1,Center,9,Jump Shot,4.408695652173913
2011-12,202379,Jeremy Evans,SF,27,42,27,41,0,1,Center,5,Slam Dunk Shot,4.285714285714286
2012-13,202379,Jeremy Evans,PF,27,44,27,43,0,1,Center,5,Jump Shot,5.840909090909091
2013-14,202379,Jeremy Evans,SF,175,332,175,330,0,2,Center,7,Jump Shot,7.656626506024097
2014-15,202379,Jeremy Evans,SF,32,58,30,53,2,5,Center,0,Jump Shot,6.120689655172414
2015-16,202379,Jeremy Evans,SF,26,48,22,32,4,16,Center,4,Jump Shot,10.291666666666666
2017-18,202379,Jeremy Evans,SF,1,1,1,1,0,0,Center,1,Putback Dunk Shot,0.0
2012-13,203087,Jeremy Lamb,SF,24,68,15,38,9,30,Center,7,Jump Shot,15.897058823529411
2013-14,203087,Jeremy Lamb,SG,263,609,175,362,88,247,Center,11,Jump Shot,15.133004926108374
2014-15,203087,Jeremy Lamb,SG,104,250,66,139,38,111,Center,17,Jump Shot,16.008
2015-16,203087,Jeremy Lamb,SG,230,510,174,329,56,181,Center,7,Jump Shot,13.63921568627451
2016-17,203087,Jeremy Lamb,SG,226,491,185,345,41,146,Center,5,Jump Shot,13.29735234215886
2017-18,203087,Jeremy Lamb,SG,380,832,286,578,94,254,Center,8,Jump Shot,13.929086538461538
2018-19,203087,Jeremy Lamb,SG,431,979,316,649,115,330,Center,12,Jump Shot,13.036772216547497
2019-20,203087,Jeremy Lamb,SG,216,479,163,321,53,158,Center,6,Pullup Jump shot,14.620041753653444
2020-21,203087,Jeremy Lamb,SG,120,276,68,148,52,128,Center,4,Jump Shot,15.945652173913043
2021-22,203087,Jeremy Lamb,SF-SG,133,347,78,177,55,170,Center,6,Jump Shot,16.95100864553314
2010-11,202391,Jeremy Lin,PG,28,72,27,67,1,5,Center,6,Jump Shot,8.01388888888889
2011-12,202391,Jeremy Lin,PG,171,383,147,308,24,75,Center,10,Jump Shot,10.219321148825065
2012-13,202391,Jeremy Lin,PG,396,897,309,640,87,257,Center,15,Jump Shot,11.87402452619844
2013-14,202391,Jeremy Lin,PG,295,662,213,433,82,229,Center,13,Jump Shot,12.780966767371602
2014-15,202391,Jeremy Lin,PG,277,654,212,478,65,176,Center,15,Jump Shot,12.8348623853211
2015-16,202391,Jeremy Lin,SG,300,728,224,502,76,226,Center,13,Jump Shot,13.032967032967033
2016-17,202391,Jeremy Lin,PG,175,400,117,244,58,156,Center,13,Jump Shot,14.4725
2017-18,202391,Jeremy Lin,PG,5,12,4,10,1,2,Center,0,Driving Layup Shot,9.666666666666666
2018-19,202391,Jeremy Lin,PG,238,541,183,354,55,187,Center,14,Jump Shot,12.903881700554528
2011-12,202951,Jeremy Pargo,PG,50,150,40,112,10,38,Center,1,Jump Shot,13.56
2012-13,202951,Jeremy Pargo,PG-SG,99,250,74,176,25,74,Center,7,Jump Shot,12.5
2019-20,202951,Jeremy Pargo,PG,11,22,8,15,3,7,Center,0,Jump Shot,13.454545454545455
2006-07,200978,Jeremy Richardson,SG-SF,3,6,1,3,2,3,Left Side Center,1,Jump Shot,22.666666666666668
2007-08,200978,Jeremy Richardson,SG-SF,16,44,9,25,7,19,Center,5,Jump Shot,18.818181818181817
2008-09,200978,Jeremy Richardson,SF,14,49,8,32,6,17,Left Side,4,Jump Shot,17.816326530612244
2022-23,1631110,Jeremy Sochan,PF,250,552,217,418,33,134,Center,5,Jump Shot,9.927536231884059
2011-12,202719,Jeremy Tyler,C,88,209,88,208,0,1,Center,6,Jump Shot,6.143540669856459
2012-13,202719,Jeremy Tyler,C,9,24,9,24,0,0,Center,2,Jump Shot,7.833333333333333
2013-14,202719,Jeremy Tyler,C,60,116,60,116,0,0,Center,15,Jump Shot,5.913793103448276
2015-16,1626170,Jerian Grant,PG,154,391,132,291,22,100,Center,13,Jump Shot,11.309462915601022
2016-17,1626170,Jerian Grant,PG,128,301,79,167,49,134,Center,4,Jump Shot,16.169435215946844
2017-18,1626170,Jerian Grant,PG,209,503,148,316,61,187,Center,9,Jump Shot,15.664015904572565
2018-19,1626170,Jerian Grant,PG,92,220,52,110,40,110,Center,9,Jump Shot,17.740909090909092
2019-20,1626170,Jerian Grant,SG,10,27,8,19,2,8,Center,0,Jump Shot,12.037037037037036
2021-22,1630579,Jericho Sims,PF,39,54,39,54,0,0,Center,4,Alley Oop Dunk Shot,1.5740740740740742
2022-23,1630579,Jericho Sims,C,83,107,83,106,0,1,Center,9,Alley Oop Dunk Shot,2.102803738317757
2004-05,1983,Jermaine Jackson,SG,17,33,17,31,0,2,Center,2,Jump Shot,11.545454545454545
2005-06,1983,Jermaine Jackson,PG,11,26,10,22,1,4,Center,1,Jump Shot,11.307692307692308
2003-04,979,Jermaine O'Neal,PF,608,1400,606,1382,2,18,Center,21,Jump Shot,8.849285714285715
2004-05,979,Jermaine O'Neal,PF,386,854,385,848,1,6,Center,17,Jump Shot,8.574941451990632
2005-06,979,Jermaine O'Neal,PF,380,805,377,795,3,10,Center,13,Jump Shot,8.281987577639752
2006-07,979,Jermaine O'Neal,C,498,1141,498,1134,0,7,Center,21,Jump Shot,8.800175284837861
2007-08,979,Jermaine O'Neal,C,225,512,225,507,0,5,Center,5,Jump Shot,8.998046875
2008-09,979,Jermaine O'Neal,C,365,770,365,769,0,1,Center,12,Jump Shot,8.118181818181819
2009-10,979,Jermaine O'Neal,C,394,745,394,743,0,2,Center,9,Jump Shot,8.904697986577181
2010-11,979,Jermaine O'Neal,C,50,109,50,108,0,1,Center,0,Jump Shot,7.146788990825688
2011-12,979,Jermaine O'Neal,C,52,120,52,120,0,0,Center,0,Jump Shot,6.591666666666667
2012-13,979,Jermaine O'Neal,C,179,371,179,371,0,0,Center,4,Jump Shot,6.973045822102426
2013-14,979,Jermaine O'Neal,PF,125,248,125,248,0,0,Center,1,Jump Shot,5.350806451612903
2009-10,201966,Jermaine Taylor,SG,45,119,40,97,5,22,Center,10,Jump Shot,8.781512605042018
2010-11,201966,Jermaine Taylor,SG,94,196,80,151,14,45,Center,16,Jump Shot,9.107142857142858
2007-08,201176,Jermareo Davidson,SF,51,125,51,125,0,0,Center,8,Jump Shot,10.96
2008-09,201176,Jermareo Davidson,SF,17,35,17,35,0,0,Center,2,Jump Shot,10.771428571428572
2003-04,2602,Jerome Beasley,PF,1,3,1,3,0,0,Center,1,Layup Shot,7.0
2011-12,202406,Jerome Dyson,PG,19,48,18,40,1,8,Center,0,Jump Shot,8.833333333333334
2003-04,1744,Jerome James,C,129,259,129,259,0,0,Center,2,Jump Shot,4.250965250965251
2004-05,1744,Jerome James,C,174,342,174,340,0,2,Center,1,Jump Shot,5.780701754385965
2005-06,1744,Jerome James,C,56,121,56,121,0,0,Center,0,Jump Shot,5.090909090909091
2006-07,1744,Jerome James,C,33,79,33,79,0,0,Center,3,Jump Shot,6.189873417721519
2007-08,1744,Jerome James,C,1,1,1,1,0,0,Center,1,Turnaround Jump Shot,4.0
2008-09,1744,Jerome James,C,3,8,3,8,0,0,Center,0,Jump Shot,9.625
2011-12,202366,Jerome Jordan,C,17,33,17,33,0,0,Center,4,Jump Shot,4.666666666666667
2014-15,202366,Jerome Jordan,C,50,94,50,94,0,0,Center,9,Layup Shot,3.0425531914893615
2003-04,2040,Jerome Moiso,PF,40,84,40,83,0,1,Center,0,Jump Shot,5.4523809523809526
2004-05,2040,Jerome Moiso,C-PF,9,18,9,17,0,1,Center,2,Tip Shot,5.166666666666667
2018-19,1629010,Jerome Robinson,SG,44,110,26,53,18,57,Center,3,Jump Shot,17.8
2019-20,1629010,Jerome Robinson,SG,115,310,66,157,49,153,Center,14,Jump Shot,17.280645161290323
2020-21,1629010,Jerome Robinson,SG,28,95,17,53,11,42,Center,0,Jump Shot,16.621052631578948
2003-04,966,Jerome Williams,PF,158,336,158,328,0,8,Center,7,Layup Shot,5.669642857142857
2004-05,966,Jerome Williams,SF,122,243,122,238,0,5,Center,4,Layup Shot,4.68724279835391
2011-12,202536,Jerry Smith,PG,3,14,2,8,1,6,Center,0,Jump Shot,16.5
2003-04,711,Jerry Stackhouse,SF,128,321,105,256,23,65,Center,5,Jump Shot,13.317757009345794
2004-05,711,Jerry Stackhouse,SG,274,662,242,542,32,120,Center,13,Jump Shot,12.561933534743202
2005-06,711,Jerry Stackhouse,SG,242,603,206,473,36,130,Center,6,Jump Shot,13.791044776119403
2006-07,711,Jerry Stackhouse,SF,280,654,218,492,62,162,Center,5,Jump Shot,14.663608562691131
2007-08,711,Jerry Stackhouse,SG,213,526,153,342,60,184,Center,8,Jump Shot,14.819391634980988
2008-09,711,Jerry Stackhouse,SG,16,60,13,41,3,19,Center,1,Jump Shot,14.333333333333334
2009-10,711,Jerry Stackhouse,SG,129,316,84,186,45,130,Center,0,Jump Shot,16.981012658227847
2010-11,711,Jerry Stackhouse,SG,3,12,2,8,1,4,Left Side,1,Jump Shot,17.666666666666668
2011-12,711,Jerry Stackhouse,SF,37,100,24,62,13,38,Left Side,7,Jump Shot,15.8
2012-13,711,Jerry Stackhouse,SF,66,171,36,83,30,88,Left Side,0,Jump Shot,18.43859649122807
2008-09,201573,Jerryd Bayless,PG,69,189,62,162,7,27,Center,8,Jump Shot,9.074074074074074
2009-10,201573,Jerryd Bayless,SG,200,483,171,391,29,92,Center,10,Jump Shot,12.246376811594203
2010-11,201573,Jerryd Bayless,PG,218,517,169,371,49,146,Center,9,Jump Shot,13.241779497098646
2011-12,201573,Jerryd Bayless,PG,117,276,73,172,44,104,Center,5,Jump Shot,17.083333333333332
2012-13,201573,Jerryd Bayless,PG,260,621,189,420,71,201,Center,11,Jump Shot,16.244766505636072
2013-14,201573,Jerryd Bayless,PG,248,617,172,405,76,212,Center,8,Jump Shot,16.567260940032416
2014-15,201573,Jerryd Bayless,PG,220,516,183,396,37,120,Center,9,Jump Shot,13.540697674418604
2015-16,201573,Jerryd Bayless,SG,183,432,84,206,99,226,Center,8,Jump Shot,17.337962962962962
2016-17,201573,Jerryd Bayless,PG,11,32,9,27,2,5,Center,0,Jump Shot,11.53125
2017-18,201573,Jerryd Bayless,SG,109,262,55,116,54,146,Center,1,Jump Shot,17.015267175572518
2018-19,201573,Jerryd Bayless,PG,82,230,53,132,29,98,Center,2,Jump Shot,16.56086956521739
2018-19,1628975,Jevon Carter,PG,56,185,22,83,34,102,Center,5,Jump Shot,18.464864864864865
2019-20,1628975,Jevon Carter,PG,101,243,39,97,62,146,Center,5,Jump Shot,18.069958847736626
2020-21,1628975,Jevon Carter,PG,94,223,38,72,56,151,Center,3,Jump Shot,20.730941704035875
2021-22,1628975,Jevon Carter,PG,98,253,32,83,66,170,Right Side Center,8,Jump Shot,20.6600790513834
2022-23,1628975,Jevon Carter,PG,239,565,97,228,142,337,Center,10,Jump Shot,19.373451327433628
2003-04,754,Jim Jackson,SF,382,900,220,495,162,405,Center,15,Jump Shot,17.36777777777778
2004-05,754,Jim Jackson,SF,248,582,126,287,122,295,Left Side,12,Jump Shot,18.960481099656356
2005-06,754,Jim Jackson,SF,47,160,29,86,18,74,Right Side Center,1,Jump Shot,19.28125
2011-12,202690,Jimmer Fredette,PG,172,446,94,230,78,216,Center,12,Jump Shot,17.230941704035875
2012-13,202690,Jimmer Fredette,SG,172,409,107,253,65,156,Center,16,Jump Shot,15.009779951100244
2013-14,202690,Jimmer Fredette,SG,107,227,67,143,40,84,Center,13,Jump Shot,16.07488986784141
2014-15,202690,Jimmer Fredette,PG,63,166,54,118,9,48,Center,5,Jump Shot,13.210843373493976
2015-16,202690,Jimmer Fredette,SG,2,5,1,3,1,2,Center,2,Jump Shot,13.8
2018-19,202690,Jimmer Fredette,SG,8,29,8,16,0,13,Center,1,Jump Shot,18.310344827586206
2011-12,202710,Jimmy Butler,SG,32,79,30,68,2,11,Center,4,Jump Shot,9.949367088607595
2012-13,202710,Jimmy Butler,SF,239,512,199,407,40,105,Center,11,Jump Shot,11.18359375
2013-14,202710,Jimmy Butler,SG,275,693,207,453,68,240,Center,6,Jump Shot,14.157287157287158
2014-15,202710,Jimmy Butler,SG,421,912,348,719,73,193,Center,22,Jump Shot,11.762061403508772
2015-16,202710,Jimmy Butler,SG,470,1035,406,830,64,205,Center,30,Jump Shot,12.015458937198067
2016-17,202710,Jimmy Butler,SF,570,1252,479,1004,91,248,Center,41,Jump Shot,12.373801916932907
2017-18,202710,Jimmy Butler,SG,437,921,367,721,70,200,Center,23,Jump Shot,12.1085776330076
2018-19,202710,Jimmy Butler,SF-SG,418,904,351,711,67,193,Center,24,Jump Shot,11.184734513274336
2019-20,202710,Jimmy Butler,SF,345,758,316,639,29,119,Center,12,Driving Layup Shot,9.536939313984169
2020-21,202710,Jimmy Butler,SF,366,736,341,634,25,102,Center,9,Driving Layup Shot,8.80570652173913
2021-22,202710,Jimmy Butler,SF,398,829,371,713,27,116,Center,12,Driving Layup Shot,9.060313630880579
2022-23,202710,Jimmy Butler,SF,479,888,443,785,36,103,Center,31,Driving Layup Shot,7.88963963963964
2003-04,2412,Jiri Welsch,SG,262,612,193,431,69,181,Center,14,Jump Shot,14.027777777777779
2004-05,2412,Jiri Welsch,SG-SF,149,371,115,261,34,110,Center,11,Jump Shot,14.964959568733153
2005-06,2412,Jiri Welsch,SF,86,222,72,173,14,49,Center,9,Jump Shot,13.536036036036036
2007-08,201149,Joakim Noah,C,177,367,177,366,0,1,Center,6,Layup Shot,2.6158038147138964
2008-09,201149,Joakim Noah,C,207,372,207,371,0,1,Center,5,Layup Shot,0.9220430107526881
2009-10,201149,Joakim Noah,C,262,520,262,520,0,0,Center,12,Layup Shot,3.8211538461538463
2010-11,201149,Joakim Noah,C,211,402,211,401,0,1,Center,3,Jump Shot,4.333333333333333
2011-12,201149,Joakim Noah,C,249,490,249,489,0,1,Center,6,Layup Shot,4.575510204081633
2012-13,201149,Joakim Noah,C,303,630,303,625,0,5,Center,10,Jump Shot,5.787301587301587
2013-14,201149,Joakim Noah,C,380,800,380,798,0,2,Center,6,Jump Shot,5.865
2014-15,201149,Joakim Noah,C,190,427,190,425,0,2,Center,6,Layup Shot,5.353629976580796
2015-16,201149,Joakim Noah,C,51,133,51,132,0,1,Center,0,Tip Layup Shot,2.887218045112782
2016-17,201149,Joakim Noah,C,99,202,99,201,0,1,Center,2,Tip Layup Shot,1.6336633663366336
2017-18,201149,Joakim Noah,C,5,10,5,10,0,0,Center,0,Driving Layup Shot,2.8
2018-19,201149,Joakim Noah,C,110,213,110,212,0,1,Center,3,Cutting Layup Shot,3.4460093896713615
2019-20,201149,Joakim Noah,C,4,8,4,8,0,0,Center,0,Cutting Layup Shot,2.0
2021-22,1629111,Jock Landale,C,101,204,72,115,29,89,Center,12,Jump Shot,12.867647058823529
2022-23,1629111,Jock Landale,C,178,337,157,253,21,84,Center,7,Jump Shot,9.29080118694362
2009-10,201975,Jodie Meeks,SG,104,267,62,136,42,131,Center,13,Jump Shot,16.827715355805243
2010-11,201975,Jodie Meeks,SG,242,570,104,222,138,348,Center,9,Jump Shot,18.196491228070176
2011-12,201975,Jodie Meeks,SG,191,467,94,201,97,266,Center,12,Jump Shot,17.99357601713062
2012-13,201975,Jodie Meeks,SG,205,529,83,188,122,341,Center,9,Jump Shot,17.96219281663516
2013-14,201975,Jodie Meeks,SG,413,891,251,488,162,403,Center,16,Jump Shot,14.347923681257015
2014-15,201975,Jodie Meeks,SG,222,534,148,322,74,212,Center,11,Jump Shot,15.312734082397004
2015-16,201975,Jodie Meeks,SG,7,20,3,11,4,9,Center,0,Jump Shot,15.55
2016-17,201975,Jodie Meeks,SG,103,256,47,119,56,137,Center,2,Jump Shot,17.72265625
2017-18,201975,Jodie Meeks,SG,157,393,85,183,72,210,Center,12,Jump Shot,17.75826972010178
2018-19,201975,Jodie Meeks,SG,21,39,13,21,8,18,Center,3,Jump Shot,14.846153846153847
2008-09,201570,Joe Alexander,SF,102,245,86,199,16,46,Center,15,Jump Shot,11.893877551020408
2009-10,201570,Joe Alexander,SF,1,6,1,5,0,1,Center,1,Jump Shot,9.0
2018-19,1629147,Joe Chealey,PG,1,3,1,3,0,0,Center,0,Driving Floating Jump Shot,8.333333333333334
2019-20,1629147,Joe Chealey,PG,0,7,0,3,0,4,Right Side,0,Jump Shot,16.285714285714285
2008-09,201621,Joe Crawford,SF,3,10,2,6,1,4,Center,1,Jump Shot,11.1
2014-15,203925,Joe Harris,SG,48,120,17,36,31,84,Left Side,9,Jump Shot,18.883333333333333
2015-16,203925,Joe Harris,SG,1,4,0,0,1,4,Right Side Center,1,Jump Shot,25.0
2016-17,203925,Joe Harris,SG,154,362,69,141,85,221,Center,4,Jump Shot,16.825966850828728
2017-18,203925,Joe Harris,SG,305,621,155,263,150,358,Center,8,Jump Shot,15.892109500805153
2018-19,203925,Joe Harris,SG,374,748,191,362,183,386,Center,17,Jump Shot,14.803475935828876
2019-20,203925,Joe Harris,SF,381,784,209,378,172,406,Center,18,Jump Shot,15.012755102040817
2020-21,203925,Joe Harris,SF,357,707,146,263,211,444,Center,7,Jump Shot,17.97878359264498
2021-22,203925,Joe Harris,SF,56,124,15,36,41,88,Center,2,Jump Shot,19.10483870967742
2022-23,203925,Joe Harris,SG,201,440,59,107,142,333,Center,1,Jump Shot,19.970454545454544
2014-15,204060,Joe Ingles,SF,147,354,75,152,72,202,Center,4,Jump Shot,18.347457627118644
2015-16,204060,Joe Ingles,SF,124,291,43,81,81,210,Center,7,Jump Shot,20.10996563573883
2016-17,204060,Joe Ingles,SF,204,451,81,172,123,279,Center,8,Jump Shot,17.66740576496674
2017-18,204060,Joe Ingles,SF,335,718,131,254,204,464,Center,10,Jump Shot,17.97075208913649
2018-19,204060,Joe Ingles,PF,359,802,170,319,189,483,Center,9,Jump Shot,16.80798004987531
2019-20,204060,Joe Ingles,PF,246,553,105,200,141,353,Center,5,Jump Shot,17.84267631103074
2020-21,204060,Joe Ingles,SF,275,562,92,156,183,406,Center,2,Jump Shot,19.355871886120998
2021-22,204060,Joe Ingles,SF,115,285,37,60,78,225,Right Side Center,1,Jump Shot,20.8
2022-23,204060,Joe Ingles,SF,108,248,25,45,83,203,Right Side Center,1,Jump Shot,21.673387096774192
2003-04,2207,Joe Johnson,SG,555,1291,472,1019,83,272,Center,27,Jump Shot,12.90317583268784
2004-05,2207,Joe Johnson,SF,544,1179,367,809,177,370,Center,16,Jump Shot,14.905004240882104
2005-06,2207,Joe Johnson,SG,632,1395,504,1035,128,360,Center,29,Jump Shot,13.245161290322581
2006-07,2207,Joe Johnson,SG,536,1139,417,827,119,312,Center,20,Jump Shot,14.129060579455663
2007-08,2207,Joe Johnson,SG,647,1497,478,1053,169,444,Center,31,Jump Shot,14.593854375417502
2008-09,2207,Joe Johnson,SG,620,1420,471,1006,149,414,Center,31,Jump Shot,14.345070422535212
2009-10,2207,Joe Johnson,SG,635,1386,506,1036,129,350,Center,22,Jump Shot,13.113275613275613
2010-11,2207,Joe Johnson,SG,514,1161,425,861,89,300,Center,14,Jump Shot,13.397071490094746
2011-12,2207,Joe Johnson,SG,423,931,298,609,125,322,Center,23,Jump Shot,15.696025778732546
2012-13,2207,Joe Johnson,SG,445,1052,297,657,148,395,Center,11,Jump Shot,15.865969581749049
2013-14,2207,Joe Johnson,SG,462,1018,300,614,162,404,Center,17,Jump Shot,15.653241650294696
2014-15,2207,Joe Johnson,SG,446,1025,325,688,121,337,Center,18,Jump Shot,14.498536585365853
2015-16,2207,Joe Johnson,SF,377,859,257,546,120,313,Center,25,Jump Shot,15.508731082654249
2016-17,2207,Joe Johnson,SF,273,626,167,368,106,258,Center,12,Jump Shot,16.075079872204473
2017-18,2207,Joe Johnson,SF,146,360,106,215,40,145,Center,3,Jump Shot,16.180555555555557
2021-22,2207,Joe Johnson,SG,1,1,1,1,0,0,Right Side Center,1,Fadeaway Jump Shot,18.0
2003-04,693,Joe Smith,PF,311,708,310,703,1,5,Center,10,Jump Shot,8.943502824858758
2004-05,693,Joe Smith,PF,319,621,319,620,0,1,Center,17,Jump Shot,9.035426731078905
2005-06,693,Joe Smith,PF,145,305,145,303,0,2,Center,7,Jump Shot,9.429508196721311
2006-07,693,Joe Smith,PF,214,477,214,472,0,5,Center,6,Jump Shot,9.754716981132075
2007-08,693,Joe Smith,PF,312,653,312,650,0,3,Center,6,Jump Shot,11.075038284839204
2008-09,693,Joe Smith,C,156,333,153,326,3,7,Center,4,Jump Shot,10.87987987987988
2009-10,693,Joe Smith,PF,77,193,76,186,1,7,Center,2,Jump Shot,11.424870466321243
2010-11,693,Joe Smith,PF,3,16,3,16,0,0,Right Side,1,Jump Shot,13.75
2021-22,1630580,Joe Wieskamp,SG,20,56,6,13,14,43,Right Side Center,8,Jump Shot,21.053571428571427
2022-23,1630580,Joe Wieskamp,SF,3,14,0,2,3,12,Right Side,0,Jump Shot,20.357142857142858
2015-16,1626202,Joe Young,PG,62,168,52,123,10,45,Center,8,Jump Shot,14.56547619047619
2016-17,1626202,Joe Young,PG,26,72,21,49,5,23,Center,16,Jump Shot,15.777777777777779
2017-18,1626202,Joe Young,PG,80,186,55,120,25,66,Center,13,Jump Shot,15.56989247311828
2007-08,201202,Joel Anthony,PF,28,60,28,60,0,0,Center,1,Layup Shot,4.183333333333334
2008-09,201202,Joel Anthony,C,57,118,57,118,0,0,Center,1,Layup Shot,3.211864406779661
2009-10,201202,Joel Anthony,C,76,159,76,159,0,0,Center,2,Jump Shot,2.729559748427673
2010-11,201202,Joel Anthony,C,53,99,53,99,0,0,Center,1,Jump Shot,4.040404040404041
2011-12,201202,Joel Anthony,C,85,152,85,152,0,0,Center,1,Layup Shot,3.375
2012-13,201202,Joel Anthony,C,35,68,35,68,0,0,Center,5,Jump Shot,4.794117647058823
2013-14,201202,Joel Anthony,C,12,32,12,32,0,0,Center,2,Jump Shot,6.625
2014-15,201202,Joel Anthony,C,36,62,36,62,0,0,Center,5,Jump Shot,3.6129032258064515
2015-16,201202,Joel Anthony,C,6,10,6,10,0,0,Center,0,Jump Shot,4.4
2016-17,201202,Joel Anthony,C,10,16,10,16,0,0,Center,4,Jump Shot,3.375
2021-22,1630555,Joel Ayayi,SG,1,6,1,5,0,1,Center,0,Pullup Jump shot,12.166666666666666
2016-17,1627762,Joel Bolomboy,PF,9,16,8,12,1,4,Center,5,Jump Shot,8.1875
2017-18,1627762,Joel Bolomboy,PF,3,6,3,5,0,1,Center,1,Pullup Jump shot,6.5
2016-17,203954,Joel Embiid,C,200,429,164,331,36,98,Center,13,Jump Shot,10.72960372960373
2017-18,203954,Joel Embiid,C,510,1056,444,842,66,214,Center,19,Jump Shot,11.094696969696969
2018-19,203954,Joel Embiid,C,580,1199,501,936,79,263,Center,14,Jump Shot,10.456213511259383
2019-20,203954,Joel Embiid,C,382,801,325,629,57,172,Center,22,Jump Shot,11.931335830212234
2020-21,203954,Joel Embiid,C,461,899,403,745,58,154,Center,16,Jump Shot,11.363737486095662
2021-22,203954,Joel Embiid,C,666,1334,573,1083,93,251,Center,28,Jump Shot,11.423538230884558
2022-23,203954,Joel Embiid,C,728,1328,662,1128,66,200,Center,26,Jump Shot,10.855421686746988
2012-13,200777,Joel Freeland,PF,58,142,58,142,0,0,Center,10,Jump Shot,8.288732394366198
2013-14,200777,Joel Freeland,C,77,162,77,160,0,2,Center,2,Jump Shot,8.11111111111111
2014-15,200777,Joel Freeland,C,74,151,74,151,0,0,Center,5,Jump Shot,8.602649006622517
2003-04,2038,Joel Przybilla,C,18,50,18,50,0,0,Center,2,Layup Shot,4.14
2004-05,2038,Joel Przybilla,C,199,333,199,333,0,0,Center,6,Layup Shot,2.735735735735736
2005-06,2038,Joel Przybilla,C,131,239,131,239,0,0,Center,4,Layup Shot,2.192468619246862
2006-07,2038,Joel Przybilla,C,37,78,37,78,0,0,Center,1,Jump Shot,4.32051282051282
2007-08,2038,Joel Przybilla,C,144,250,144,249,0,1,Center,1,Layup Shot,1.54
2008-09,2038,Joel Przybilla,C,168,269,168,268,0,1,Center,2,Layup Shot,1.137546468401487
2009-10,2038,Joel Przybilla,C,45,86,45,86,0,0,Center,2,Layup Shot,0.5
2010-11,2038,Joel Przybilla,C,25,44,25,44,0,0,Center,0,Layup Shot,1.3863636363636365
2011-12,2038,Joel Przybilla,C,22,48,22,48,0,0,Center,0,Layup Shot,2.1458333333333335
2012-13,2038,Joel Przybilla,C,1,4,1,4,0,0,Center,0,Layup Shot,0.25
2008-09,201595,Joey Dorsey,PF,1,2,1,2,0,0,Center,1,Dunk Shot,0.0
2009-10,201595,Joey Dorsey,PF,9,20,9,20,0,0,Center,0,Layup Shot,0.95
2010-11,201595,Joey Dorsey,C,52,99,52,99,0,0,Center,3,Layup Shot,1.393939393939394
2014-15,201595,Joey Dorsey,PF,80,145,80,144,0,1,Center,2,Layup Shot,1.9793103448275862
2005-06,101121,Joey Graham,SF,198,414,169,327,29,87,Center,7,Jump Shot,11.567632850241546
2006-07,101121,Joey Graham,SF,192,388,183,357,9,31,Center,5,Jump Shot,10.716494845360824
2007-08,101121,Joey Graham,SF,49,113,47,110,2,3,Center,10,Jump Shot,9.725663716814159
2008-09,101121,Joey Graham,SF,231,480,228,464,3,16,Center,7,Jump Shot,8.13125
2009-10,101121,Joey Graham,SF,105,202,103,189,2,13,Center,5,Jump Shot,8.326732673267326
2010-11,101121,Joey Graham,SF,82,179,73,149,9,30,Center,3,Jump Shot,12.754189944134078
2014-15,203530,Joffrey Lauvergne,C,36,89,33,73,3,16,Center,5,Jump Shot,7.921348314606742
2015-16,203530,Joffrey Lauvergne,C,195,380,182,327,13,53,Center,2,Jump Shot,8.442105263157895
2016-17,203530,Joffrey Lauvergne,PF-C,148,336,115,238,33,98,Center,3,Jump Shot,10.458333333333334
2017-18,203530,Joffrey Lauvergne,C,98,190,98,185,0,5,Center,11,Hook Shot,4.505263157894737
2005-06,101130,Johan Petro,C,153,300,153,300,0,0,Center,6,Jump Shot,4.58
2006-07,101130,Johan Petro,C,226,438,226,438,0,0,Center,10,Jump Shot,7.844748858447488
2007-08,101130,Johan Petro,C,184,439,184,438,0,1,Center,8,Jump Shot,9.29384965831435
2008-09,101130,Johan Petro,C,73,176,73,174,0,2,Center,6,Jump Shot,8.869318181818182
2009-10,101130,Johan Petro,C,54,101,54,100,0,1,Center,6,Jump Shot,7.99009900990099
2010-11,101130,Johan Petro,C,129,290,129,286,0,4,Center,11,Jump Shot,12.148275862068965
2011-12,101130,Johan Petro,C,109,260,108,259,1,1,Center,6,Jump Shot,10.65
2012-13,101130,Johan Petro,C,48,110,47,106,1,4,Center,5,Jump Shot,8.381818181818181
2022-23,1631219,John Butler Jr.,,17,53,9,18,8,35,Center,4,Jump Shot,18.50943396226415
2017-18,1628381,John Collins,PF,314,545,298,498,16,47,Center,15,Jump Shot,5.711926605504587
2018-19,1628381,John Collins,PF,465,831,410,673,55,158,Center,24,Jump Shot,7.1516245487364625
2019-20,1628381,John Collins,PF,353,605,294,458,59,147,Center,16,Jump Shot,8.87107438016529
2020-21,1628381,John Collins,PF,429,771,346,563,83,208,Center,10,Jump Shot,10.447470817120623
2021-22,1628381,John Collins,PF,339,644,275,468,64,176,Center,11,Jump Shot,10.557453416149068
2022-23,1628381,John Collins,PF,359,707,289,467,70,240,Center,11,Jump Shot,11.700141442715701
2004-05,2823,John Edwards,C,11,30,11,30,0,0,Center,2,Jump Shot,6.566666666666666
2005-06,2823,John Edwards,C,31,64,31,64,0,0,Center,1,Jump Shot,7.15625
2012-13,203089,John Henson,PF,162,336,162,333,0,3,Center,12,Jump Shot,5.419642857142857
2013-14,203089,John Henson,PF,344,639,344,638,0,1,Center,10,Hook Shot,4.588419405320813
2014-15,203089,John Henson,C,196,346,196,346,0,0,Center,5,Layup Shot,2.491329479768786
2015-16,203089,John Henson,C,164,291,164,290,0,1,Center,2,Hook Shot,3.3402061855670104
2016-17,203089,John Henson,C,159,308,159,308,0,0,Center,5,Hook Shot,4.392857142857143
2017-18,203089,John Henson,C,287,502,286,495,1,7,Center,7,Hook Shot,4.4800796812749
2018-19,203089,John Henson,C,31,67,20,36,11,31,Center,2,Jump Shot,12.985074626865671
2019-20,203089,John Henson,C,95,171,87,135,8,36,Center,0,Jump Shot,7.707602339181286
2017-18,204066,John Holland,SF,17,59,6,23,11,36,Center,3,Jump Shot,17.728813559322035
2012-13,203098,John Jenkins,SG,131,294,78,156,53,138,Center,10,Jump Shot,17.231292517006803
2013-14,203098,John Jenkins,SG,16,42,12,24,4,18,Center,1,Jump Shot,13.547619047619047
2014-15,203098,John Jenkins,SG,49,99,28,47,21,52,Center,9,Jump Shot,19.04040404040404
2015-16,203098,John Jenkins,SG,71,160,55,109,16,51,Center,12,Jump Shot,15.6125
2016-17,203098,John Jenkins,SG,2,5,1,3,1,2,Left Side Center,1,Jump Shot,21.2
2018-19,203098,John Jenkins,SG,42,105,20,47,22,58,Right Side Center,1,Jump Shot,20.17142857142857
2019-20,1629723,John Konchar,SG,24,37,19,27,5,10,Center,5,Jump Shot,8.054054054054054
2020-21,1629723,John Konchar,SG,69,138,48,82,21,56,Center,2,Jump Shot,11.971014492753623
2021-22,1629723,John Konchar,SG,135,262,83,136,52,126,Center,7,Jump Shot,13.84732824427481
2022-23,1629723,John Konchar,SG,138,320,78,143,60,177,Center,2,Jump Shot,14.81875
2005-06,101249,John Lucas III,PG,14,36,12,27,2,9,Center,6,Jump Shot,14.25
2006-07,101249,John Lucas III,PG,62,156,47,97,15,59,Center,9,Jump Shot,14.51923076923077
2010-11,101249,John Lucas III,PG,1,3,1,2,0,1,Right Side Center,0,Jump Shot,20.666666666666668
2011-12,101249,John Lucas III,PG,143,358,88,218,55,140,Center,9,Jump Shot,17.40223463687151
2012-13,101249,John Lucas III,PG,128,333,72,183,56,150,Center,11,Jump Shot,17.663663663663662
2013-14,101249,John Lucas III,PG,62,190,37,106,25,84,Center,9,Jump Shot,16.78421052631579
2014-15,101249,John Lucas III,PG,42,104,33,75,9,29,Center,4,Jump Shot,16.826923076923077
2016-17,101249,John Lucas III,PG,1,4,1,3,0,1,Left Side,1,Jump Shot,13.0
2003-04,2422,John Salmons,SG,161,416,111,269,50,147,Center,5,Jump Shot,14.680288461538462
2004-05,2422,John Salmons,SG,85,210,54,119,31,91,Center,4,Jump Shot,14.619047619047619
2005-06,2422,John Salmons,SG,219,521,193,434,26,87,Center,10,Jump Shot,9.950095969289828
2006-07,2422,John Salmons,SG,236,517,196,405,40,112,Center,11,Jump Shot,11.011605415860735
2007-08,2422,John Salmons,SG,381,799,342,679,39,120,Center,20,Jump Shot,8.81727158948686
2008-09,2422,John Salmons,SF,516,1093,390,791,126,302,Center,16,Jump Shot,12.512351326623971
2009-10,2422,John Salmons,SG,436,990,319,682,117,308,Center,13,Jump Shot,13.833333333333334
2010-11,2422,John Salmons,SG,373,898,290,679,83,219,Center,9,Jump Shot,13.733853006681514
2011-12,2422,John Salmons,SF,141,345,108,233,33,112,Center,5,Jump Shot,15.649275362318841
2012-13,2422,John Salmons,SF,244,612,145,345,99,267,Center,6,Jump Shot,16.233660130718953
2013-14,2422,John Salmons,SG-SF,150,413,87,250,63,163,Center,5,Jump Shot,16.79418886198547
2014-15,2422,John Salmons,SF,16,48,8,22,8,26,Right Side Center,0,Jump Shot,19.375
2004-05,1519,John Thomas,C,42,86,42,86,0,0,Center,4,Layup Shot,2.9302325581395348
2005-06,1519,John Thomas,C,6,15,6,15,0,0,Center,1,Layup Shot,3.066666666666667
2010-11,202322,John Wall,PG,398,972,364,857,34,115,Center,28,Jump Shot,10.47119341563786
2011-12,202322,John Wall,PG,378,894,375,852,3,42,Center,16,Jump Shot,9.076062639821028
2012-13,202322,John Wall,PG,324,735,312,690,12,45,Center,13,Jump Shot,10.81360544217687
2013-14,202322,John Wall,PG,579,1337,471,1029,108,308,Center,32,Jump Shot,13.954375467464473
2014-15,202322,John Wall,PG,519,1166,454,949,65,217,Center,30,Jump Shot,13.027444253859349
2015-16,202322,John Wall,PG,571,1347,457,1021,114,326,Center,27,Jump Shot,13.64513734224202
2016-17,202322,John Wall,PG,647,1435,558,1163,89,272,Center,46,Jump Shot,11.418815331010453
2017-18,202322,John Wall,PG,280,667,218,500,62,167,Center,14,Jump Shot,13.032983508245877
2018-19,202322,John Wall,PG,245,552,194,383,51,169,Center,11,Jump Shot,12.373188405797102
2020-21,202322,John Wall,PG,293,726,214,477,79,249,Center,7,Jump Shot,13.714876033057852
2022-23,202322,John Wall,PG,138,339,105,230,33,109,Center,0,Jump Shot,13.96755162241888
2003-04,961,John Wallace,SF,61,145,56,132,5,13,Center,8,Jump Shot,12.50344827586207
2017-18,1628405,Johnathan Motley,PF,40,75,39,69,1,6,Center,6,Jump Shot,7.8
2018-19,1628405,Johnathan Motley,PF,39,73,39,70,0,3,Center,12,Layup Shot,4.232876712328767
2019-20,1628405,Johnathan Motley,PF,11,15,10,14,1,1,Center,4,Cutting Layup Shot,3.4
2018-19,1629140,Johnathan Williams,C,65,110,65,108,0,2,Center,2,Putback Layup Shot,3.3545454545454545
2019-20,1629140,Johnathan Williams,PF,19,34,19,32,0,2,Center,2,Jump Shot,8.235294117647058
2022-23,1631098,Johnny Davis,SG,66,171,49,101,17,70,Center,10,Jump Shot,15.309941520467836
2022-23,1630548,Johnny Juzang,SF,35,104,20,41,15,63,Center,3,Jump Shot,18.76923076923077
2014-15,203948,Johnny O'Bryant III,PF,44,120,44,120,0,0,Center,6,Jump Shot,10.283333333333333
2015-16,203948,Johnny O'Bryant III,PF,86,209,85,208,1,1,Center,7,Jump Shot,9.358851674641148
2016-17,203948,Johnny O'Bryant III,PF,15,30,12,24,3,6,Center,3,Jump Shot,10.9
2017-18,203948,Johnny O'Bryant III,PF,68,171,54,128,14,43,Center,7,Jump Shot,13.321637426900585
2003-04,468,Jon Barry,SG,120,297,69,159,51,138,Center,7,Jump Shot,17.575757575757574
2004-05,468,Jon Barry,SG,161,368,90,203,71,165,Center,8,Jump Shot,17.695652173913043
2005-06,468,Jon Barry,SG,25,65,13,33,12,32,Left Side,3,Jump Shot,17.876923076923077
2009-10,201972,Jon Brockman,PF,55,103,55,103,0,0,Center,1,Layup Shot,3.1650485436893203
2010-11,201972,Jon Brockman,C,48,94,48,94,0,0,Center,6,Layup Shot,3.3085106382978724
2011-12,201972,Jon Brockman,PF,15,45,15,44,0,1,Center,5,Layup Shot,6.533333333333333
2011-12,202720,Jon Leuer,PF,97,191,94,182,3,9,Center,15,Jump Shot,10.434554973821989
2012-13,202720,Jon Leuer,PF-C,25,52,25,49,0,3,Center,4,Jump Shot,11.788461538461538
2013-14,202720,Jon Leuer,PF,121,246,98,197,23,49,Center,14,Jump Shot,11.882113821138212
2014-15,202720,Jon Leuer,PF,121,273,114,244,7,29,Center,7,Jump Shot,10.758241758241759
2015-16,202720,Jon Leuer,PF,224,466,182,356,42,110,Center,10,Jump Shot,11.32403433476395
2016-17,202720,Jon Leuer,PF,310,646,261,479,49,167,Center,6,Jump Shot,12.462848297213622
2017-18,202720,Jon Leuer,PF,15,36,15,33,0,3,Center,0,Jump Shot,8.11111111111111
2018-19,202720,Jon Leuer,PF,66,113,65,102,1,11,Center,7,Jump Shot,7.884955752212389
2021-22,1630257,Jon Teske,C,0,1,0,1,0,0,Right Side,0,Floating Jump shot,15.0
2018-19,1628413,Jonah Bolden,PF,80,162,46,66,34,96,Center,4,Jump Shot,15.808641975308642
2019-20,1628413,Jonah Bolden,C,4,11,4,7,0,4,Center,1,Jump Shot,9.090909090909092
2009-10,201973,Jonas Jerebko,PF,290,603,254,488,36,115,Center,10,Jump Shot,8.102819237147596
2011-12,201973,Jonas Jerebko,PF,212,453,180,347,32,106,Center,5,Jump Shot,10.883002207505518
2012-13,201973,Jonas Jerebko,PF,142,316,117,233,25,83,Center,11,Jump Shot,10.050632911392405
2013-14,201973,Jonas Jerebko,PF,98,208,67,134,31,74,Center,10,Jump Shot,12.711538461538462
2014-15,201973,Jonas Jerebko,PF,169,379,115,239,54,140,Center,12,Jump Shot,13.37203166226913
2015-16,201973,Jonas Jerebko,PF,118,286,75,178,43,108,Center,7,Jump Shot,12.961538461538462
2016-17,201973,Jonas Jerebko,PF,114,262,69,132,45,130,Center,3,Jump Shot,14.977099236641221
2017-18,201973,Jonas Jerebko,PF,159,341,94,184,65,157,Center,6,Jump Shot,14.03225806451613
2018-19,201973,Jonas Jerebko,PF,163,355,94,167,69,188,Center,7,Jump Shot,16.194366197183097
2012-13,202685,Jonas Valanciunas,C,204,366,204,366,0,0,Center,4,Jump Shot,5.368852459016393
2013-14,202685,Jonas Valanciunas,C,359,676,359,675,0,1,Center,8,Jump Shot,5.338757396449704
2014-15,202685,Jonas Valanciunas,C,373,652,373,651,0,1,Center,4,Layup Shot,4.104294478527607
2015-16,202685,Jonas Valanciunas,C,303,536,303,536,0,0,Center,13,Jump Shot,4.276119402985074
2016-17,202685,Jonas Valanciunas,C,391,702,390,700,1,2,Center,10,Jump Shot,5.901709401709402
2017-18,202685,Jonas Valanciunas,C,390,687,360,613,30,74,Center,5,Jump Shot,6.446870451237263
2018-19,202685,Jonas Valanciunas,C,301,538,287,490,14,48,Center,16,Jump Shot,6.514869888475836
2019-20,202685,Jonas Valanciunas,C,432,739,400,648,32,91,Center,7,Jump Shot,6.690121786197564
2020-21,202685,Jonas Valanciunas,C,440,743,419,686,21,57,Center,14,Jump Shot,5.6218034993270525
2021-22,202685,Jonas Valanciunas,C,510,938,453,780,57,158,Center,14,Jump Shot,8.639658848614072
2022-23,202685,Jonas Valanciunas,C,446,816,408,707,38,109,Center,1,Jump Shot,7.756127450980392
2003-04,1886,Jonathan Bender,SF,50,106,41,84,9,22,Center,6,Jump Shot,10.716981132075471
2004-05,1886,Jonathan Bender,SF,16,40,15,35,1,5,Center,0,Jump Shot,10.2
2005-06,1886,Jonathan Bender,SF,4,5,4,5,0,0,Center,0,Slam Dunk Shot,2.2
2009-10,1886,Jonathan Bender,SF,40,100,26,61,14,39,Center,1,Jump Shot,13.96
2016-17,1626780,Jonathan Gibson,PG,35,95,20,50,15,45,Center,7,Jump Shot,17.442105263157895
2017-18,1626780,Jonathan Gibson,PG,14,23,8,11,6,12,Center,4,Jump Shot,16.130434782608695
2017-18,1628371,Jonathan Isaac,PF,55,145,39,99,16,46,Center,2,Jump Shot,13.813793103448276
2018-19,1628371,Jonathan Isaac,PF,262,611,176,345,86,266,Center,6,Jump Shot,14.220949263502455
2019-20,1628371,Jonathan Isaac,PF,156,332,124,238,32,94,Center,10,Jump Shot,11.58433734939759
2022-23,1628371,Jonathan Isaac,PF,22,53,16,38,6,15,Center,0,Jump Shot,11.452830188679245
2021-22,1630228,Jonathan Kuminga,SF,236,460,186,311,50,149,Center,15,Jump Shot,10.567391304347826
2022-23,1630228,Jonathan Kuminga,PF,261,497,207,351,54,146,Center,13,Jump Shot,10.191146881287727
2015-16,203613,Jonathon Simmons,SG,122,242,104,195,18,47,Center,20,Jump Shot,8.417355371900827
2016-17,203613,Jonathon Simmons,SG,177,421,147,319,30,102,Center,12,Jump Shot,11.558194774346793
2017-18,203613,Jonathon Simmons,SG,354,761,285,557,69,204,Center,16,Jump Shot,11.868593955321945
2018-19,203613,Jonathon Simmons,SG-SF,133,350,105,246,28,104,Center,7,Jump Shot,12.551428571428572
2009-10,201938,Jonny Flynn,PG,397,952,320,737,77,215,Center,28,Jump Shot,11.989495798319327
2010-11,201938,Jonny Flynn,PG,108,296,77,196,31,100,Center,2,Jump Shot,15.905405405405405
2011-12,201938,Jonny Flynn,PG,46,131,36,97,10,34,Center,2,Jump Shot,12.679389312977099
2020-21,1629007,Jontay Porter,PF,8,15,5,7,3,8,Center,3,Jump Shot,18.066666666666666
2014-15,203919,Jordan Adams,SG,35,86,25,61,10,25,Center,6,Jump Shot,12.523255813953488
2015-16,203919,Jordan Adams,SG,2,6,2,5,0,1,Center,0,Jump Shot,10.833333333333334
2017-18,1628395,Jordan Bell,C,116,185,116,181,0,4,Center,8,Layup Shot,3.962162162162162
2018-19,1628395,Jordan Bell,C,99,192,99,190,0,2,Center,13,Jump Shot,7.625
2019-20,1628395,Jordan Bell,C,35,67,31,55,4,12,Center,2,Jump Shot,6.731343283582089
2020-21,1628395,Jordan Bell,C,7,22,7,20,0,2,Center,1,Tip Layup Shot,5.545454545454546
2019-20,1629648,Jordan Bone,PG,5,20,3,10,2,10,Left Side Center,3,Jump Shot,17.45
2020-21,1629648,Jordan Bone,PG,23,54,13,22,10,32,Center,2,Jump Shot,20.333333333333332
2014-15,203903,Jordan Clarkson,PG,267,596,229,475,38,121,Center,22,Jump Shot,11.798657718120806
2015-16,203903,Jordan Clarkson,SG,474,1096,364,778,110,318,Center,17,Jump Shot,12.610401459854014
2016-17,203903,Jordan Clarkson,SG,475,1068,360,715,115,353,Center,23,Jump Shot,12.987827715355806
2017-18,203903,Jordan Clarkson,SG,430,954,318,636,112,318,Center,14,Jump Shot,13.725366876310273
2018-19,203903,Jordan Clarkson,SG,529,1180,385,735,144,445,Center,18,Jump Shot,14.166101694915254
2019-20,203903,Jordan Clarkson,SG,394,867,242,454,152,413,Center,7,Jump Shot,14.815455594002307
2020-21,203903,Jordan Clarkson,SG,457,1075,249,476,208,599,Center,7,Jump Shot,16.7153488372093
2021-22,203903,Jordan Clarkson,SG,466,1113,276,516,190,597,Center,8,Jump Shot,16.38364779874214
2022-23,203903,Jordan Clarkson,SG,458,1031,303,572,155,459,Center,25,Jump Shot,14.992240543161978
2010-11,202348,Jordan Crawford,SG,192,500,159,372,33,128,Center,8,Jump Shot,14.38
2011-12,202348,Jordan Crawford,SG,349,872,270,599,79,273,Center,12,Jump Shot,15.035550458715596
2012-13,202348,Jordan Crawford,SG,301,725,218,479,83,246,Center,13,Jump Shot,15.324137931034484
2013-14,202348,Jordan Crawford,SG-PG,327,787,237,503,90,284,Center,12,Jump Shot,15.48284625158831
2016-17,202348,Jordan Crawford,SG,105,218,68,123,37,95,Center,9,Jump Shot,17.027522935779817
2017-18,202348,Jordan Crawford,SG,12,27,4,13,8,14,Center,2,Jump Shot,19.48148148148148
2006-07,200770,Jordan Farmar,PG,124,294,79,157,45,137,Center,10,Jump Shot,15.200680272108844
2007-08,200770,Jordan Farmar,PG,291,631,177,324,114,307,Center,11,Jump Shot,15.559429477020602
2008-09,200770,Jordan Farmar,PG,161,412,112,266,49,146,Center,7,Jump Shot,13.45873786407767
2009-10,200770,Jordan Farmar,PG,224,515,138,286,86,229,Center,6,Jump Shot,15.497087378640776
2010-11,200770,Jordan Farmar,PG,255,651,146,347,109,304,Center,11,Jump Shot,15.71889400921659
2011-12,200770,Jordan Farmar,PG,147,315,92,190,55,125,Center,8,Jump Shot,15.133333333333333
2013-14,200770,Jordan Farmar,PG,150,363,81,204,69,159,Center,7,Jump Shot,16.052341597796143
2014-15,200770,Jordan Farmar,PG,61,158,26,61,35,97,Center,5,Jump Shot,19.79746835443038
2015-16,200770,Jordan Farmar,PG,42,100,26,55,16,45,Center,6,Jump Shot,15.79
2016-17,200770,Jordan Farmar,PG,4,12,0,3,4,9,Center,0,Jump Shot,21.166666666666668
2021-22,1630692,Jordan Goodwin,SG,0,3,0,2,0,1,Right Side Center,0,Jump Shot,16.0
2022-23,1630692,Jordan Goodwin,PG,158,353,120,235,38,118,Center,17,Jump Shot,13.286118980169972
2022-23,1631160,Jordan Hall,SF,9,28,6,13,3,15,Center,3,Jump Shot,18.607142857142858
2011-12,202706,Jordan Hamilton,SF,48,111,31,64,17,47,Center,10,Jump Shot,14.513513513513514
2012-13,202706,Jordan Hamilton,SF,84,201,57,128,27,73,Center,14,Jump Shot,13.039800995024876
2013-14,202706,Jordan Hamilton,SF,147,376,77,178,70,198,Center,7,Jump Shot,16.377659574468087
2014-15,202706,Jordan Hamilton,SF,14,35,4,14,10,21,Center,3,Jump Shot,18.8
2015-16,202706,Jordan Hamilton,SF,49,116,36,71,13,45,Center,4,Jump Shot,13.982758620689655
2009-10,201941,Jordan Hill,PF,99,201,99,199,0,2,Center,8,Jump Shot,7.298507462686567
2010-11,201941,Jordan Hill,C,173,352,173,350,0,2,Center,8,Jump Shot,6.923295454545454
2011-12,201941,Jordan Hill,C,82,165,82,162,0,3,Center,5,Jump Shot,7.363636363636363
2012-13,201941,Jordan Hill,PF,77,155,77,153,0,2,Center,1,Jump Shot,7.864516129032258
2013-14,201941,Jordan Hill,PF,286,521,286,520,0,1,Center,8,Jump Shot,5.975047984644914
2014-15,201941,Jordan Hill,C,357,777,354,766,3,11,Center,18,Jump Shot,10.454311454311455
2015-16,201941,Jordan Hill,C,278,549,278,548,0,1,Center,8,Jump Shot,7.998178506375227
2016-17,201941,Jordan Hill,C,5,13,5,13,0,0,Center,1,Jump Shot,7.538461538461538
2018-19,1628070,Jordan Loyd,PG,8,18,4,10,4,8,Center,4,Jump Shot,15.61111111111111
2019-20,1629162,Jordan McLaughlin,PG,87,178,58,102,29,76,Center,5,Driving Layup Shot,12.882022471910112
2020-21,1629162,Jordan McLaughlin,PG,100,242,67,150,33,92,Center,7,Jump Shot,11.694214876033058
2021-22,1629162,Jordan McLaughlin,PG,88,200,61,115,27,85,Center,6,Jump Shot,12.755
2022-23,1629162,Jordan McLaughlin,PG,61,145,37,67,24,78,Center,2,Jump Shot,16.2
2015-16,203895,Jordan McRae,PG,34,78,24,56,10,22,Center,10,Jump Shot,12.192307692307692
2016-17,203895,Jordan McRae,SG,58,150,40,99,18,51,Center,10,Jump Shot,13.626666666666667
2018-19,203895,Jordan McRae,SG,61,130,51,95,10,35,Center,7,Jump Shot,14.276923076923078
2019-20,203895,Jordan McRae,SG,149,366,104,240,45,126,Center,13,Jump Shot,14.478142076502733
2015-16,1626175,Jordan Mickey,PF,8,22,8,22,0,0,Center,2,Layup Shot,3.727272727272727
2016-17,1626175,Jordan Mickey,PF,15,34,15,33,0,1,Center,2,Layup Shot,4.823529411764706
2017-18,1626175,Jordan Mickey,PF,39,82,37,66,2,16,Center,2,Jump Shot,7.621951219512195
2020-21,1629670,Jordan Nwora,SF,62,135,34,73,28,62,Center,9,Jump Shot,16.303703703703704
2021-22,1629670,Jordan Nwora,SF,186,462,107,235,79,227,Center,8,Jump Shot,16.31168831168831
2022-23,1629670,Jordan Nwora,SF,194,445,108,234,86,211,Center,7,Jump Shot,15.024719101123596
2019-20,1629673,Jordan Poole,SG,167,502,93,237,74,265,Center,14,Jump Shot,18.61354581673307
2020-21,1629673,Jordan Poole,SG,205,474,108,198,97,276,Center,19,Jump Shot,18.08649789029536
2021-22,1629673,Jordan Poole,SG,474,1058,263,478,211,580,Center,28,Jump Shot,17.273156899810964
2022-23,1629673,Jordan Poole,PG,550,1278,336,641,214,637,Center,18,Jump Shot,16.790297339593113
2021-22,1630648,Jordan Schakel,SG,1,11,0,5,1,6,Center,0,Jump Shot,17.272727272727273
2022-23,1630648,Jordan Schakel,SF,1,2,0,1,1,1,Center,1,Driving Layup Shot,15.5
2018-19,1626296,Jordan Sibert,SG,1,1,0,0,1,1,Left Side Center,0,Jump Shot,25.0
2011-12,202716,Jordan Williams,C,77,152,77,152,0,0,Center,4,Layup Shot,4.269736842105263
2006-07,200816,Jorge Garbajosa,PF,222,529,156,336,66,193,Center,7,Jump Shot,17.8468809073724
2007-08,200816,Jorge Garbajosa,PF,8,25,2,9,6,16,Right Side,1,Jump Shot,21.96
2013-14,203268,Jorge Gutierrez,PG,25,54,22,42,3,12,Center,2,Jump Shot,11.425925925925926
2014-15,203268,Jorge Gutierrez,PG,22,41,22,38,0,3,Center,2,Jump Shot,9.804878048780488
2015-16,203268,Jorge Gutierrez,PG,6,11,6,9,0,2,Center,2,Jump Shot,12.454545454545455
2021-22,1630631,Jose Alvarado,PG,131,294,99,184,32,110,Center,8,Jump Shot,13.064625850340136
2022-23,1630631,Jose Alvarado,PG,201,489,118,242,83,247,Center,6,Jump Shot,15.049079754601227
2005-06,101181,Jose Calderon,SG,132,312,125,269,7,43,Center,6,Jump Shot,11.256410256410257
2006-07,101181,Jose Calderon,PG,263,505,238,430,25,75,Center,7,Jump Shot,11.657425742574258
2007-08,101181,Jose Calderon,PG,367,707,288,523,79,184,Center,18,Jump Shot,15.57001414427157
2008-09,101181,Jose Calderon,PG,320,644,238,442,82,202,Center,16,Jump Shot,16.62111801242236
2009-10,101181,Jose Calderon,PG,274,568,206,397,68,171,Center,11,Jump Shot,15.295774647887324
2010-11,101181,Jose Calderon,PG,262,596,205,440,57,156,Center,11,Jump Shot,15.609060402684564
2011-12,101181,Jose Calderon,PG,218,477,159,318,59,159,Center,16,Jump Shot,17.9895178197065
2012-13,101181,Jose Calderon,PG,312,635,182,353,130,282,Center,13,Jump Shot,18.891338582677164
2013-14,101181,Jose Calderon,PG,341,748,150,323,191,425,Left Side Center,6,Jump Shot,19.772727272727273
2014-15,101181,Jose Calderon,PG,147,354,88,212,59,142,Right Side Center,6,Jump Shot,18.443502824858758
2015-16,101181,Jose Calderon,PG,209,455,125,252,84,203,Left Side Center,4,Jump Shot,18.41978021978022
2016-17,101181,Jose Calderon,PG,55,134,35,70,20,64,Left Side Center,2,Jump Shot,18.05223880597015
2017-18,101181,Jose Calderon,PG,93,185,48,88,45,97,Center,2,Jump Shot,17.832432432432434
2018-19,101181,Jose Calderon,PG,45,120,31,63,14,57,Center,0,Jump Shot,18.583333333333332
2012-13,203006,Josh Akognon,PG,2,4,1,2,1,2,Right Side Center,1,Jump Shot,23.5
2006-07,200767,Josh Boone,PF,99,171,99,171,0,0,Center,5,Layup Shot,0.8187134502923976
2007-08,200767,Josh Boone,PF,238,434,238,434,0,0,Center,12,Layup Shot,1.7741935483870968
2008-09,200767,Josh Boone,C,113,214,113,214,0,0,Center,5,Layup Shot,2.8738317757009346
2009-10,200767,Josh Boone,PF,117,223,117,223,0,0,Center,5,Layup Shot,2.9506726457399104
2004-05,2735,Josh Childress,SG,302,642,289,586,13,56,Center,23,Jump Shot,6.419003115264798
2005-06,2735,Josh Childress,SF,278,504,246,439,32,65,Center,16,Jump Shot,6.402777777777778
2006-07,2735,Josh Childress,SG,261,518,235,441,26,77,Center,13,Jump Shot,7.073359073359073
2007-08,2735,Josh Childress,SF,327,573,305,513,22,60,Center,11,Layup Shot,4.37696335078534
2010-11,2735,Josh Childress,SG,121,214,120,198,1,16,Center,7,Layup Shot,4.009345794392523
2011-12,2735,Josh Childress,SF,48,99,44,75,4,24,Center,2,Jump Shot,7.444444444444445
2012-13,2735,Josh Childress,SF,6,21,5,18,1,3,Center,0,Jump Shot,12.19047619047619
2021-22,1630528,Josh Christopher,SG,224,500,168,311,56,189,Center,23,Jump Shot,12.852
2022-23,1630528,Josh Christopher,SG,153,329,132,240,21,89,Center,17,Jump Shot,11.370820668693009
2003-04,2668,Josh Davis,PF,2,5,2,3,0,2,Center,0,Jump Shot,12.4
2004-05,2668,Josh Davis,PF,42,111,23,58,19,53,Center,6,Jump Shot,13.306306306306306
2005-06,2668,Josh Davis,PF,2,7,2,5,0,2,Center,1,Jump Shot,12.428571428571429
2011-12,2668,Josh Davis,PF,10,27,6,14,4,13,Center,2,Jump Shot,14.74074074074074
2021-22,1630581,Josh Giddey,SF,281,670,225,457,56,213,Center,9,Jump Shot,12.213432835820896
2022-23,1630581,Josh Giddey,SG,539,1118,463,884,76,234,Center,25,Jump Shot,9.126118067978533
2017-18,1627982,Josh Gray,PG,11,41,8,28,3,13,Center,0,Jump Shot,12.121951219512194
2019-20,1627982,Josh Gray,PG,1,2,1,2,0,0,Center,0,Driving Layup Shot,1.5
2020-21,1630182,Josh Green,SG,42,93,38,68,4,25,Center,9,Jump Shot,9.731182795698924
2021-22,1630182,Josh Green,SG,130,256,102,178,28,78,Center,10,Jump Shot,10.5703125
2022-23,1630182,Josh Green,SG,205,382,137,213,68,169,Center,3,Jump Shot,12.612565445026178
2020-21,1630221,Josh Hall,SF,30,99,26,62,4,37,Center,4,Jump Shot,13.383838383838384
2011-12,202725,Josh Harrellson,PF,63,149,43,90,20,59,Center,3,Jump Shot,13.187919463087248
2012-13,202725,Josh Harrellson,C,4,9,3,4,1,5,Center,1,Jump Shot,14.777777777777779
2013-14,202725,Josh Harrellson,C,38,82,26,51,12,31,Center,0,Jump Shot,12.658536585365853
2017-18,1628404,Josh Hart,SG,176,375,98,178,78,197,Center,5,Jump Shot,15.138666666666667
2018-19,1628404,Josh Hart,SG,189,464,97,190,92,274,Center,10,Jump Shot,16.5
2019-20,1628404,Josh Hart,SF,225,532,104,178,121,354,Center,12,Jump Shot,17.68233082706767
2020-21,1628404,Josh Hart,SF,151,344,88,151,63,193,Center,4,Jump Shot,15.61046511627907
2021-22,1628404,Josh Hart,SG,287,569,214,356,73,213,Center,11,Jump Shot,11.9402460456942
2022-23,1628404,Josh Hart,SF-SG,275,520,214,356,61,164,Center,14,Jump Shot,10.113461538461538
2003-04,2572,Josh Howard,SF,229,532,209,466,20,66,Center,4,Jump Shot,9.44548872180451
2004-05,2572,Josh Howard,SF,377,793,343,678,34,115,Center,8,Jump Shot,9.414880201765447
2005-06,2572,Josh Howard,SF,350,743,323,680,27,63,Center,4,Jump Shot,9.099596231493944
2006-07,2572,Josh Howard,SF,493,1075,401,836,92,239,Center,8,Jump Shot,13.229767441860465
2007-08,2572,Josh Howard,SF,567,1247,500,1037,67,210,Center,10,Jump Shot,13.153969526864476
2008-09,2572,Josh Howard,SF,353,783,295,615,58,168,Center,8,Jump Shot,13.338441890166028
2009-10,2572,Josh Howard,SF,157,387,134,302,23,85,Center,3,Jump Shot,14.041343669250645
2010-11,2572,Josh Howard,SF,58,162,51,133,7,29,Center,1,Jump Shot,14.364197530864198
2011-12,2572,Josh Howard,SF,144,361,135,324,9,37,Center,3,Jump Shot,12.614958448753463
2012-13,2572,Josh Howard,SF,31,77,26,61,5,16,Center,0,Jump Shot,14.0
2015-16,203962,Josh Huestis,PF,5,12,1,6,4,6,Center,0,Jump Shot,17.416666666666668
2016-17,203962,Josh Huestis,PF,6,11,4,7,2,4,Center,2,Jump Shot,12.363636363636363
2017-18,203962,Josh Huestis,PF,60,182,27,67,33,115,Center,5,Jump Shot,16.434065934065934
2017-18,1628367,Josh Jackson,SF,389,932,332,715,57,217,Center,14,Jump Shot,10.706008583690988
2018-19,1628367,Josh Jackson,SG,347,841,274,616,73,225,Center,11,Jump Shot,11.20332936979786
2019-20,1628367,Josh Jackson,SF,70,159,47,87,23,72,Center,1,Jump Shot,13.767295597484276
2020-21,1628367,Josh Jackson,SG,296,707,219,450,77,257,Center,14,Jump Shot,12.862800565770863
2021-22,1628367,Josh Jackson,SF,120,300,87,170,33,130,Center,3,Jump Shot,14.44
2017-18,203705,Josh Magette,PG,15,46,7,24,8,22,Center,2,Jump Shot,20.58695652173913
2019-20,203705,Josh Magette,PG,5,15,4,11,1,4,Center,3,Driving Floating Jump Shot,14.6
2007-08,201177,Josh McRoberts,PF,6,10,6,9,0,1,Center,3,Jump Shot,8.3
2008-09,201177,Josh McRoberts,PF,35,83,35,73,0,10,Center,2,Jump Shot,8.036144578313253
2009-10,201177,Josh McRoberts,C,76,146,68,123,8,23,Center,9,Jump Shot,8.705479452054794
2010-11,201177,Josh McRoberts,PF,211,386,188,326,23,60,Center,4,Jump Shot,8.199481865284975
2011-12,201177,Josh McRoberts,PF,56,118,53,111,3,7,Center,4,Jump Shot,5.559322033898305
2012-13,201177,Josh McRoberts,PF,156,343,132,259,24,84,Center,4,Jump Shot,10.862973760932945
2013-14,201177,Josh McRoberts,PF,247,566,142,275,105,291,Center,13,Jump Shot,16.054770318021202
2014-15,201177,Josh McRoberts,PF,28,53,20,34,8,19,Center,0,Jump Shot,11.320754716981131
2015-16,201177,Josh McRoberts,PF,55,148,43,99,12,49,Center,1,Jump Shot,13.371621621621621
2016-17,201177,Josh McRoberts,PF,44,118,31,87,13,31,Center,0,Jump Shot,12.26271186440678
2017-18,201177,Josh McRoberts,PF,0,1,0,0,0,1,Center,0,Jump Shot,25.0
2022-23,1631169,Josh Minott,SF,18,36,16,30,2,6,Center,5,Jump Shot,6.166666666666667
2018-19,1629006,Josh Okogie,SG,196,508,136,293,60,215,Center,5,Jump Shot,13.496062992125983
2019-20,1629006,Josh Okogie,SG,170,398,129,244,41,154,Center,7,Jump Shot,11.195979899497488
2020-21,1629006,Josh Okogie,SG,102,254,73,146,29,108,Center,4,Jump Shot,11.89763779527559
2021-22,1629006,Josh Okogie,SG,42,104,28,57,14,47,Center,4,Jump Shot,11.913461538461538
2022-23,1629006,Josh Okogie,SG,162,414,96,217,66,197,Center,10,Jump Shot,13.908212560386474
2005-06,2694,Josh Powell,PF,37,81,37,81,0,0,Center,5,Jump Shot,7.91358024691358
2006-07,2694,Josh Powell,PF,43,93,43,93,0,0,Center,6,Jump Shot,9.193548387096774
2007-08,2694,Josh Powell,C,145,315,145,312,0,3,Center,7,Jump Shot,7.307936507936508
2008-09,2694,Josh Powell,PF,106,239,106,239,0,0,Center,9,Jump Shot,8.640167364016737
2009-10,2694,Josh Powell,PF,71,194,64,178,7,16,Center,7,Jump Shot,10.469072164948454
2010-11,2694,Josh Powell,PF,94,208,94,207,0,1,Center,4,Jump Shot,10.26923076923077
2013-14,2694,Josh Powell,PF,2,6,2,6,0,0,Right Side,0,Jump Shot,15.166666666666666
2019-20,1629729,Josh Reaves,SF,3,9,3,7,0,2,Center,0,Reverse Layup Shot,8.11111111111111
2015-16,1626196,Josh Richardson,SG,123,272,70,157,53,115,Center,8,Jump Shot,14.886029411764707
2016-17,1626196,Josh Richardson,SG,202,513,127,286,75,227,Center,15,Jump Shot,16.428849902534115
2017-18,1626196,Josh Richardson,SF,399,885,272,549,127,336,Center,13,Jump Shot,14.926553672316384
2018-19,1626196,Josh Richardson,SG,423,1026,259,566,164,460,Center,13,Jump Shot,15.971734892787524
2019-20,1626196,Josh Richardson,SG,278,646,193,397,85,249,Center,4,Jump Shot,15.628482972136222
2020-21,1626196,Josh Richardson,SG,264,618,176,351,88,267,Center,5,Jump Shot,15.689320388349515
2021-22,1626196,Josh Richardson,SG,234,534,132,288,102,246,Center,7,Jump Shot,16.644194756554306
2022-23,1626196,Josh Richardson,SG,239,554,132,261,107,293,Center,6,Jump Shot,18.276173285198556
2011-12,202729,Josh Selby,PG,25,72,23,57,2,15,Center,2,Jump Shot,12.36111111111111
2012-13,202729,Josh Selby,PG,6,22,5,16,1,6,Right Side Center,2,Jump Shot,16.181818181818183
2004-05,2746,Josh Smith,SF,274,602,270,579,4,23,Center,22,Jump Shot,7.410299003322259
2005-06,2746,Josh Smith,SF,329,774,295,664,34,110,Center,14,Jump Shot,10.844961240310077
2006-07,2746,Josh Smith,SF,436,993,398,841,38,152,Center,18,Jump Shot,9.671701913393756
2007-08,2746,Josh Smith,PF,518,1133,493,1034,25,99,Center,27,Jump Shot,8.300970873786408
2008-09,2746,Josh Smith,PF,418,849,392,762,26,87,Center,14,Jump Shot,8.492343934040047
2009-10,2746,Josh Smith,PF,504,999,504,992,0,7,Center,16,Jump Shot,6.131131131131131
2010-11,2746,Josh Smith,PF,497,1041,446,887,51,154,Center,13,Jump Shot,11.491834774255523
2011-12,2746,Josh Smith,PF,504,1101,476,992,28,109,Center,11,Jump Shot,11.188010899182562
2012-13,2746,Josh Smith,PF,550,1182,489,981,61,201,Center,16,Jump Shot,10.78087986463621
2013-14,2746,Josh Smith,SF,517,1233,447,968,70,265,Center,18,Jump Shot,11.991078669910786
2014-15,2746,Josh Smith,PF,414,986,342,759,72,227,Center,8,Jump Shot,10.639959432048682
2015-16,2746,Josh Smith,PF,127,349,86,206,41,143,Center,2,Jump Shot,13.624641833810887
2017-18,2746,Josh Smith,PF,1,4,1,4,0,0,Center,1,Layup Shot,5.25
2021-22,1630563,Joshua Primo,SF,101,270,59,133,42,137,Center,7,Jump Shot,15.42962962962963
2022-23,1630563,Joshua Primo,SG,9,26,6,14,3,12,Center,0,Jump Shot,16.46153846153846
2009-10,201950,Jrue Holiday,PG,230,520,168,361,62,159,Center,18,Jump Shot,13.326923076923077
2010-11,201950,Jrue Holiday,PG,446,999,365,777,81,222,Center,14,Jump Shot,12.082082082082081
2011-12,201950,Jrue Holiday,PG,360,834,295,663,65,171,Center,12,Jump Shot,12.235011990407674
2012-13,201950,Jrue Holiday,PG,555,1288,464,1041,91,247,Center,27,Jump Shot,12.125776397515528
2013-14,201950,Jrue Holiday,PG,203,454,173,377,30,77,Center,8,Jump Shot,11.702643171806168
2014-15,201950,Jrue Holiday,PG,238,534,187,399,51,135,Center,5,Jump Shot,12.146067415730338
2015-16,201950,Jrue Holiday,PG,410,934,323,676,87,258,Center,21,Jump Shot,12.25695931477516
2016-17,201950,Jrue Holiday,PG,404,892,305,612,99,280,Center,10,Jump Shot,12.880044843049328
2017-18,201950,Jrue Holiday,SG,615,1244,495,888,120,356,Center,18,Jump Shot,11.644694533762058
2018-19,201950,Jrue Holiday,SG,547,1159,429,796,118,363,Center,18,Jump Shot,11.755823986194995
2019-20,201950,Jrue Holiday,SG,458,1006,336,660,122,346,Center,14,Jump Shot,11.587475149105368
2020-21,201950,Jrue Holiday,PG,414,823,303,540,111,283,Center,15,Jump Shot,12.664641555285542
2021-22,201950,Jrue Holiday,PG,478,954,346,633,132,321,Center,10,Jump Shot,13.127882599580714
2022-23,201950,Jrue Holiday,PG,490,1023,332,612,158,411,Center,14,Pullup Jump shot,14.757575757575758
2007-08,2434,Juan Carlos Navarro,SG,308,766,152,334,156,432,Center,14,Jump Shot,17.39817232375979
2003-04,2413,Juan Dixon,SG,247,637,188,439,59,198,Center,17,Jump Shot,15.243328100470958
2004-05,2413,Juan Dixon,SG,186,447,138,300,48,147,Center,9,Jump Shot,15.825503355704697
2005-06,2413,Juan Dixon,SG,357,821,292,651,65,170,Center,23,Jump Shot,14.572472594397077
2006-07,2413,Juan Dixon,SG,299,703,220,477,79,226,Left Side,8,Jump Shot,16.01280227596017
2007-08,2413,Juan Dixon,PG,106,258,76,186,30,72,Center,6,Jump Shot,15.666666666666666
2008-09,2413,Juan Dixon,PG,101,256,76,181,25,75,Center,5,Jump Shot,15.09765625
2019-20,1629308,Juan Toscano-Anderson,SG,29,63,21,40,8,23,Center,3,Jump Shot,11.047619047619047
2020-21,1629308,Juan Toscano-Anderson,SG,121,209,84,117,37,92,Center,5,Jump Shot,12.397129186602871
2021-22,1629308,Juan Toscano-Anderson,SF,115,235,87,148,28,87,Center,10,Jump Shot,11.242553191489362
2022-23,1629308,Juan Toscano-Anderson,SF,64,143,56,100,8,43,Center,3,Jump Shot,10.755244755244755
2016-17,1627823,Juancho Hernangomez,PF,101,224,55,111,46,113,Center,5,Jump Shot,13.90625
2017-18,1627823,Juancho Hernangomez,PF,29,75,15,25,14,50,Center,5,Jump Shot,16.813333333333333
2018-19,1627823,Juancho Hernangomez,PF,138,314,72,133,66,181,Center,7,Jump Shot,15.30891719745223
2019-20,1627823,Juancho Hernangomez,PF,100,247,56,118,44,129,Center,7,Jump Shot,14.226720647773279
2020-21,1627823,Juancho Hernangomez,PF,130,299,75,131,55,168,Center,7,Jump Shot,14.68227424749164
2021-22,1627823,Juancho Hernangomez,PF,44,106,20,37,24,69,Center,4,Jump Shot,16.72641509433962
2022-23,1627823,Juancho Hernangomez,PF,48,114,31,47,17,67,Center,2,Jump Shot,15.675438596491228
2022-23,1630577,Julian Champagnie,SF,59,130,26,48,33,82,Center,1,Jump Shot,17.46153846153846
2018-19,1627395,Julian Washburn,SF,16,48,11,24,5,24,Left Side Center,0,Jump Shot,18.0625
2007-08,201153,Julian Wright,SF,90,169,80,145,10,24,Center,7,Jump Shot,8.822485207100591
2008-09,201153,Julian Wright,SF,109,234,107,213,2,21,Center,8,Jump Shot,8.782051282051283
2009-10,201153,Julian Wright,SF,116,232,114,226,2,6,Center,8,Jump Shot,6.663793103448276
2010-11,201153,Julian Wright,SF,82,160,80,150,2,10,Center,10,Jump Shot,6.98125
2005-06,101125,Julius Hodge,SG,5,13,5,13,0,0,Center,1,Layup Shot,2.769230769230769
2006-07,101125,Julius Hodge,SG,6,12,6,12,0,0,Center,3,Layup Shot,5.25
2014-15,203944,Julius Randle,PF,1,3,1,3,0,0,Right Side Center,0,Jump Shot,9.0
2015-16,203944,Julius Randle,PF,358,835,348,799,10,36,Center,23,Jump Shot,6.682634730538922
2016-17,203944,Julius Randle,PF,377,773,360,710,17,63,Center,22,Jump Shot,6.606727037516171
2017-18,203944,Julius Randle,C,504,904,494,859,10,45,Center,21,Layup Shot,4.954646017699115
2018-19,203944,Julius Randle,PF,571,1089,504,894,67,195,Center,28,Jump Shot,7.858585858585859
2019-20,203944,Julius Randle,PF,463,1006,399,775,64,231,Center,25,Jump Shot,9.97614314115308
2020-21,203944,Julius Randle,PF,602,1321,442,932,160,389,Center,30,Jump Shot,14.006056018168055
2021-22,203944,Julius Randle,PF,512,1246,392,856,120,390,Center,19,Jump Shot,13.278491171749598
2022-23,203944,Julius Randle,PF,658,1432,440,796,218,636,Center,34,Jump Shot,14.856145251396647
2011-12,202933,Julyan Stone,SG,13,31,11,20,2,11,Center,4,Jump Shot,13.516129032258064
2012-13,202933,Julyan Stone,PG,2,2,2,2,0,0,Center,1,Layup Shot,1.5
2013-14,202933,Julyan Stone,SG,7,16,5,9,2,7,Center,1,Jump Shot,12.5
2017-18,202933,Julyan Stone,SG,6,13,0,0,6,13,Left Side,1,Jump Shot,24.153846153846153
2003-04,1908,Jumaine Jones,SG,33,96,20,52,13,44,Center,4,Jump Shot,16.40625
2004-05,1908,Jumaine Jones,SF,210,486,108,225,102,261,Center,10,Jump Shot,15.559670781893004
2005-06,1908,Jumaine Jones,PF,298,736,183,401,115,335,Left Side,10,Jump Shot,17.497282608695652
2006-07,1908,Jumaine Jones,SF,14,51,4,19,10,32,Right Side Center,2,Jump Shot,20.84313725490196
2004-05,2454,Junior Harrington,SG,64,178,58,159,6,19,Center,2,Jump Shot,13.932584269662922
2006-07,2454,Junior Harrington,PG,57,137,50,111,7,26,Center,3,Jump Shot,14.284671532846716
2015-16,1626147,Justin Anderson,SF,71,175,49,92,22,83,Center,13,Jump Shot,14.937142857142858
2016-17,1626147,Justin Anderson,SF,186,439,128,245,58,194,Center,21,Jump Shot,13.722095671981776
2017-18,1626147,Justin Anderson,SF,87,202,53,99,34,103,Center,8,Jump Shot,14.846534653465346
2018-19,1626147,Justin Anderson,SF,64,157,40,80,24,77,Center,8,Jump Shot,14.273885350318471
2019-20,1626147,Justin Anderson,SG,10,38,4,9,6,29,Center,1,Jump Shot,19.842105263157894
2021-22,1626147,Justin Anderson,SF,36,95,21,36,15,59,Center,4,Jump Shot,18.45263157894737
2021-22,1630551,Justin Champagnie,SF,31,67,21,39,10,28,Center,4,Jump Shot,11.283582089552239
2022-23,1630551,Justin Champagnie,SF,5,15,4,10,1,5,Center,0,Jump Shot,10.733333333333333
2011-12,202458,Justin Dentmon,PG,10,28,8,14,2,14,Center,0,Jump Shot,17.571428571428573
2012-13,202458,Justin Dentmon,PG,0,2,0,2,0,0,Right Side,0,Jump Shot,16.5
2013-14,203120,Justin Hamilton,C,9,20,6,11,3,9,Center,2,Jump Shot,15.05
2014-15,203120,Justin Hamilton,C,85,178,75,147,10,31,Center,4,Jump Shot,8.842696629213483
2016-17,203120,Justin Hamilton,C,174,379,119,199,55,180,Center,9,Jump Shot,14.08179419525066
2011-12,202712,Justin Harper,PF,9,31,7,18,2,13,Center,0,Jump Shot,15.129032258064516
2015-16,202712,Justin Harper,PF,4,10,0,1,4,9,Right Side Center,1,Jump Shot,24.5
2016-17,202712,Justin Harper,PF,5,12,3,5,2,7,Center,0,Jump Shot,17.833333333333332
2012-13,203200,Justin Holiday,SG,16,48,12,32,4,16,Center,1,Jump Shot,16.104166666666668
2014-15,203200,Justin Holiday,SG,91,235,56,126,35,109,Center,9,Jump Shot,16.714893617021275
2015-16,203200,Justin Holiday,SG,88,228,52,123,36,105,Center,10,Jump Shot,14.87280701754386
2016-17,203200,Justin Holiday,SG,233,538,136,265,97,273,Center,13,Jump Shot,17.152416356877325
2017-18,203200,Justin Holiday,SG,290,782,129,333,161,449,Center,10,Jump Shot,18.41304347826087
2018-19,203200,Justin Holiday,SG,300,777,138,312,162,465,Center,8,Jump Shot,18.0978120978121
2019-20,203200,Justin Holiday,SF,208,486,74,155,134,331,Center,2,Jump Shot,19.133744855967077
2020-21,203200,Justin Holiday,SG,258,625,85,172,173,453,Center,5,Jump Shot,19.4192
2021-22,203200,Justin Holiday,SF-SG,261,662,84,180,177,482,Center,12,Jump Shot,20.23262839879154
2022-23,203200,Justin Holiday,SG,77,204,31,61,46,143,Center,6,Jump Shot,19.254901960784313
2017-18,1628382,Justin Jackson,SF,185,419,128,234,57,185,Center,9,Jump Shot,15.439140811455847
2018-19,1628382,Justin Jackson,SF,217,485,130,240,87,245,Center,9,Jump Shot,15.903092783505155
2019-20,1628382,Justin Jackson,PF,135,341,87,178,48,163,Center,6,Jump Shot,14.944281524926685
2020-21,1628382,Justin Jackson,SF,89,221,53,104,36,117,Center,3,Jump Shot,16.289592760180994
2021-22,1628382,Justin Jackson,SF,5,15,2,6,3,9,Center,1,Jump Shot,19.466666666666665
2022-23,1628382,Justin Jackson,SF,7,27,2,7,5,20,Center,2,Jump Shot,20.555555555555557
2019-20,1629713,Justin James,SF,35,84,26,55,9,29,Center,9,Jump Shot,13.571428571428571
2020-21,1629713,Justin James,SF,52,111,38,73,14,38,Center,6,Jump Shot,12.765765765765765
2022-23,1631303,Justin Minaya,SF,7,23,4,11,3,12,Center,0,Jump Shot,16.0
2017-18,1628383,Justin Patton,C,1,2,1,2,0,0,Center,1,Driving Layup Shot,7.0
2018-19,1628383,Justin Patton,C,2,7,2,5,0,2,Center,0,Jump Shot,9.0
2019-20,1628383,Justin Patton,C,4,10,3,6,1,4,Center,2,Jump Shot,13.0
2020-21,1628383,Justin Patton,C,29,70,20,36,9,34,Center,3,Jump Shot,14.542857142857143
2004-05,2770,Justin Reed,SF,15,29,15,26,0,3,Center,4,Jump Shot,11.172413793103448
2005-06,2770,Justin Reed,SF,119,295,119,294,0,1,Center,5,Jump Shot,8.515254237288136
2006-07,2770,Justin Reed,PF,40,107,40,107,0,0,Center,7,Jump Shot,8.495327102803738
2019-20,1629620,Justin Robinson,PG,5,12,2,7,3,5,Right Side Center,0,Jump Shot,19.916666666666668
2020-21,1629620,Justin Robinson,PG,7,21,3,7,4,14,Left Side Center,1,Jump Shot,19.666666666666668
2021-22,1629620,Justin Robinson,PG,28,93,10,32,18,61,Center,7,Jump Shot,20.849462365591396
2006-07,200818,Justin Williams,C,54,88,54,87,0,1,Center,4,Layup Shot,2.3068181818181817
2007-08,200818,Justin Williams,C,13,29,13,29,0,0,Center,1,Layup Shot,2.793103448275862
2019-20,1629625,Justin Wright-Foreman,PG,7,20,5,10,2,10,Center,1,Jump Shot,16.6
2015-16,1626159,Justise Winslow,SF,195,461,163,346,32,115,Center,11,Jump Shot,10.427331887201735
2016-17,1626159,Justise Winslow,SF,80,224,73,190,7,34,Center,3,Jump Shot,10.089285714285714
2017-18,1626159,Justise Winslow,PF,207,488,158,359,49,129,Center,4,Jump Shot,10.192622950819672
2018-19,1626159,Justise Winslow,SF,324,749,228,493,96,256,Center,7,Jump Shot,12.551401869158878
2019-20,1626159,Justise Winslow,SG,50,129,44,102,6,27,Center,3,Jump Shot,9.984496124031008
2020-21,1626159,Justise Winslow,SF,74,210,64,156,10,54,Center,1,Jump Shot,11.480952380952381
2021-22,1626159,Justise Winslow,PF,110,257,95,191,15,66,Center,7,Jump Shot,10.198443579766536
2022-23,1626159,Justise Winslow,SF,81,198,67,153,14,45,Center,0,Jump Shot,9.282828282828282
2014-15,203994,Jusuf Nurkic,C,171,383,171,381,0,2,Center,7,Layup Shot,4.462140992167102
2015-16,203994,Jusuf Nurkic,C,101,242,101,239,0,3,Center,5,Layup Shot,4.520661157024794
2016-17,203994,Jusuf Nurkic,C,271,534,271,533,0,1,Center,5,Layup Shot,3.7790262172284645
2017-18,203994,Jusuf Nurkic,C,480,951,480,944,0,7,Center,10,Jump Shot,5.861198738170347
2018-19,203994,Jusuf Nurkic,C,420,826,417,797,3,29,Center,9,Jump Shot,5.216707021791768
2019-20,203994,Jusuf Nurkic,C,54,109,52,99,2,10,Center,3,Jump Shot,5.853211009174312
2020-21,203994,Jusuf Nurkic,C,171,333,159,303,12,30,Center,3,Cutting Layup Shot,5.222222222222222
2021-22,203994,Jusuf Nurkic,C,321,600,306,544,15,56,Center,9,Driving Layup Shot,5.493333333333333
2022-23,203994,Jusuf Nurkic,C,262,505,219,386,43,119,Center,8,Jump Shot,8.136633663366336
2003-04,436,Juwan Howard,PF,529,1169,529,1168,0,1,Center,7,Jump Shot,8.652694610778443
2004-05,436,Juwan Howard,PF,244,541,244,540,0,1,Center,4,Jump Shot,10.829944547134936
2005-06,436,Juwan Howard,PF,394,859,394,855,0,4,Center,12,Jump Shot,10.644935972060535
2006-07,436,Juwan Howard,PF,309,665,309,665,0,0,Center,4,Jump Shot,10.332330827067668
2007-08,436,Juwan Howard,PF,23,64,23,64,0,0,Center,4,Jump Shot,7.734375
2008-09,436,Juwan Howard,SF-PF,75,147,75,147,0,0,Center,1,Jump Shot,9.129251700680273
2009-10,436,Juwan Howard,C,191,375,191,374,0,1,Center,5,Jump Shot,10.010666666666667
2010-11,436,Juwan Howard,PF,55,125,55,125,0,0,Center,8,Jump Shot,11.8
2011-12,436,Juwan Howard,PF,17,55,17,55,0,0,Center,3,Jump Shot,7.454545454545454
2012-13,436,Juwan Howard,PF,10,19,10,19,0,0,Center,1,Jump Shot,8.105263157894736
2019-20,1629752,Juwan Morgan,PF,15,26,12,18,3,8,Center,3,Jump Shot,8.307692307692308
2020-21,1629752,Juwan Morgan,PF,14,30,10,17,4,13,Center,1,Jump Shot,11.8
2021-22,1629752,Juwan Morgan,PF,2,3,1,1,1,2,Right Side Center,0,Jump Shot,16.666666666666668
2014-15,203909,KJ McDaniels,SG,172,434,129,284,43,150,Center,12,Jump Shot,11.73041474654378
2015-16,203909,KJ McDaniels,SF,29,72,22,47,7,25,Center,6,Jump Shot,11.0
2016-17,203909,KJ McDaniels,SF,77,169,57,103,20,66,Center,10,Jump Shot,12.041420118343195
2019-20,1629644,KZ Okpala,PF,3,5,3,4,0,1,Center,0,Running Dunk Shot,7.0
2020-21,1629644,KZ Okpala,PF,36,96,24,46,12,50,Center,1,Jump Shot,14.083333333333334
2021-22,1629644,KZ Okpala,PF,30,69,21,43,9,26,Center,2,Jump Shot,11.44927536231884
2022-23,1629644,KZ Okpala,PF,16,38,9,17,7,21,Center,0,Jump Shot,15.473684210526315
2017-18,1628443,Kadeem Allen,PG,6,22,6,11,0,11,Center,3,Jump Shot,14.409090909090908
2018-19,1628443,Kadeem Allen,PG,65,141,48,105,17,36,Center,5,Jump Shot,11.4822695035461
2019-20,1628443,Kadeem Allen,PG,19,44,14,28,5,16,Center,2,Jump Shot,14.5
2021-22,1630539,Kai Jones,C,9,14,8,12,1,2,Center,7,Dunk Shot,7.142857142857143
2022-23,1630539,Kai Jones,C,67,120,63,101,4,19,Center,8,Jump Shot,6.816666666666666
2014-15,203564,Kalin Lucas,PG,0,1,0,1,0,0,Left Side,0,Jump Shot,14.0
2018-19,203564,Kalin Lucas,PG,0,1,0,0,0,1,Left Side Center,0,Jump Shot,28.0
2003-04,2079,Kaniel Dickens,PF,3,3,3,3,0,0,Center,0,Jump Shot,7.0
2004-05,2079,Kaniel Dickens,SF,4,14,1,5,3,9,Left Side,0,Jump Shot,17.428571428571427
2007-08,2079,Kaniel Dickens,PF,1,3,1,3,0,0,Center,1,Layup Shot,9.333333333333334
2003-04,2416,Kareem Rush,SG,190,432,142,294,48,138,Center,18,Jump Shot,15.9375
2004-05,2416,Kareem Rush,SG,157,406,106,269,51,137,Center,9,Jump Shot,16.167487684729064
2005-06,2416,Kareem Rush,SG,181,469,124,305,57,164,Center,6,Jump Shot,15.812366737739872
2007-08,2416,Kareem Rush,SG,228,569,126,307,102,262,Center,14,Jump Shot,17.325131810193323
2008-09,2416,Kareem Rush,SG,20,58,10,25,10,33,Center,1,Jump Shot,18.25862068965517
2009-10,2416,Kareem Rush,SG,4,11,3,8,1,3,Center,0,Jump Shot,13.727272727272727
2020-21,1630211,Karim Mane,PG,3,13,2,11,1,2,Center,0,Driving Layup Shot,6.769230769230769
2003-04,252,Karl Malone,PF,193,400,193,399,0,1,Center,6,Jump Shot,10.0825
2015-16,1626157,Karl-Anthony Towns,C,625,1153,595,1065,30,88,Center,17,Jump Shot,9.75021682567216
2016-17,1626157,Karl-Anthony Towns,C,802,1479,701,1205,101,274,Center,31,Jump Shot,9.208924949290061
2017-18,1626157,Karl-Anthony Towns,C,639,1172,519,887,120,285,Center,19,Jump Shot,10.325085324232083
2018-19,1626157,Karl-Anthony Towns,C,681,1314,539,959,142,355,Center,37,Jump Shot,10.904870624048707
2019-20,1626157,Karl-Anthony Towns,C,316,622,202,345,114,277,Center,14,Jump Shot,13.557877813504824
2020-21,1626157,Karl-Anthony Towns,C,425,875,303,560,122,315,Center,15,Jump Shot,12.441142857142857
2021-22,1626157,Karl-Anthony Towns,C,642,1214,492,848,150,366,Center,19,Jump Shot,11.028006589785832
2022-23,1626157,Karl-Anthony Towns,PF,212,428,152,264,60,164,Center,8,Jump Shot,13.521028037383177
2007-08,2867,Kasib Powell,SF,35,95,27,62,8,33,Center,1,Jump Shot,12.56842105263158
2011-12,202695,Kawhi Leonard,SF,199,404,158,295,41,109,Center,7,Jump Shot,10.641089108910892
2012-13,202695,Kawhi Leonard,SF,260,526,195,352,65,174,Center,9,Jump Shot,12.26425855513308
2013-14,202695,Kawhi Leonard,SF,337,645,268,463,69,182,Center,7,Jump Shot,12.02170542635659
2014-15,202695,Kawhi Leonard,SF,394,822,327,630,67,192,Center,11,Jump Shot,12.693430656934307
2015-16,202695,Kawhi Leonard,SF,551,1088,422,799,129,289,Center,17,Jump Shot,13.286764705882353
2016-17,202695,Kawhi Leonard,SF,636,1311,489,925,147,386,Center,20,Jump Shot,14.356979405034325
2017-18,202695,Kawhi Leonard,SF,52,111,41,76,11,35,Center,1,Jump Shot,14.0
2018-19,202695,Kawhi Leonard,SF,560,1129,448,827,112,302,Center,27,Jump Shot,12.803365810451727
2019-20,202695,Kawhi Leonard,SF,532,1133,409,808,123,325,Center,14,Jump Shot,14.049426301853487
2020-21,202695,Kawhi Leonard,SF,465,908,364,654,101,254,Center,14,Jump Shot,13.412995594713657
2022-23,202695,Kawhi Leonard,SF,446,871,342,621,104,250,Center,16,Pullup Jump shot,14.427095292766934
2016-17,1627770,Kay Felder,PG,62,158,55,136,7,22,Center,14,Jump Shot,10.987341772151899
2017-18,1627770,Kay Felder,PG,21,70,17,51,4,19,Center,2,Jump Shot,14.82857142857143
2003-04,2208,Kedrick Brown,SF,117,254,79,155,38,99,Center,2,Jump Shot,13.358267716535433
2004-05,2208,Kedrick Brown,SF,2,6,2,3,0,3,Center,0,Jump Shot,16.5
2022-23,1631099,Keegan Murray,SF,354,782,148,281,206,501,Center,7,Jump Shot,17.649616368286445
2021-22,1626208,Keifer Sykes,PG,69,190,42,100,27,90,Center,4,Jump Shot,16.789473684210527
2018-19,1628966,Keita Bates-Diop,SF,60,142,47,90,13,52,Center,2,Jump Shot,12.746478873239436
2019-20,1628966,Keita Bates-Diop,PF-SF,100,234,66,131,34,103,Center,5,Jump Shot,12.376068376068377
2020-21,1628966,Keita Bates-Diop,SF,30,67,25,50,5,17,Center,5,Jump Shot,9.283582089552239
2021-22,1628966,Keita Bates-Diop,SF,136,263,119,208,17,55,Center,10,Jump Shot,7.91254752851711
2022-23,1628966,Keita Bates-Diop,SF,236,465,180,323,56,142,Center,4,Jump Shot,9.978494623655914
2015-16,203951,Keith Appling,PG,2,8,2,5,0,3,Center,0,Pullup Jump shot,14.875
2011-12,202728,Keith Benson,C,0,1,0,1,0,0,Center,0,Layup Shot,1.0
2003-04,2586,Keith Bogans,SF,183,454,116,267,67,187,Center,8,Jump Shot,15.083700440528634
2004-05,2586,Keith Bogans,SG,262,688,205,515,57,173,Center,6,Jump Shot,12.645348837209303
2005-06,2586,Keith Bogans,SG-SF,215,544,150,344,65,200,Center,14,Jump Shot,12.959558823529411
2006-07,2586,Keith Bogans,SG,99,245,46,108,53,137,Center,2,Jump Shot,16.583673469387755
2007-08,2586,Keith Bogans,SG,241,588,93,179,148,409,Center,10,Jump Shot,18.535714285714285
2008-09,2586,Keith Bogans,SG,119,324,45,106,74,218,Center,8,Jump Shot,17.61111111111111
2009-10,2586,Keith Bogans,SF,120,298,50,102,70,196,Center,4,Jump Shot,17.026845637583893
2010-11,2586,Keith Bogans,SG,124,307,34,70,90,237,Left Side,0,Jump Shot,20.18241042345277
2011-12,2586,Keith Bogans,SF,8,21,5,9,3,12,Center,1,Jump Shot,15.19047619047619
2012-13,2586,Keith Bogans,SG,108,284,24,39,84,245,Left Side,2,Jump Shot,21.471830985915492
2013-14,2586,Keith Bogans,SG,3,6,0,0,3,6,Left Side,0,Jump Shot,23.833333333333332
2007-08,101247,Keith Langford,SG,1,4,1,4,0,0,Center,0,Layup Shot,9.25
2003-04,2693,Keith McLeod,PG,27,82,26,72,1,10,Center,1,Jump Shot,14.414634146341463
2004-05,2693,Keith McLeod,PG,143,408,125,336,18,72,Center,7,Jump Shot,14.463235294117647
2005-06,2693,Keith McLeod,PG,120,340,96,258,24,82,Center,5,Jump Shot,16.761764705882353
2006-07,2693,Keith McLeod,PG,73,188,57,143,16,45,Center,6,Jump Shot,16.409574468085108
2003-04,1496,Keith Van Horn,SF,410,903,317,670,93,233,Center,16,Jump Shot,11.520487264673312
2004-05,1496,Keith Van Horn,SF-PF,257,564,203,422,54,142,Center,6,Jump Shot,11.421985815602836
2005-06,1496,Keith Van Horn,SF,164,387,114,251,50,136,Center,2,Jump Shot,13.405684754521964
2019-20,1629103,Kelan Martin,SF,71,181,46,85,25,96,Center,8,Jump Shot,16.055248618784532
2020-21,1629103,Kelan Martin,SF,62,138,38,78,24,60,Center,14,Jump Shot,14.289855072463768
2021-22,1629103,Kelan Martin,SF,70,171,48,96,22,75,Center,2,Jump Shot,14.88888888888889
2019-20,1629640,Keldon Johnson,SF,53,89,40,67,13,22,Center,8,Jump Shot,9.584269662921349
2020-21,1629640,Keldon Johnson,SF,338,705,278,524,60,181,Center,12,Jump Shot,9.205673758865249
2021-22,1629640,Keldon Johnson,SF,471,1011,312,612,159,399,Center,10,Jump Shot,12.939663699307616
2022-23,1629640,Keldon Johnson,SF,503,1113,369,706,134,407,Center,17,Jump Shot,12.176100628930818
2006-07,101235,Kelenna Azubuike,SG,98,220,64,141,34,79,Center,8,Jump Shot,12.540909090909091
2007-08,101235,Kelenna Azubuike,SG,261,587,190,392,71,195,Center,13,Jump Shot,11.87052810902896
2008-09,101235,Kelenna Azubuike,SF,392,845,298,635,94,210,Center,13,Jump Shot,11.615384615384615
2009-10,101235,Kelenna Azubuike,SF,48,88,38,61,10,27,Center,1,Jump Shot,11.284090909090908
2011-12,101235,Kelenna Azubuike,SG,3,8,2,5,1,3,Left Side,2,Jump Shot,14.125
2020-21,1629833,Keljin Blevins,SF,5,20,3,12,2,8,Center,3,Jump Shot,12.05
2021-22,1629833,Keljin Blevins,SF,34,111,13,39,21,72,Center,5,Jump Shot,17.90990990990991
2013-14,203482,Kelly Olynyk,C,234,502,194,388,40,114,Center,15,Jump Shot,10.53784860557769
2014-15,203482,Kelly Olynyk,C,251,528,190,353,61,175,Center,7,Jump Shot,12.166666666666666
2015-16,203482,Kelly Olynyk,C,253,556,168,346,85,210,Center,6,Jump Shot,12.83093525179856
2016-17,203482,Kelly Olynyk,C,260,508,192,316,68,192,Center,3,Jump Shot,12.590551181102363
2017-18,203482,Kelly Olynyk,PF,316,636,210,356,106,280,Center,11,Jump Shot,14.355345911949685
2018-19,203482,Kelly Olynyk,PF,261,564,148,245,113,319,Center,10,Jump Shot,15.955673758865249
2019-20,203482,Kelly Olynyk,C,184,398,89,164,95,234,Center,11,Jump Shot,17.128140703517587
2020-21,203482,Kelly Olynyk,C-PF,337,697,211,329,126,368,Center,10,Jump Shot,15.071736011477762
2021-22,203482,Kelly Olynyk,C,128,286,88,167,40,119,Center,2,Jump Shot,13.716783216783217
2022-23,203482,Kelly Olynyk,C,278,557,185,321,93,236,Center,10,Jump Shot,13.6229802513465
2015-16,1626162,Kelly Oubre Jr.,SF,90,211,65,132,25,79,Center,13,Jump Shot,11.635071090047393
2016-17,1626162,Kelly Oubre Jr.,SF,186,441,132,254,54,187,Center,4,Jump Shot,13.541950113378684
2017-18,1626162,Kelly Oubre Jr.,SF,318,790,192,421,126,369,Center,14,Jump Shot,14.851898734177215
2018-19,1626162,Kelly Oubre Jr.,SF,375,842,267,504,108,338,Center,16,Jump Shot,12.576009501187649
2019-20,1626162,Kelly Oubre Jr.,SF,373,826,265,519,108,307,Center,13,Jump Shot,12.234866828087167
2020-21,1626162,Kelly Oubre Jr.,SF,318,724,228,439,90,285,Center,5,Jump Shot,12.720994475138122
2021-22,1626162,Kelly Oubre Jr.,SF,410,932,219,379,191,553,Center,12,Jump Shot,16.36480686695279
2022-23,1626162,Kelly Oubre Jr.,SF,353,819,245,480,108,339,Center,6,Jump Shot,13.35897435897436
2003-04,1509,Kelvin Cato,PF,161,360,161,360,0,0,Center,1,Jump Shot,5.158333333333333
2004-05,1509,Kelvin Cato,C,160,297,160,297,0,0,Center,7,Jump Shot,5.286195286195286
2005-06,1509,Kelvin Cato,C,36,84,36,84,0,0,Center,0,Jump Shot,6.488095238095238
2006-07,1509,Kelvin Cato,C,7,22,7,22,0,0,Center,0,Layup Shot,3.409090909090909
2011-12,202689,Kemba Walker,PG,281,767,212,541,69,226,Center,19,Jump Shot,14.967405475880053
2012-13,202689,Kemba Walker,PG,526,1244,419,912,107,332,Center,20,Jump Shot,12.919614147909968
2013-14,202689,Kemba Walker,PG,449,1143,340,816,109,327,Center,31,Jump Shot,14.710411198600175
2014-15,202689,Kemba Walker,PG,378,981,293,701,85,280,Center,31,Jump Shot,13.790010193679919
2015-16,202689,Kemba Walker,PG,568,1331,386,841,182,490,Center,34,Jump Shot,14.761833208114199
2016-17,202689,Kemba Walker,PG,643,1449,403,847,240,602,Center,56,Jump Shot,14.518288474810214
2017-18,202689,Kemba Walker,PG,588,1363,357,762,231,601,Center,27,Jump Shot,15.997065297138665
2018-19,202689,Kemba Walker,PG,731,1684,471,953,260,731,Center,37,Jump Shot,15.291567695961994
2019-20,202689,Kemba Walker,PG,378,889,198,416,180,473,Center,13,Jump Shot,17.06636670416198
2020-21,202689,Kemba Walker,PG,284,676,157,323,127,353,Center,14,Pullup Jump shot,17.534023668639055
2021-22,202689,Kemba Walker,PG,149,370,76,171,73,199,Center,2,Pullup Jump shot,17.548648648648648
2022-23,202689,Kemba Walker,PG,24,57,17,29,7,28,Center,2,Pullup Jump shot,16.05263157894737
2022-23,1631112,Kendall Brown,SG,4,7,4,6,0,1,Center,2,Running Dunk Shot,6.857142857142857
2003-04,383,Kendall Gill,SG,215,548,206,510,9,38,Center,10,Jump Shot,12.872262773722628
2004-05,383,Kendall Gill,SG,32,80,29,71,3,9,Center,3,Jump Shot,12.55
2012-13,203088,Kendall Marshall,PG,56,151,33,78,23,73,Center,7,Jump Shot,17.13907284768212
2013-14,203088,Kendall Marshall,PG,170,419,99,241,71,178,Center,13,Jump Shot,16.052505966587113
2014-15,203088,Kendall Marshall,PG,46,101,28,55,18,46,Center,1,Jump Shot,15.227722772277227
2015-16,203088,Kendall Marshall,PG,43,118,27,69,16,49,Center,3,Jump Shot,16.423728813559322
2019-20,1629134,Kendrick Nunn,PG,401,914,264,523,137,391,Center,13,Jump Shot,15.334792122538293
2020-21,1629134,Kendrick Nunn,PG,319,658,197,338,122,320,Center,12,Jump Shot,15.562310030395137
2022-23,1629134,Kendrick Nunn,SG-PG,191,450,112,227,79,223,Center,12,Jump Shot,16.468888888888888
2003-04,2570,Kendrick Perkins,C,8,15,8,15,0,0,Center,5,Jump Shot,4.333333333333333
2004-05,2570,Kendrick Perkins,C,56,119,56,119,0,0,Center,4,Layup Shot,4.126050420168068
2005-06,2570,Kendrick Perkins,C,137,266,137,264,0,2,Center,2,Layup Shot,3.699248120300752
2006-07,2570,Kendrick Perkins,C,132,269,132,266,0,3,Center,0,Layup Shot,4.483271375464684
2007-08,2570,Kendrick Perkins,C,214,348,214,347,0,1,Center,3,Layup Shot,2.353448275862069
2008-09,2570,Kendrick Perkins,C,276,478,276,476,0,2,Center,4,Layup Shot,3.5230125523012554
2009-10,2570,Kendrick Perkins,C,314,521,314,519,0,2,Center,6,Layup Shot,3.341650671785029
2010-11,2570,Kendrick Perkins,C,67,130,67,130,0,0,Center,1,Layup Shot,3.792307692307692
2011-12,2570,Kendrick Perkins,C,128,262,128,262,0,0,Center,3,Jump Shot,4.511450381679389
2012-13,2570,Kendrick Perkins,C,143,313,143,312,0,1,Center,2,Jump Shot,6.437699680511182
2013-14,2570,Kendrick Perkins,C,87,193,87,192,0,1,Center,1,Jump Shot,4.958549222797927
2014-15,2570,Kendrick Perkins,C,102,227,102,226,0,1,Center,4,Jump Shot,4.167400881057269
2015-16,2570,Kendrick Perkins,C,40,75,40,75,0,0,Center,2,Jump Shot,6.293333333333333
2017-18,2570,Kendrick Perkins,C,1,2,1,2,0,0,Center,0,Hook Shot,3.5
2022-23,1631113,Kennedy Chandler,PG,35,83,33,68,2,15,Center,7,Jump Shot,8.27710843373494
2011-12,202702,Kenneth Faried,PF,181,309,181,309,0,0,Center,10,Layup Shot,3.016181229773463
2012-13,202702,Kenneth Faried,PF,380,689,380,689,0,0,Center,5,Layup Shot,3.3410740203193035
2013-14,202702,Kenneth Faried,PF,447,820,447,817,0,3,Center,11,Jump Shot,4.470731707317073
2014-15,202702,Kenneth Faried,PF,373,736,372,728,1,8,Center,14,Layup Shot,3.8682065217391304
2015-16,202702,Kenneth Faried,PF,349,626,348,624,1,2,Center,12,Layup Shot,3.498402555910543
2016-17,202702,Kenneth Faried,PF,228,416,228,410,0,6,Center,5,Layup Shot,3.5096153846153846
2017-18,202702,Kenneth Faried,PF,76,148,76,147,0,1,Center,2,Layup Shot,4.4324324324324325
2018-19,202702,Kenneth Faried,C,156,265,148,240,8,25,Center,10,Layup Shot,4.418867924528302
2022-23,1631254,Kenneth Lofton Jr.,PF,49,93,43,76,6,17,Center,7,Jump Shot,9.043010752688172
2003-04,72,Kenny Anderson,PG,113,256,112,252,1,4,Center,5,Jump Shot,10.0703125
2004-05,72,Kenny Anderson,PG,85,201,79,188,6,13,Center,3,Jump Shot,11.671641791044776
2003-04,1903,Kenny Thomas,PF,381,813,380,808,1,5,Center,7,Jump Shot,6.435424354243542
2004-05,1903,Kenny Thomas,PF,367,781,366,776,1,5,Center,8,Jump Shot,11.49167733674776
2005-06,1903,Kenny Thomas,PF,305,604,305,603,0,1,Center,5,Jump Shot,7.720198675496689
2006-07,1903,Kenny Thomas,PF,146,303,146,302,0,1,Center,1,Layup Shot,3.0495049504950495
2007-08,1903,Kenny Thomas,PF,16,38,16,38,0,0,Center,0,Layup Shot,2.6052631578947367
2008-09,1903,Kenny Thomas,PF,3,8,3,8,0,0,Center,0,Jump Shot,2.5
2009-10,1903,Kenny Thomas,PF,17,35,17,35,0,0,Center,0,Layup Shot,2.6
2018-19,1629026,Kenrich Williams,SF,107,279,55,123,52,156,Center,6,Jump Shot,16.057347670250895
2019-20,1629026,Kenrich Williams,PF,51,147,26,50,25,97,Center,4,Jump Shot,17.31972789115646
2020-21,1629026,Kenrich Williams,PF,219,411,167,294,52,117,Center,2,Jump Shot,11.316301703163017
2021-22,1629026,Kenrich Williams,SF,146,317,105,196,41,121,Center,7,Jump Shot,13.227129337539433
2022-23,1629026,Kenrich Williams,PF,179,346,129,212,50,134,Center,7,Jump Shot,12.88150289017341
2012-13,203145,Kent Bazemore,SG,43,116,33,82,10,34,Center,15,Jump Shot,15.775862068965518
2013-14,203145,Kent Bazemore,SG,147,343,104,215,43,128,Center,15,Jump Shot,14.352769679300291
2014-15,203145,Kent Bazemore,SG,141,331,93,199,48,132,Center,8,Jump Shot,12.444108761329305
2015-16,203145,Kent Bazemore,SF,319,724,211,420,108,304,Center,11,Jump Shot,12.740331491712707
2016-17,203145,Kent Bazemore,SF,294,718,203,455,91,263,Center,9,Jump Shot,14.211699164345404
2017-18,203145,Kent Bazemore,SG,284,676,176,402,108,274,Center,11,Jump Shot,14.724852071005918
2018-19,203145,Kent Bazemore,SG,278,691,182,391,96,300,Center,8,Jump Shot,14.512301013024603
2019-20,203145,Kent Bazemore,SF,200,534,116,290,84,244,Center,4,Jump Shot,14.441947565543071
2020-21,203145,Kent Bazemore,SF,176,392,101,208,75,184,Center,8,Jump Shot,14.806122448979592
2021-22,203145,Kent Bazemore,SF,45,139,16,59,29,80,Center,4,Jump Shot,17.553956834532375
2013-14,203484,Kentavious Caldwell-Pope,SG,181,459,123,275,58,184,Center,3,Jump Shot,14.85838779956427
2014-15,203484,Kentavious Caldwell-Pope,SG,390,972,237,528,153,444,Center,27,Jump Shot,15.772633744855968
2015-16,203484,Kentavious Caldwell-Pope,SG,403,959,289,591,114,368,Center,8,Jump Shot,14.831074035453598
2016-17,203484,Kentavious Caldwell-Pope,SG,370,927,217,491,153,436,Center,21,Jump Shot,17.284789644012946
2017-18,203484,Kentavious Caldwell-Pope,SG,340,798,181,383,159,415,Center,12,Jump Shot,17.25563909774436
2018-19,203484,Kentavious Caldwell-Pope,SG,325,756,174,321,151,435,Center,16,Jump Shot,17.804232804232804
2019-20,203484,Kentavious Caldwell-Pope,SG,237,507,145,268,92,239,Center,3,Jump Shot,15.37475345167653
2020-21,203484,Kentavious Caldwell-Pope,SG,218,506,98,213,120,293,Center,4,Jump Shot,17.124505928853754
2021-22,203484,Kentavious Caldwell-Pope,SG,361,829,202,421,159,408,Center,21,Jump Shot,17.59589867310012
2022-23,203484,Kentavious Caldwell-Pope,SG,292,632,157,313,135,319,Center,9,Jump Shot,17.01740506329114
2003-04,2030,Kenyon Martin,PF,439,900,432,875,7,25,Center,14,Jump Shot,7.37
2004-05,2030,Kenyon Martin,PF,444,907,444,895,0,12,Center,17,Jump Shot,7.357221609702315
2005-06,2030,Kenyon Martin,PF,297,600,292,578,5,22,Center,5,Jump Shot,8.583333333333334
2006-07,2030,Kenyon Martin,PF,8,16,8,15,0,1,Center,1,Jump Shot,9.5
2007-08,2030,Kenyon Martin,PF,376,699,374,688,2,11,Center,6,Jump Shot,6.457796852646638
2008-09,2030,Kenyon Martin,PF,318,648,304,610,14,38,Center,7,Jump Shot,8.155864197530864
2009-10,2030,Kenyon Martin,PF,283,620,275,591,8,29,Center,10,Jump Shot,9.053225806451612
2010-11,2030,Kenyon Martin,PF,185,362,183,353,2,9,Center,7,Jump Shot,7.599447513812155
2011-12,2030,Kenyon Martin,PF,97,220,94,207,3,13,Center,4,Jump Shot,11.15
2012-13,2030,Kenyon Martin,C,56,93,56,93,0,0,Center,0,Jump Shot,5.204301075268817
2013-14,2030,Kenyon Martin,PF,63,123,63,122,0,1,Center,0,Jump Shot,6.162601626016261
2014-15,2030,Kenyon Martin,PF,9,22,9,22,0,0,Center,1,Jump Shot,6.136363636363637
2020-21,1630231,Kenyon Martin Jr.,SF,162,318,127,222,35,96,Center,9,Jump Shot,9.213836477987421
2021-22,1630231,Kenyon Martin Jr.,SF,279,523,219,355,60,168,Center,12,Jump Shot,9.361376673040153
2022-23,1630231,Kenyon Martin Jr.,SF,410,720,342,504,68,216,Center,15,Jump Shot,9.247222222222222
2003-04,1721,Keon Clark,PF,2,6,2,6,0,0,Center,0,Jump Shot,9.166666666666666
2022-23,1631165,Keon Ellis,SG,7,16,1,4,6,12,Center,6,Jump Shot,21.625
2021-22,1630553,Keon Johnson,SG,96,272,62,172,34,100,Center,8,Jump Shot,12.849264705882353
2022-23,1630553,Keon Johnson,SG,67,178,39,97,28,81,Center,11,Jump Shot,14.910112359550562
2003-04,954,Kerry Kittles,SG,434,959,337,683,97,276,Center,14,Jump Shot,13.956204379562044
2004-05,954,Kerry Kittles,SG,28,73,21,52,7,21,Center,2,Jump Shot,15.287671232876713
2021-22,1630556,Kessler Edwards,SF,110,267,62,131,48,136,Center,2,Jump Shot,14.98876404494382
2022-23,1630556,Kessler Edwards,SF,36,93,19,38,17,55,Center,3,Jump Shot,16.559139784946236
2005-06,101207,Kevin Burleson,PG,22,88,12,34,10,54,Center,1,Jump Shot,19.795454545454547
2007-08,201142,Kevin Durant,SG,587,1366,528,1161,59,205,Center,28,Jump Shot,12.378477306002928
2008-09,201142,Kevin Durant,SF,661,1390,564,1160,97,230,Center,25,Jump Shot,12.497841726618706
2009-10,201142,Kevin Durant,SF,794,1668,666,1317,128,351,Center,24,Jump Shot,12.851918465227818
2010-11,201142,Kevin Durant,SF,711,1538,566,1124,145,414,Center,29,Jump Shot,14.982444733420026
2011-12,201142,Kevin Durant,SF,643,1297,510,953,133,344,Center,31,Jump Shot,13.269853508095606
2012-13,201142,Kevin Durant,SF,731,1433,592,1099,139,334,Center,24,Jump Shot,12.801814375436148
2013-14,201142,Kevin Durant,SF,849,1688,657,1197,192,491,Center,34,Jump Shot,13.300947867298579
2014-15,201142,Kevin Durant,SF,238,467,174,308,64,159,Center,11,Jump Shot,14.417558886509635
2015-16,201142,Kevin Durant,SF,698,1381,512,900,186,481,Center,30,Jump Shot,14.580738595220854
2016-17,201142,Kevin Durant,PF,551,1026,434,714,117,312,Center,15,Jump Shot,13.347953216374268
2017-18,201142,Kevin Durant,SF,630,1222,457,809,173,413,Center,13,Jump Shot,15.382978723404255
2018-19,201142,Kevin Durant,SF,721,1383,584,995,137,388,Center,21,Jump Shot,14.451916124367317
2020-21,201142,Kevin Durant,PF,324,603,239,414,85,189,Center,8,Jump Shot,14.446102819237147
2021-22,201142,Kevin Durant,PF,578,1115,463,815,115,300,Center,23,Pullup Jump shot,14.657399103139014
2022-23,201142,Kevin Durant,PF-SF,483,862,390,632,93,230,Center,12,Pullup Jump shot,14.638051044083527
2003-04,708,Kevin Garnett,PF,804,1611,793,1568,11,43,Center,33,Jump Shot,10.827436374922408
2004-05,708,Kevin Garnett,PF,683,1360,677,1335,6,25,Center,37,Jump Shot,9.461029411764706
2005-06,708,Kevin Garnett,PF,626,1191,618,1161,8,30,Center,30,Jump Shot,10.43408900083963
2006-07,708,Kevin Garnett,PF,638,1341,626,1285,12,56,Center,18,Jump Shot,11.36241610738255
2007-08,708,Kevin Garnett,PF,534,990,534,979,0,11,Center,14,Jump Shot,11.00909090909091
2008-09,708,Kevin Garnett,PF,393,740,391,732,2,8,Center,16,Jump Shot,10.933783783783785
2009-10,708,Kevin Garnett,PF,402,772,401,767,1,5,Center,14,Jump Shot,10.724093264248705
2010-11,708,Kevin Garnett,PF,434,822,433,817,1,5,Center,14,Jump Shot,10.481751824817518
2011-12,708,Kevin Garnett,C,391,777,388,768,3,9,Center,16,Jump Shot,11.871299871299872
2012-13,708,Kevin Garnett,C,422,850,420,834,2,16,Center,11,Jump Shot,12.038823529411765
2013-14,708,Kevin Garnett,C,157,356,157,353,0,3,Center,4,Jump Shot,12.629213483146067
2014-15,708,Kevin Garnett,PF,143,306,142,299,1,7,Center,2,Jump Shot,13.529411764705882
2015-16,708,Kevin Garnett,PF,54,115,54,114,0,1,Center,0,Jump Shot,13.643478260869566
2019-20,1628987,Kevin Hervey,PF,7,27,4,7,3,20,Center,2,Jump Shot,21.703703703703702
2018-19,1628989,Kevin Huerter,SG,275,657,139,304,136,353,Center,15,Jump Shot,16.299847792998477
2019-20,1628989,Kevin Huerter,SG,252,610,125,276,127,334,Center,7,Jump Shot,17.611475409836064
2020-21,1628989,Kevin Huerter,SG,316,731,176,345,140,386,Center,7,Jump Shot,16.928864569083448
2021-22,1628989,Kevin Huerter,SF,345,760,185,349,160,411,Center,7,Jump Shot,17.489473684210527
2022-23,1628989,Kevin Huerter,SG,420,866,215,356,205,510,Center,17,Jump Shot,17.67782909930716
2012-13,203158,Kevin Jones,PF,43,107,43,107,0,0,Center,5,Jump Shot,7.514018691588785
2018-19,1628995,Kevin Knox II,PF,338,914,213,550,125,364,Center,15,Jump Shot,14.699124726477024
2019-20,1628995,Kevin Knox II,SF,144,401,79,202,65,199,Center,4,Jump Shot,16.164588528678305
2020-21,1628995,Kevin Knox II,SF,56,143,21,54,35,89,Center,7,Jump Shot,17.762237762237763
2021-22,1628995,Kevin Knox II,SF,31,85,16,31,15,54,Center,4,Jump Shot,18.094117647058823
2022-23,1628995,Kevin Knox II,PF-SF,152,332,87,146,65,186,Center,11,Jump Shot,16.117469879518072
2008-09,201567,Kevin Love,C,316,688,314,669,2,19,Center,13,Jump Shot,6.825581395348837
2009-10,201567,Kevin Love,PF,291,646,256,540,35,106,Center,11,Jump Shot,9.181114551083592
2010-11,201567,Kevin Love,PF,482,1026,394,815,88,211,Center,20,Jump Shot,9.939571150097466
2011-12,201567,Kevin Love,PF,474,1059,369,777,105,282,Center,17,Jump Shot,11.814919735599622
2012-13,201567,Kevin Love,PF,105,298,85,206,20,92,Center,4,Jump Shot,12.231543624161073
2013-14,201567,Kevin Love,PF,650,1421,460,916,190,505,Center,22,Jump Shot,13.812807881773399
2014-15,201567,Kevin Love,PF,413,952,269,560,144,392,Center,8,Jump Shot,14.293067226890756
2015-16,201567,Kevin Love,PF,408,976,251,538,157,438,Center,9,Jump Shot,15.135245901639344
2016-17,201567,Kevin Love,PF,370,867,225,478,145,389,Center,7,Jump Shot,14.785467128027681
2017-18,201567,Kevin Love,C,334,729,197,399,137,330,Center,4,Jump Shot,14.887517146776407
2018-19,201567,Kevin Love,PF,109,283,56,136,53,147,Center,6,Jump Shot,16.268551236749115
2019-20,201567,Kevin Love,PF,327,727,181,337,146,390,Center,11,Jump Shot,17.851444291609354
2020-21,201567,Kevin Love,PF,103,252,46,96,57,156,Center,2,Jump Shot,18.857142857142858
2021-22,201567,Kevin Love,C,327,761,140,284,187,477,Center,3,Jump Shot,19.226018396846253
2022-23,201567,Kevin Love,PF,165,424,66,128,99,296,Center,1,Jump Shot,19.76179245283019
2004-05,2755,Kevin Martin,PG,45,117,40,92,5,25,Center,5,Jump Shot,11.495726495726496
2005-06,2755,Kevin Martin,SG,262,546,196,367,66,179,Center,12,Jump Shot,12.82967032967033
2006-07,2755,Kevin Martin,SG,505,1067,378,734,127,333,Center,25,Jump Shot,13.81630740393627
2007-08,2755,Kevin Martin,SG,417,914,310,648,107,266,Center,13,Jump Shot,13.591903719912473
2008-09,2755,Kevin Martin,SG,341,811,226,534,115,277,Center,9,Jump Shot,15.352651048088779
2009-10,2755,Kevin Martin,SG,289,693,219,483,70,210,Center,9,Jump Shot,14.630591630591631
2010-11,2755,Kevin Martin,SG,553,1267,377,808,176,459,Center,21,Jump Shot,15.251775848460932
2011-12,2755,Kevin Martin,SG,222,537,144,312,78,225,Center,7,Jump Shot,16.649906890130353
2012-13,2755,Kevin Martin,SG,350,778,192,407,158,371,Center,6,Jump Shot,16.47814910025707
2013-14,2755,Kevin Martin,SG,439,1022,325,726,114,296,Center,17,Jump Shot,13.970645792563602
2014-15,2755,Kevin Martin,SG,267,625,192,434,75,191,Center,11,Jump Shot,15.9904
2015-16,2755,Kevin Martin,SG,156,418,107,283,49,135,Center,5,Jump Shot,15.0933014354067
2012-13,203122,Kevin Murphy,SG,7,28,6,23,1,5,Center,3,Jump Shot,16.0
2003-04,1563,Kevin Ollie,PG,95,257,91,248,4,9,Center,8,Jump Shot,10.560311284046692
2004-05,1563,Kevin Ollie,PG,11,31,11,31,0,0,Center,1,Jump Shot,12.129032258064516
2005-06,1563,Kevin Ollie,SG,75,174,74,171,1,3,Center,3,Jump Shot,12.431034482758621
2006-07,1563,Kevin Ollie,PG,81,187,81,185,0,2,Center,3,Jump Shot,11.235294117647058
2007-08,1563,Kevin Ollie,SG,29,69,29,68,0,1,Center,1,Jump Shot,10.130434782608695
2008-09,1563,Kevin Ollie,PG,61,150,61,149,0,1,Center,5,Jump Shot,10.713333333333333
2009-10,1563,Kevin Ollie,PG,18,45,18,44,0,1,Center,2,Jump Shot,11.911111111111111
2021-22,1630698,Kevin Pangos,PG,15,46,9,20,6,26,Center,4,Jump Shot,17.282608695652176
2019-20,1629645,Kevin Porter Jr.,SF,186,421,133,263,53,158,Center,12,Jump Shot,13.513064133016627
2020-21,1629645,Kevin Porter Jr.,SG,156,367,106,206,50,161,Center,7,Jump Shot,14.841961852861035
2021-22,1629645,Kevin Porter Jr.,PG,335,808,180,395,155,413,Center,17,Jump Shot,16.019801980198018
2022-23,1629645,Kevin Porter Jr.,PG,391,884,250,499,141,385,Center,17,Pullup Jump shot,15.164027149321267
2010-11,202338,Kevin Seraphin,PF,66,147,66,147,0,0,Center,3,Jump Shot,4.312925170068027
2011-12,202338,Kevin Seraphin,C,203,382,203,381,0,1,Center,11,Jump Shot,5.719895287958115
2012-13,202338,Kevin Seraphin,C,330,716,330,716,0,0,Center,11,Jump Shot,8.614525139664805
2013-14,202338,Kevin Seraphin,C,111,220,111,220,0,0,Center,3,Jump Shot,7.209090909090909
2014-15,202338,Kevin Seraphin,C,231,450,231,448,0,2,Center,10,Jump Shot,8.044444444444444
2015-16,202338,Kevin Seraphin,C,84,205,84,203,0,2,Center,1,Jump Shot,9.214634146341464
2016-17,202338,Kevin Seraphin,PF,109,198,109,196,0,2,Center,8,Jump Shot,8.444444444444445
2003-04,788,Kevin Willis,C,70,150,70,149,0,1,Center,11,Jump Shot,8.333333333333334
2004-05,788,Kevin Willis,C,35,90,35,88,0,2,Center,0,Jump Shot,6.433333333333334
2006-07,788,Kevin Willis,PF,5,13,5,13,0,0,Center,1,Jump Shot,7.6923076923076925
2006-07,200838,Kevinn Pinkney,PF,12,27,11,25,1,2,Center,1,Jump Shot,11.851851851851851
2022-23,1630284,Kevon Harris,SG,47,107,31,64,16,43,Center,2,Jump Shot,11.794392523364486
2015-16,1626172,Kevon Looney,PF,4,7,3,5,1,2,Center,2,Jump Shot,12.142857142857142
2016-17,1626172,Kevon Looney,C,56,107,54,98,2,9,Center,8,Jump Shot,4.747663551401869
2017-18,1626172,Kevon Looney,C,112,193,111,188,1,5,Center,9,Layup Shot,4.803108808290156
2018-19,1626172,Kevon Looney,C,217,347,216,337,1,10,Center,6,Jump Shot,4.221902017291066
2019-20,1626172,Kevon Looney,C,29,79,28,65,1,14,Center,0,Jump Shot,9.30379746835443
2020-21,1626172,Kevon Looney,C,108,197,104,180,4,17,Center,3,Jump Shot,5.8578680203045685
2021-22,1626172,Kevon Looney,C,208,364,208,363,0,1,Center,5,Cutting Dunk Shot,4.1401098901098905
2022-23,1626172,Kevon Looney,C,242,384,242,383,0,1,Center,4,Cutting Layup Shot,3.1197916666666665
2003-04,2039,Keyon Dooling,PG,137,352,129,306,8,46,Center,18,Jump Shot,13.338068181818182
2004-05,2039,Keyon Dooling,PG,139,345,120,270,19,75,Center,6,Jump Shot,14.843478260869565
2005-06,2039,Keyon Dooling,PG,178,405,165,362,13,43,Center,10,Jump Shot,11.612345679012346
2006-07,2039,Keyon Dooling,SG,188,458,157,362,31,96,Center,5,Jump Shot,13.246724890829695
2007-08,2039,Keyon Dooling,PG,198,423,176,358,22,65,Center,6,Jump Shot,12.070921985815604
2008-09,2039,Keyon Dooling,PG,261,598,162,363,99,235,Center,16,Jump Shot,15.25418060200669
2009-10,2039,Keyon Dooling,PG,129,324,70,167,59,157,Center,7,Jump Shot,17.45679012345679
2010-11,2039,Keyon Dooling,PG,206,518,125,285,81,233,Center,8,Jump Shot,17.584942084942085
2011-12,2039,Keyon Dooling,SG,66,163,39,82,27,81,Center,1,Jump Shot,17.858895705521473
2012-13,2039,Keyon Dooling,PG,10,21,5,9,5,12,Center,0,Jump Shot,19.38095238095238
2017-18,203920,Khem Birch,C,68,126,68,126,0,0,Center,7,Jump Shot,4.2063492063492065
2018-19,203920,Khem Birch,C,91,151,91,150,0,1,Center,7,Tip Layup Shot,3.033112582781457
2019-20,203920,Khem Birch,C,73,143,73,142,0,1,Center,1,Floating Jump shot,4.055944055944056
2020-21,203920,Khem Birch,C,189,380,176,328,13,52,Center,6,Jump Shot,7.83421052631579
2021-22,203920,Khem Birch,C,97,200,97,186,0,14,Center,1,Floating Jump shot,5.91
2022-23,203920,Khem Birch,C,19,32,18,30,1,2,Center,0,Cutting Dunk Shot,6.03125
2012-13,203114,Khris Middleton,SG,62,141,48,96,14,45,Center,9,Jump Shot,14.26241134751773
2013-14,203114,Khris Middleton,SF,376,854,256,564,120,290,Center,23,Jump Shot,15.387587822014051
2014-15,203114,Khris Middleton,SF,406,869,297,601,109,268,Center,19,Jump Shot,14.790563866513233
2015-16,203114,Khris Middleton,SG,507,1142,364,781,143,361,Center,25,Jump Shot,15.18213660245184
2016-17,203114,Khris Middleton,SF,150,333,105,229,45,104,Center,5,Jump Shot,14.621621621621621
2017-18,203114,Khris Middleton,SF,593,1272,447,865,146,407,Center,31,Jump Shot,15.16745283018868
2018-19,203114,Khris Middleton,SF,506,1148,327,674,179,474,Center,14,Jump Shot,15.455574912891986
2019-20,203114,Khris Middleton,SF,471,947,324,593,147,354,Center,13,Jump Shot,16.12143611404435
2020-21,203114,Khris Middleton,SF,511,1074,360,709,151,365,Center,15,Jump Shot,15.164804469273744
2021-22,203114,Khris Middleton,SF,452,1021,290,587,162,434,Center,14,Jump Shot,16.852105778648383
2022-23,203114,Khris Middleton,SF,177,406,126,244,51,162,Center,4,Jump Shot,15.916256157635468
2018-19,1629017,Khyri Thomas,SG,22,69,12,34,10,35,Center,7,Jump Shot,16.26086956521739
2019-20,1629017,Khyri Thomas,SG,5,17,0,3,5,14,Right Side Center,1,Jump Shot,22.176470588235293
2020-21,1629017,Khyri Thomas,SG,32,66,23,39,9,27,Center,0,Jump Shot,14.348484848484848
2020-21,1630165,Killian Hayes,PG,71,201,51,129,20,72,Center,6,Jump Shot,13.83084577114428
2021-22,1630165,Killian Hayes,PG,176,459,132,292,44,167,Center,5,Jump Shot,13.808278867102397
2022-23,1630165,Killian Hayes,PG,307,815,227,529,80,286,Center,16,Pullup Jump shot,15.150920245398773
2020-21,1629681,Killian Tillie,C,19,57,9,24,10,33,Center,3,Jump Shot,16.649122807017545
2021-22,1629681,Killian Tillie,C,43,127,16,41,27,86,Right Side Center,2,Jump Shot,18.212598425196852
2012-13,203119,Kim English,SG,42,112,28,62,14,50,Center,7,Jump Shot,15.401785714285714
2020-21,1630184,Kira Lewis Jr.,PG,130,337,90,217,40,120,Center,9,Jump Shot,12.237388724035608
2021-22,1630184,Kira Lewis Jr.,PG,59,146,46,88,13,58,Center,0,Jump Shot,14.335616438356164
2022-23,1630184,Kira Lewis Jr.,PG,40,88,25,54,15,34,Center,2,Jump Shot,13.875
2003-04,2550,Kirk Hinrich,PG,318,823,174,454,144,369,Center,9,Jump Shot,15.978128797083839
2004-05,2550,Kirk Hinrich,PG,445,1122,300,714,145,408,Center,9,Jump Shot,16.575757575757574
2005-06,2550,Kirk Hinrich,PG,451,1078,325,737,126,341,Center,18,Jump Shot,15.369202226345083
2006-07,2550,Kirk Hinrich,PG,475,1061,335,724,140,337,Center,20,Jump Shot,15.960414703110274
2007-08,2550,Kirk Hinrich,PG,330,797,246,557,84,240,Center,6,Jump Shot,16.427854454203263
2008-09,2550,Kirk Hinrich,SG,183,418,114,250,69,168,Center,2,Jump Shot,17.79665071770335
2009-10,2550,Kirk Hinrich,SG,308,752,204,473,104,279,Center,8,Jump Shot,17.440159574468087
2010-11,2550,Kirk Hinrich,SG-PG,278,623,203,435,75,188,Center,6,Jump Shot,16.608346709470304
2011-12,2550,Kirk Hinrich,SG,122,295,75,159,47,136,Center,0,Jump Shot,17.07457627118644
2012-13,2550,Kirk Hinrich,PG,159,422,88,240,71,182,Center,4,Jump Shot,17.42654028436019
2013-14,2550,Kirk Hinrich,PG,243,619,158,377,85,242,Center,10,Jump Shot,17.15670436187399
2014-15,2550,Kirk Hinrich,SG,142,381,84,213,58,168,Center,6,Jump Shot,17.540682414698164
2015-16,2550,Kirk Hinrich,PG,49,129,25,67,24,62,Center,0,Jump Shot,16.2015503875969
2003-04,2632,Kirk Penney,SG,1,6,0,3,1,3,Left Side,0,Jump Shot,21.333333333333332
2004-05,2632,Kirk Penney,SG,1,3,1,2,0,1,Left Side Center,0,Jump Shot,20.333333333333332
2004-05,2745,Kirk Snyder,SG,122,328,92,243,30,85,Center,15,Jump Shot,13.237804878048781
2005-06,2745,Kirk Snyder,SG,205,453,159,324,46,129,Center,10,Jump Shot,13.01766004415011
2006-07,2745,Kirk Snyder,SF,66,146,55,102,11,44,Center,2,Jump Shot,11.116438356164384
2007-08,2745,Kirk Snyder,SF-PF,96,189,91,166,5,23,Center,8,Jump Shot,7.8994708994708995
2011-12,202691,Klay Thompson,SG,318,718,207,450,111,268,Center,20,Jump Shot,16.74373259052925
2012-13,202691,Klay Thompson,SG,508,1205,297,679,211,526,Center,10,Jump Shot,17.34771784232365
2013-14,202691,Klay Thompson,SG,559,1259,336,724,223,535,Center,15,Jump Shot,16.72597299444003
2014-15,202691,Klay Thompson,SG,602,1299,363,754,239,545,Center,15,Jump Shot,16.107005388760584
2015-16,202691,Klay Thompson,SG,651,1386,375,736,276,650,Center,18,Jump Shot,16.483405483405484
2016-17,202691,Klay Thompson,SG,644,1376,376,729,268,647,Center,7,Jump Shot,17.177325581395348
2017-18,202691,Klay Thompson,SG,575,1177,346,657,229,520,Center,7,Jump Shot,17.88785046728972
2018-19,202691,Klay Thompson,SG,655,1402,414,803,241,599,Center,10,Jump Shot,17.1811697574893
2021-22,202691,Klay Thompson,SG,246,573,132,277,114,296,Center,7,Jump Shot,18.43106457242583
2022-23,202691,Klay Thompson,SG,546,1252,245,521,301,731,Center,25,Jump Shot,19.118210862619808
2003-04,977,Kobe Bryant,SG,516,1178,445,961,71,217,Center,26,Jump Shot,11.53904923599321
2004-05,977,Kobe Bryant,SG,573,1324,442,937,131,387,Center,20,Jump Shot,13.554380664652568
2005-06,977,Kobe Bryant,SG,978,2173,798,1655,180,518,Center,39,Jump Shot,14.739530602853199
2006-07,977,Kobe Bryant,SG,813,1757,676,1359,137,398,Center,43,Jump Shot,14.110415480933408
2007-08,977,Kobe Bryant,SG,775,1690,625,1275,150,415,Center,37,Jump Shot,14.011242603550295
2008-09,977,Kobe Bryant,SG,800,1712,682,1376,118,336,Center,47,Jump Shot,13.632593457943925
2009-10,977,Kobe Bryant,SG,716,1569,617,1268,99,301,Center,32,Jump Shot,13.05672402804334
2010-11,977,Kobe Bryant,SG,740,1639,625,1283,115,356,Center,33,Jump Shot,13.957291031116535
2011-12,977,Kobe Bryant,SG,574,1336,487,1049,87,287,Center,33,Jump Shot,14.52245508982036
2012-13,977,Kobe Bryant,SG,736,1593,606,1188,130,405,Center,49,Jump Shot,13.875706214689265
2013-14,977,Kobe Bryant,SG,31,73,28,57,3,16,Center,2,Jump Shot,14.191780821917808
2014-15,977,Kobe Bryant,SG,266,713,212,529,54,184,Center,13,Jump Shot,15.20476858345021
2015-16,977,Kobe Bryant,SF,398,1113,265,646,133,467,Center,18,Jump Shot,17.345911949685533
2017-18,1628424,Kobi Simmons,PG,80,189,69,150,11,39,Center,4,Jump Shot,11.285714285714286
2022-23,1628424,Kobi Simmons,PG,1,6,0,1,1,5,Right Side Center,0,Jump Shot,21.833333333333332
2008-09,201585,Kosta Koufos,C,94,185,94,185,0,0,Center,14,Jump Shot,5.405405405405405
2009-10,201585,Kosta Koufos,C,22,47,22,47,0,0,Center,7,Layup Shot,3.851063829787234
2010-11,201585,Kosta Koufos,C,68,150,68,148,0,2,Center,7,Jump Shot,5.8
2011-12,201585,Kosta Koufos,C,115,192,115,192,0,0,Center,6,Layup Shot,2.5104166666666665
2012-13,201585,Kosta Koufos,C,295,508,295,507,0,1,Center,5,Layup Shot,2.940944881889764
2013-14,201585,Kosta Koufos,C,227,459,227,459,0,0,Center,1,Hook Shot,4.490196078431373
2014-15,201585,Kosta Koufos,C,182,358,182,358,0,0,Center,4,Jump Shot,4.921787709497207
2015-16,201585,Kosta Koufos,C,236,444,236,444,0,0,Center,10,Hook Shot,4.436936936936937
2016-17,201585,Kosta Koufos,C,216,392,216,391,0,1,Center,1,Hook Shot,4.344387755102041
2017-18,201585,Kosta Koufos,C,222,389,222,389,0,0,Center,2,Hook Shot,5.007712082262211
2018-19,201585,Kosta Koufos,C,73,153,73,153,0,0,Center,4,Hook Shot,5.457516339869281
2007-08,200785,Kosta Perovic,C,3,10,3,10,0,0,Center,0,Layup Shot,3.8
2018-19,1628961,Kostas Antetokounmpo,PF,0,3,0,3,0,0,Center,0,Jump Shot,3.3333333333333335
2019-20,1628961,Kostas Antetokounmpo,PF,3,3,3,3,0,0,Center,0,Cutting Dunk Shot,1.0
2020-21,1628961,Kostas Antetokounmpo,PF,3,10,3,10,0,0,Center,1,Cutting Layup Shot,3.7
2014-15,203123,Kostas Papanikolaou,SF,69,197,38,91,31,106,Center,4,Jump Shot,14.97969543147208
2015-16,203123,Kostas Papanikolaou,SF,24,66,14,34,10,32,Center,0,Jump Shot,15.681818181818182
2016-17,1627739,Kris Dunn,PG,118,313,97,240,21,73,Center,1,Jump Shot,13.370607028753994
2017-18,1627739,Kris Dunn,PG,286,666,243,532,43,134,Center,19,Jump Shot,12.025525525525525
2018-19,1627739,Kris Dunn,PG,215,506,181,410,34,96,Center,7,Jump Shot,11.152173913043478
2019-20,1627739,Kris Dunn,PG,152,342,123,230,29,112,Center,1,Jump Shot,10.830409356725147
2020-21,1627739,Kris Dunn,PG,1,12,1,10,0,2,Center,0,Pullup Jump shot,10.916666666666666
2021-22,1627739,Kris Dunn,PG,44,102,43,91,1,11,Center,0,Driving Layup Shot,8.57843137254902
2022-23,1627739,Kris Dunn,PG,116,216,99,180,17,36,Center,6,Driving Layup Shot,8.805555555555555
2004-05,2743,Kris Humphries,PF,116,287,114,281,2,6,Center,9,Jump Shot,8.233449477351916
2005-06,2743,Kris Humphries,PF,77,203,77,198,0,5,Center,6,Jump Shot,8.719211822660098
2006-07,2743,Kris Humphries,PF,87,185,87,185,0,0,Center,6,Jump Shot,4.162162162162162
2007-08,2743,Kris Humphries,PF,161,333,161,331,0,2,Center,11,Jump Shot,7.324324324324325
2008-09,2743,Kris Humphries,SF,38,90,38,90,0,0,Center,2,Jump Shot,8.022222222222222
2009-10,2743,Kris Humphries,PF,180,408,180,407,0,1,Center,16,Jump Shot,8.029411764705882
2010-11,2743,Kris Humphries,PF,307,583,307,582,0,1,Center,11,Jump Shot,5.9468267581475125
2011-12,2743,Kris Humphries,PF,323,671,323,671,0,0,Center,10,Jump Shot,7.070044709388972
2012-13,2743,Kris Humphries,PF,139,310,139,308,0,2,Center,1,Jump Shot,6.735483870967742
2013-14,2743,Kris Humphries,PF,231,461,231,459,0,2,Center,6,Jump Shot,10.674620390455532
2014-15,2743,Kris Humphries,PF,211,446,211,439,0,7,Center,4,Jump Shot,10.390134529147982
2015-16,2743,Kris Humphries,PF,121,295,87,187,34,108,Center,11,Jump Shot,14.816949152542373
2016-17,2743,Kris Humphries,PF,87,214,68,160,19,54,Center,4,Jump Shot,11.44392523364486
2012-13,203126,Kris Joseph,SF,2,14,2,11,0,3,Center,2,Jump Shot,14.285714285714286
2015-16,204001,Kristaps Porzingis,PF,373,886,292,643,81,243,Center,7,Jump Shot,13.191873589164786
2016-17,204001,Kristaps Porzingis,PF,443,985,331,671,112,314,Center,15,Jump Shot,13.63248730964467
2017-18,204001,Kristaps Porzingis,PF,390,889,300,661,90,228,Center,14,Jump Shot,14.281214848143982
2019-20,204001,Kristaps Porzingis,C,398,932,256,529,142,403,Center,6,Jump Shot,15.859442060085836
2020-21,204001,Kristaps Porzingis,C,325,683,228,425,97,258,Center,8,Jump Shot,14.626647144948755
2021-22,204001,Kristaps Porzingis,PF,352,767,274,515,78,252,Center,14,Jump Shot,13.852672750977836
2022-23,204001,Kristaps Porzingis,C,507,1018,370,662,137,356,Center,13,Jump Shot,14.445972495088409
2003-04,703,Kurt Thomas,PF,392,829,392,826,0,3,Center,8,Jump Shot,11.469240048250905
2004-05,703,Kurt Thomas,PF,424,901,422,897,2,4,Left Side,26,Jump Shot,13.520532741398446
2005-06,703,Kurt Thomas,C,190,391,190,391,0,0,Center,0,Jump Shot,11.074168797953964
2006-07,703,Kurt Thomas,C,126,259,126,258,0,1,Center,1,Jump Shot,10.38996138996139
2007-08,703,Kurt Thomas,C-PF,195,396,195,395,0,1,Center,12,Jump Shot,11.1489898989899
2008-09,703,Kurt Thomas,PF,153,304,153,302,0,2,Center,8,Jump Shot,11.098684210526315
2009-10,703,Kurt Thomas,C,99,208,99,208,0,0,Center,1,Jump Shot,11.658653846153847
2010-11,703,Kurt Thomas,PF,95,186,94,185,1,1,Center,4,Jump Shot,12.779569892473118
2011-12,703,Kurt Thomas,C,73,157,73,157,0,0,Center,0,Jump Shot,14.101910828025478
2012-13,703,Kurt Thomas,PF,45,83,44,82,1,1,Center,2,Jump Shot,13.831325301204819
2003-04,2198,Kwame Brown,PF,288,589,287,587,1,2,Center,10,Jump Shot,4.426146010186757
2004-05,2198,Kwame Brown,PF,109,237,109,237,0,0,Center,0,Jump Shot,6.151898734177215
2005-06,2198,Kwame Brown,C,204,388,204,387,0,1,Center,4,Layup Shot,3.1572164948453607
2006-07,2198,Kwame Brown,C,143,242,143,241,0,1,Center,4,Layup Shot,1.5454545454545454
2007-08,2198,Kwame Brown,C,72,142,72,142,0,0,Center,2,Layup Shot,2.464788732394366
2008-09,2198,Kwame Brown,C,90,169,90,169,0,0,Center,4,Layup Shot,2.834319526627219
2009-10,2198,Kwame Brown,C,62,124,62,123,0,1,Center,1,Layup Shot,3.6451612903225805
2010-11,2198,Kwame Brown,C,194,375,194,375,0,0,Center,8,Layup Shot,3.9306666666666668
2011-12,2198,Kwame Brown,C,21,40,21,40,0,0,Center,1,Layup Shot,2.325
2012-13,2198,Kwame Brown,C,17,37,17,37,0,0,Center,0,Layup Shot,2.324324324324324
2019-20,1629065,Ky Bowman,PG,134,321,101,214,33,107,Center,9,Jump Shot,14.264797507788161
2019-20,1629734,Kyle Alexander,C,1,2,1,2,0,0,Center,1,Putback Layup Shot,1.0
2014-15,203937,Kyle Anderson,SF,31,89,28,78,3,11,Center,2,Jump Shot,10.910112359550562
2015-16,203937,Kyle Anderson,SF,138,295,126,258,12,37,Center,19,Jump Shot,11.423728813559322
2016-17,203937,Kyle Anderson,SF,93,208,78,169,15,39,Center,13,Jump Shot,10.649038461538462
2017-18,203937,Kyle Anderson,SF,231,438,212,381,19,57,Center,4,Jump Shot,8.349315068493151
2018-19,203937,Kyle Anderson,SF,150,276,141,242,9,34,Center,4,Jump Shot,7.365942028985507
2019-20,203937,Kyle Anderson,SF,157,331,133,246,24,85,Center,3,Jump Shot,11.347432024169184
2020-21,203937,Kyle Anderson,PF,308,658,214,397,94,261,Center,8,Jump Shot,14.299392097264437
2021-22,203937,Kyle Anderson,PF,209,469,173,360,36,109,Center,5,Jump Shot,10.18550106609808
2022-23,203937,Kyle Anderson,PF,252,495,209,390,43,105,Center,7,Jump Shot,9.44040404040404
2017-18,1627858,Kyle Collinsworth,SF,38,99,34,82,4,17,Center,7,Jump Shot,7.646464646464646
2019-20,1629657,Kyle Guy,SG,2,5,2,2,0,3,Right Side Center,2,Jump Shot,19.6
2020-21,1629657,Kyle Guy,PG,29,88,16,42,13,46,Center,6,Jump Shot,15.715909090909092
2021-22,1629657,Kyle Guy,SG,26,65,12,25,14,40,Center,2,Jump Shot,18.153846153846153
2003-04,2594,Kyle Korver,SF,115,327,34,120,81,207,Right Side Center,9,Jump Shot,20.69724770642202
2004-05,2594,Kyle Korver,SF,317,759,91,201,226,558,Left Side Center,9,Jump Shot,21.247694334650856
2005-06,2594,Kyle Korver,SF,327,761,143,323,184,438,Center,10,Jump Shot,19.92378449408673
2006-07,2594,Kyle Korver,SF,372,845,240,538,132,307,Center,18,Jump Shot,17.847337278106508
2007-08,2594,Kyle Korver,SG-PF,255,575,144,279,111,296,Center,11,Jump Shot,18.98608695652174
2008-09,2594,Kyle Korver,SF,245,560,142,293,103,267,Center,13,Jump Shot,18.47142857142857
2009-10,2594,Kyle Korver,SG,138,280,79,170,59,110,Center,9,Jump Shot,18.664285714285715
2010-11,2594,Kyle Korver,SG,242,557,122,268,120,289,Left Side Center,21,Jump Shot,20.545780969479353
2011-12,2594,Kyle Korver,SG,178,411,60,141,118,270,Right Side Center,4,Jump Shot,21.223844282238442
2012-13,2594,Kyle Korver,SF,277,601,88,187,189,414,Right Side Center,4,Jump Shot,21.56073211314476
2013-14,2594,Kyle Korver,SG,289,609,104,217,185,392,Right Side Center,9,Jump Shot,20.991789819376027
2014-15,2594,Kyle Korver,SG,292,600,71,151,221,449,Center,7,Jump Shot,21.703333333333333
2015-16,2594,Kyle Korver,SG,267,616,110,220,157,396,Center,6,Jump Shot,20.689935064935064
2016-17,2594,Kyle Korver,SG,239,515,77,156,162,359,Center,5,Jump Shot,21.631067961165048
2017-18,2594,Kyle Korver,SG,222,484,58,108,164,376,Center,9,Jump Shot,22.136363636363637
2018-19,2594,Kyle Korver,SG-PF,201,483,63,135,138,348,Center,3,Jump Shot,22.00414078674948
2019-20,2594,Kyle Korver,SF,126,293,27,56,99,237,Left Side Center,8,Jump Shot,22.85665529010239
2017-18,1628398,Kyle Kuzma,PF,468,1039,309,605,159,434,Center,21,Jump Shot,14.045235803657363
2018-19,1628398,Kyle Kuzma,PF,496,1087,368,665,128,422,Center,17,Jump Shot,12.824287028518858
2019-20,1628398,Kyle Kuzma,PF,291,668,205,396,86,272,Center,13,Jump Shot,14.672155688622755
2020-21,1628398,Kyle Kuzma,SF,335,757,198,377,137,380,Center,14,Jump Shot,15.49669749009247
2021-22,1628398,Kyle Kuzma,PF,423,936,295,561,128,375,Center,21,Jump Shot,14.347222222222221
2022-23,1628398,Kyle Kuzma,PF,512,1142,352,661,160,481,Center,20,Jump Shot,14.436077057793344
2006-07,200768,Kyle Lowry,PG,14,38,11,30,3,8,Center,0,Jump Shot,9.447368421052632
2007-08,200768,Kyle Lowry,PG,256,592,220,452,36,140,Center,17,Jump Shot,11.364864864864865
2008-09,200768,Kyle Lowry,PG,189,434,164,336,25,98,Center,5,Jump Shot,10.935483870967742
2009-10,200768,Kyle Lowry,PG,184,464,147,328,37,136,Center,12,Jump Shot,11.592672413793103
2010-11,200768,Kyle Lowry,PG,345,809,216,466,129,343,Center,28,Jump Shot,15.372064276885043
2011-12,200768,Kyle Lowry,PG,210,513,131,302,79,211,Center,16,Jump Shot,14.929824561403509
2012-13,200768,Kyle Lowry,PG,250,623,149,344,101,279,Center,15,Jump Shot,15.640449438202246
2013-14,200768,Kyle Lowry,PG,457,1080,267,580,190,500,Center,24,Jump Shot,15.894444444444444
2014-15,200768,Kyle Lowry,PG,430,1043,298,652,132,391,Center,26,Jump Shot,15.155321188878236
2015-16,200768,Kyle Lowry,PG,512,1195,300,651,212,544,Center,25,Jump Shot,15.552301255230125
2016-17,200768,Kyle Lowry,PG,426,918,233,450,193,468,Center,17,Jump Shot,15.994553376906318
2017-18,200768,Kyle Lowry,PG,403,944,165,348,238,596,Center,18,Jump Shot,18.488347457627118
2018-19,200768,Kyle Lowry,PG,304,739,147,286,157,453,Center,14,Jump Shot,18.554803788903925
2019-20,200768,Kyle Lowry,PG,334,803,170,337,164,466,Center,15,Jump Shot,17.7546699875467
2020-21,200768,Kyle Lowry,PG,260,596,129,265,131,331,Center,10,Jump Shot,18.008389261744966
2021-22,200768,Kyle Lowry,PG,276,627,132,245,144,382,Center,10,Jump Shot,19.31578947368421
2022-23,200768,Kyle Lowry,PG,196,485,89,175,107,310,Center,10,Jump Shot,18.855670103092784
2012-13,203124,Kyle O'Quinn,C,101,197,101,196,0,1,Center,12,Jump Shot,7.675126903553299
2013-14,203124,Kyle O'Quinn,C,186,371,186,368,0,3,Center,8,Jump Shot,9.95687331536388
2014-15,203124,Kyle O'Quinn,PF,119,242,107,199,12,43,Center,6,Jump Shot,11.37190082644628
2015-16,203124,Kyle O'Quinn,PF,129,271,124,249,5,22,Center,5,Jump Shot,10.623616236162361
2016-17,203124,Kyle O'Quinn,C,215,412,213,396,2,16,Center,5,Jump Shot,8.49757281553398
2017-18,203124,Kyle O'Quinn,C,224,384,220,367,4,17,Center,6,Jump Shot,7.291666666666667
2018-19,203124,Kyle O'Quinn,C,69,136,68,124,1,12,Center,12,Jump Shot,11.757352941176471
2019-20,203124,Kyle O'Quinn,C,42,85,35,58,7,27,Center,5,Jump Shot,12.341176470588236
2012-13,202713,Kyle Singler,SF,275,642,205,442,70,200,Center,11,Jump Shot,12.445482866043614
2013-14,202713,Kyle Singler,SF,269,602,175,356,94,246,Center,5,Jump Shot,14.112956810631228
2014-15,202713,Kyle Singler,SF,172,446,76,205,96,241,Center,4,Jump Shot,17.071748878923767
2015-16,202713,Kyle Singler,SF,86,221,56,124,30,97,Center,3,Jump Shot,14.14027149321267
2016-17,202713,Kyle Singler,SF,34,83,27,46,7,37,Center,2,Jump Shot,12.759036144578314
2017-18,202713,Kyle Singler,SF,7,21,5,16,2,5,Center,3,Jump Shot,11.333333333333334
2008-09,201602,Kyle Weaver,SG,113,246,81,153,32,93,Center,10,Jump Shot,13.666666666666666
2009-10,201602,Kyle Weaver,SG,12,33,5,14,7,19,Left Side,1,Jump Shot,19.333333333333332
2010-11,201602,Kyle Weaver,SG,9,25,6,18,3,7,Center,1,Jump Shot,14.32
2016-17,1627787,Kyle Wiltjer,PF,4,14,0,1,4,13,Left Side Center,2,Jump Shot,25.142857142857142
2011-12,202681,Kyrie Irving,PG,350,747,277,564,73,183,Center,28,Jump Shot,11.555555555555555
2012-13,202681,Kyrie Irving,PG,484,1070,375,791,109,279,Center,38,Jump Shot,13.438317757009345
2013-14,202681,Kyrie Irving,PG,532,1237,409,893,123,344,Center,23,Jump Shot,14.044462409054164
2014-15,202681,Kyrie Irving,PG,577,1234,421,857,156,377,Center,23,Jump Shot,12.87034035656402
2015-16,202681,Kyrie Irving,PG,394,879,310,617,84,262,Center,9,Jump Shot,13.255972696245733
2016-17,202681,Kyrie Irving,PG,671,1418,494,979,177,439,Center,21,Jump Shot,13.456981664315938
2017-18,202681,Kyrie Irving,PG,534,1087,368,680,166,407,Center,36,Jump Shot,14.444342226310948
2018-19,202681,Kyrie Irving,PG,604,1241,430,807,174,434,Center,29,Jump Shot,14.120870265914585
2019-20,202681,Kyrie Irving,PG,199,416,143,274,56,142,Center,8,Pullup Jump shot,14.098557692307692
2020-21,202681,Kyrie Irving,PG,549,1086,397,708,152,378,Center,16,Pullup Jump shot,14.097605893186003
2021-22,202681,Kyrie Irving,PG,289,616,189,377,100,239,Center,10,Pullup Jump shot,16.024350649350648
2022-23,202681,Kyrie Irving,PG,594,1203,406,707,188,496,Center,27,Pullup Jump shot,15.264339152119701
2007-08,201178,Kyrylo Fesenko,C,6,16,6,16,0,0,Center,1,Layup Shot,0.9375
2008-09,201178,Kyrylo Fesenko,C,21,36,21,36,0,0,Center,3,Layup Shot,2.5
2009-10,201178,Kyrylo Fesenko,C,52,95,52,94,0,1,Center,6,Layup Shot,2.136842105263158
2010-11,201178,Kyrylo Fesenko,C,44,100,44,99,0,1,Center,1,Jump Shot,4.93
2011-12,201178,Kyrylo Fesenko,C,2,5,2,5,0,0,Center,0,Layup Shot,2.6
2006-07,200746,LaMarcus Aldridge,C,241,479,241,477,0,2,Center,21,Jump Shot,8.979123173277662
2007-08,200746,LaMarcus Aldridge,PF,561,1160,560,1153,1,7,Center,19,Jump Shot,10.464655172413794
2008-09,200746,LaMarcus Aldridge,PF,601,1243,594,1215,7,28,Center,10,Jump Shot,10.679806918744973
2009-10,200746,LaMarcus Aldridge,PF,579,1169,574,1153,5,16,Center,9,Jump Shot,10.405474764756201
2010-11,200746,LaMarcus Aldridge,PF,707,1415,703,1392,4,23,Center,17,Jump Shot,8.765371024734982
2011-12,200746,LaMarcus Aldridge,PF,483,943,481,932,2,11,Center,13,Jump Shot,10.151643690349948
2012-13,200746,LaMarcus Aldridge,PF,638,1318,636,1304,2,14,Center,29,Jump Shot,11.197268588770864
2013-14,200746,LaMarcus Aldridge,PF,652,1423,649,1408,3,15,Center,11,Jump Shot,11.978215038650738
2014-15,200746,LaMarcus Aldridge,PF,659,1415,622,1310,37,105,Center,25,Jump Shot,12.349823321554771
2015-16,200746,LaMarcus Aldridge,PF,536,1045,536,1029,0,16,Center,6,Jump Shot,9.984688995215311
2016-17,200746,LaMarcus Aldridge,PF,500,1049,477,993,23,56,Center,9,Jump Shot,11.323164918970448
2017-18,200746,LaMarcus Aldridge,C,687,1347,660,1255,27,92,Center,25,Jump Shot,9.825538233110617
2018-19,200746,LaMarcus Aldridge,C,684,1319,674,1277,10,42,Center,12,Jump Shot,9.176648976497347
2019-20,200746,LaMarcus Aldridge,C,391,793,330,636,61,157,Center,12,Jump Shot,13.172761664564943
2020-21,200746,LaMarcus Aldridge,C,140,296,109,216,31,80,Center,3,Jump Shot,15.037162162162161
2021-22,200746,LaMarcus Aldridge,C,252,458,238,412,14,46,Center,8,Jump Shot,11.864628820960698
2020-21,1630163,LaMelo Ball,PG,293,672,201,411,92,261,Center,10,Jump Shot,13.241071428571429
2021-22,1630163,LaMelo Ball,PG,538,1254,318,689,220,565,Center,19,Jump Shot,15.41866028708134
2022-23,1630163,LaMelo Ball,PG,296,721,152,338,144,383,Center,18,Jump Shot,17.24271844660194
2003-04,1885,Lamar Odom,PF,485,1127,424,922,61,205,Center,22,Jump Shot,8.770186335403727
2004-05,1885,Lamar Odom,PF,366,774,330,657,36,117,Center,6,Jump Shot,8.077519379844961
2005-06,1885,Lamar Odom,PF,445,925,365,710,80,215,Center,26,Jump Shot,9.53945945945946
2006-07,1885,Lamar Odom,PF,319,681,265,499,54,182,Center,13,Jump Shot,10.92511013215859
2007-08,1885,Lamar Odom,PF,417,795,386,682,31,113,Center,19,Jump Shot,7.930817610062893
2008-09,1885,Lamar Odom,PF,346,703,313,600,33,103,Center,7,Jump Shot,7.533428165007113
2009-10,1885,Lamar Odom,PF,342,739,284,557,58,182,Center,14,Jump Shot,10.239512855209743
2010-11,1885,Lamar Odom,PF,473,893,405,715,68,178,Center,21,Jump Shot,10.106382978723405
2011-12,1885,Lamar Odom,SF,123,349,95,238,28,111,Center,0,Jump Shot,13.002865329512893
2012-13,1885,Lamar Odom,PF,146,366,128,276,18,90,Center,4,Jump Shot,11.068306010928962
2015-16,203934,Lamar Patterson,SG,28,80,16,31,12,49,Center,0,Jump Shot,17.275
2016-17,203934,Lamar Patterson,SG,3,15,2,9,1,6,Center,1,Jump Shot,12.466666666666667
2020-21,1630205,Lamar Stevens,PF,62,136,58,111,4,25,Center,6,Jump Shot,9.941176470588236
2021-22,1630205,Lamar Stevens,PF,156,319,138,254,18,65,Center,12,Jump Shot,9.460815047021944
2022-23,1630205,Lamar Stevens,PF,129,288,99,193,30,95,Center,5,Jump Shot,11.229166666666666
2003-04,441,Lamond Murray,SF,76,215,55,155,21,60,Center,2,Jump Shot,15.595348837209302
2004-05,441,Lamond Murray,SF,132,310,86,205,46,105,Center,8,Jump Shot,15.2
2005-06,441,Lamond Murray,SF,72,181,45,103,27,78,Center,6,Jump Shot,16.585635359116022
2007-08,200984,Lance Allred,C,1,4,1,4,0,0,Right Side Center,1,Jump Shot,17.5
2010-11,202362,Lance Stephenson,SG,13,39,13,34,0,5,Center,3,Jump Shot,12.282051282051283
2011-12,202362,Lance Stephenson,SG,47,125,43,95,4,30,Center,4,Jump Shot,12.408
2012-13,202362,Lance Stephenson,SG,275,598,213,410,62,188,Center,9,Jump Shot,12.434782608695652
2013-14,202362,Lance Stephenson,SG,427,870,341,626,86,244,Center,11,Jump Shot,11.670114942528736
2014-15,202362,Lance Stephenson,SG,207,550,189,445,18,105,Center,6,Jump Shot,12.5
2015-16,202362,Lance Stephenson,SF,228,474,198,396,30,78,Center,11,Jump Shot,10.132911392405063
2016-17,202362,Lance Stephenson,SG,54,120,48,100,6,20,Center,4,Jump Shot,12.691666666666666
2017-18,202362,Lance Stephenson,SG,303,709,236,477,67,232,Center,9,Jump Shot,14.654442877291961
2018-19,202362,Lance Stephenson,SG,184,432,111,235,73,197,Center,2,Jump Shot,16.083333333333332
2021-22,202362,Lance Stephenson,PG-SG,147,323,120,233,27,90,Center,4,Pullup Jump shot,13.758513931888546
2011-12,202498,Lance Thomas,PF,57,126,57,125,0,1,Center,1,Layup Shot,4.777777777777778
2012-13,202498,Lance Thomas,SF,53,106,53,106,0,0,Center,5,Jump Shot,6.386792452830188
2013-14,202498,Lance Thomas,SF,2,9,2,9,0,0,Center,0,Jump Shot,5.555555555555555
2014-15,202498,Lance Thomas,PF-SF,182,442,175,420,7,22,Center,10,Jump Shot,11.072398190045249
2015-16,202498,Lance Thomas,PF,169,381,125,273,44,108,Center,5,Jump Shot,13.335958005249344
2016-17,202498,Lance Thomas,PF,97,244,59,159,38,85,Center,4,Jump Shot,14.573770491803279
2017-18,202498,Lance Thomas,PF,102,267,52,143,50,124,Center,2,Jump Shot,15.295880149812733
2018-19,202498,Lance Thomas,PF,78,197,56,118,22,79,Center,3,Jump Shot,14.614213197969542
2019-20,202498,Lance Thomas,PF,8,23,4,10,4,13,Right Side,0,Jump Shot,18.130434782608695
2010-11,202361,Landry Fields,SG,299,602,213,383,86,219,Center,10,Jump Shot,12.290697674418604
2011-12,202361,Landry Fields,SG,236,513,205,392,31,121,Center,10,Jump Shot,9.465886939571151
2012-13,202361,Landry Fields,SF,102,223,100,209,2,14,Center,3,Jump Shot,6.538116591928251
2013-14,202361,Landry Fields,SF,27,67,27,62,0,5,Center,1,Jump Shot,6.029850746268656
2014-15,202361,Landry Fields,SF,20,41,19,39,1,2,Center,2,Jump Shot,5.024390243902439
2018-19,1629013,Landry Shamet,SG,240,557,73,161,167,396,Center,9,Jump Shot,20.057450628366247
2019-20,1629013,Landry Shamet,SG,158,391,47,95,111,296,Center,8,Jump Shot,20.186700767263428
2020-21,1629013,Landry Shamet,SG,186,456,57,123,129,333,Center,7,Jump Shot,19.92543859649123
2021-22,1629013,Landry Shamet,SG,191,485,68,151,123,334,Center,6,Jump Shot,19.54639175257732
2022-23,1629013,Landry Shamet,SG,113,300,38,101,75,199,Center,11,Jump Shot,19.066666666666666
2014-15,204038,Langston Galloway,PG,204,511,142,335,62,176,Center,11,Jump Shot,15.714285714285714
2015-16,204038,Langston Galloway,PG,231,588,154,364,77,224,Center,18,Jump Shot,15.401360544217686
2016-17,204038,Langston Galloway,PG,206,544,87,237,119,307,Center,12,Jump Shot,19.847426470588236
2017-18,204038,Langston Galloway,SG,126,340,51,122,75,218,Center,4,Jump Shot,20.69705882352941
2018-19,204038,Langston Galloway,SG,228,587,93,207,135,380,Center,3,Jump Shot,19.030664395229984
2019-20,204038,Langston Galloway,SG,236,542,104,211,132,331,Center,8,Jump Shot,18.081180811808117
2020-21,204038,Langston Galloway,SG,66,147,30,62,36,85,Center,2,Jump Shot,18.829931972789115
2021-22,204038,Langston Galloway,SG,6,26,4,10,2,16,Center,0,Jump Shot,18.884615384615383
2004-05,1919,Laron Profit,SF,56,128,48,100,8,28,Center,8,Jump Shot,11.9453125
2005-06,1919,Laron Profit,SG,40,84,37,66,3,18,Center,2,Jump Shot,11.94047619047619
2014-15,203580,Larry Drew II,PG,20,58,16,32,4,26,Center,1,Jump Shot,19.620689655172413
2017-18,203580,Larry Drew II,PG,7,24,4,15,3,9,Center,1,Jump Shot,16.083333333333332
2003-04,1716,Larry Hughes,SG,401,1009,322,777,79,232,Center,15,Jump Shot,13.410307234886027
2004-05,1716,Larry Hughes,SG,467,1086,408,877,59,209,Center,22,Jump Shot,12.61878453038674
2005-06,1716,Larry Hughes,SG,192,469,164,393,28,76,Center,6,Jump Shot,11.840085287846481
2006-07,1716,Larry Hughes,SG,381,953,307,731,74,222,Center,14,Jump Shot,13.905561385099686
2007-08,1716,Larry Hughes,PG-SG,305,801,238,607,67,194,Center,6,Jump Shot,14.926342072409488
2008-09,1716,Larry Hughes,SF-SG,224,557,149,364,75,193,Center,10,Jump Shot,16.420107719928186
2009-10,1716,Larry Hughes,SG,137,386,94,247,43,139,Center,6,Jump Shot,15.712435233160623
2011-12,1716,Larry Hughes,PG,5,22,4,15,1,7,Center,0,Jump Shot,17.272727272727273
2015-16,1626204,Larry Nance Jr.,PF,158,300,157,290,1,10,Center,0,Jump Shot,8.1
2016-17,1626204,Larry Nance Jr.,PF,190,360,180,325,10,35,Center,5,Jump Shot,8.844444444444445
2017-18,1626204,Larry Nance Jr.,C,240,413,238,401,2,12,Center,7,Jump Shot,6.13317191283293
2018-19,1626204,Larry Nance Jr.,C,249,479,216,381,33,98,Center,8,Jump Shot,8.993736951983298
2019-20,1626204,Larry Nance Jr.,PF,229,431,173,272,56,159,Center,7,Jump Shot,12.02784222737819
2020-21,1626204,Larry Nance Jr.,PF,128,272,87,158,41,114,Center,5,Jump Shot,13.018382352941176
2021-22,1626204,Larry Nance Jr.,C-PF,129,247,106,177,23,70,Center,2,Jump Shot,9.481781376518219
2022-23,1626204,Larry Nance Jr.,PF,186,305,172,263,14,42,Center,17,Jump Shot,6.422950819672131
2010-11,202082,Larry Owens,SF,15,32,9,19,6,13,Center,0,Jump Shot,15.3125
2011-12,202082,Larry Owens,SF,4,11,2,6,2,5,Center,0,Jump Shot,17.727272727272727
2010-11,202336,Larry Sanders,C,116,268,116,268,0,0,Center,7,Jump Shot,9.111940298507463
2011-12,202336,Larry Sanders,PF,84,184,84,182,0,2,Center,6,Layup Shot,5.211956521739131
2012-13,202336,Larry Sanders,C,306,605,306,603,0,2,Center,15,Jump Shot,4.509090909090909
2013-14,202336,Larry Sanders,C,76,162,76,161,0,1,Center,4,Layup Shot,3.3950617283950617
2014-15,202336,Larry Sanders,C,86,172,86,172,0,0,Center,1,Layup Shot,2.453488372093023
2016-17,202336,Larry Sanders,C,1,4,1,4,0,0,Center,0,Tip Layup Shot,2.25
2003-04,84,Latrell Sprewell,SF,518,1266,419,967,99,299,Center,18,Jump Shot,14.4739336492891
2004-05,84,Latrell Sprewell,SF,398,961,329,750,69,211,Center,15,Jump Shot,14.460978147762747
2017-18,1628374,Lauri Markkanen,PF,374,862,229,461,145,401,Center,18,Jump Shot,15.142691415313225
2018-19,1628374,Lauri Markkanen,PF,342,795,222,463,120,332,Center,13,Jump Shot,14.491823899371068
2019-20,1628374,Lauri Markkanen,PF,251,591,142,274,109,317,Center,8,Jump Shot,15.033840947546532
2020-21,1628374,Lauri Markkanen,PF,250,521,131,225,119,296,Center,4,Jump Shot,15.750479846449137
2021-22,1628374,Lauri Markkanen,SF,313,703,177,323,136,380,Center,9,Jump Shot,16.05547652916074
2022-23,1628374,Lauri Markkanen,SF,571,1144,371,634,200,510,Center,22,Jump Shot,14.109265734265735
2011-12,202730,Lavoy Allen,PF,79,167,79,167,0,0,Center,5,Jump Shot,10.263473053892216
2012-13,202730,Lavoy Allen,C,206,454,206,453,0,1,Center,4,Jump Shot,9.623348017621145
2013-14,202730,Lavoy Allen,PF,134,300,132,287,2,13,Center,1,Jump Shot,9.243333333333334
2014-15,202730,Lavoy Allen,C,141,299,141,299,0,0,Center,6,Jump Shot,9.819397993311037
2015-16,202730,Lavoy Allen,PF,191,370,191,370,0,0,Center,5,Jump Shot,7.583783783783784
2016-17,202730,Lavoy Allen,PF,77,168,77,167,0,1,Center,1,Jump Shot,8.398809523809524
2004-05,1444,Lawrence Funderburke,PF,3,6,3,6,0,0,Center,0,Jump Shot,7.5
2005-06,101160,Lawrence Roberts,C,20,44,20,42,0,2,Center,6,Jump Shot,8.0
2006-07,101160,Lawrence Roberts,PF,94,208,94,206,0,2,Center,3,Layup Shot,2.8846153846153846
2010-11,202351,Lazar Hayward,SF,55,154,38,94,17,60,Center,8,Jump Shot,14.435064935064934
2011-12,202351,Lazar Hayward,SF,13,38,9,24,4,14,Center,4,Jump Shot,15.631578947368421
2012-13,202351,Lazar Hayward,SF,2,10,2,6,0,4,Center,1,Jump Shot,14.2
2003-04,2544,LeBron James,SG,622,1492,559,1275,63,217,Center,33,Jump Shot,10.736595174262735
2004-05,2544,LeBron James,SF,795,1684,687,1376,108,308,Center,32,Jump Shot,11.688242280285035
2005-06,2544,LeBron James,SF,875,1823,748,1444,127,379,Center,43,Jump Shot,11.973669775095996
2006-07,2544,LeBron James,SF,772,1621,673,1311,99,310,Center,35,Jump Shot,11.749537322640345
2007-08,2544,LeBron James,SF,794,1642,681,1283,113,359,Center,53,Jump Shot,11.773447015834348
2008-09,2544,LeBron James,SF,789,1613,657,1229,132,384,Center,23,Jump Shot,12.95660260384377
2009-10,2544,LeBron James,SF,768,1528,639,1141,129,387,Center,49,Jump Shot,13.019633507853403
2010-11,2544,LeBron James,SF,758,1485,666,1206,92,279,Center,34,Jump Shot,12.252525252525253
2011-12,2544,LeBron James,SF,621,1169,567,1020,54,149,Center,24,Jump Shot,11.049615055603079
2012-13,2544,LeBron James,PF,765,1354,662,1100,103,254,Center,33,Jump Shot,10.751107828655835
2013-14,2544,LeBron James,PF,767,1353,651,1047,116,306,Center,23,Jump Shot,10.88470066518847
2014-15,2544,LeBron James,SF,624,1279,504,940,120,339,Center,19,Jump Shot,12.136825645035184
2015-16,2544,LeBron James,SF,737,1415,650,1134,87,281,Center,35,Jump Shot,9.620494699646644
2016-17,2544,LeBron James,SF,736,1343,612,1002,124,341,Center,22,Jump Shot,10.548026805658973
2017-18,2544,LeBron James,PF,857,1580,708,1174,149,406,Center,44,Jump Shot,10.950632911392406
2018-19,2544,LeBron James,SF,558,1095,447,768,111,327,Center,27,Jump Shot,11.837442922374429
2019-20,2544,LeBron James,PG,643,1303,495,878,148,425,Center,19,Jump Shot,12.383729854182656
2020-21,2544,LeBron James,PG,422,823,318,538,104,285,Center,18,Jump Shot,13.383961117861482
2021-22,2544,LeBron James,PF,640,1221,479,773,161,448,Center,23,Jump Shot,13.28009828009828
2022-23,2544,LeBron James,PF,609,1219,488,842,121,377,Center,20,Jump Shot,12.313371616078753
2003-04,2571,Leandro Barbosa,PG,210,470,127,260,83,210,Center,9,Jump Shot,13.13191489361702
2004-05,2571,Leandro Barbosa,PG,168,354,117,215,51,139,Center,5,Jump Shot,13.200564971751412
2005-06,2571,Leandro Barbosa,SG,273,567,186,371,87,196,Center,13,Jump Shot,11.763668430335096
2006-07,2571,Leandro Barbosa,SG,529,1111,339,673,190,438,Center,21,Jump Shot,14.054905490549055
2007-08,2571,Leandro Barbosa,SG,472,1021,308,599,164,422,Center,16,Jump Shot,14.142997061704211
2008-09,2571,Leandro Barbosa,SG,365,758,276,519,89,239,Center,15,Jump Shot,12.633245382585752
2009-10,2571,Leandro Barbosa,PG,155,365,111,229,44,136,Center,8,Jump Shot,13.687671232876712
2010-11,2571,Leandro Barbosa,SG,294,653,222,440,72,213,Center,22,Jump Shot,12.499234303215927
2011-12,2571,Leandro Barbosa,SG,271,637,206,467,65,170,Center,7,Jump Shot,13.098901098901099
2012-13,2571,Leandro Barbosa,PG,83,193,65,146,18,47,Center,7,Jump Shot,10.264248704663212
2013-14,2571,Leandro Barbosa,PG,56,131,49,106,7,25,Center,1,Jump Shot,9.404580152671755
2014-15,2571,Leandro Barbosa,SG,183,386,140,274,43,112,Center,13,Jump Shot,11.735751295336788
2015-16,2571,Leandro Barbosa,SG,171,370,132,260,39,110,Center,5,Jump Shot,11.781081081081082
2016-17,2571,Leandro Barbosa,SG,172,392,137,294,35,98,Center,4,Jump Shot,12.573979591836734
2021-22,1630195,Leandro Bolmaro,SF,17,54,12,36,5,18,Center,4,Jump Shot,13.277777777777779
2022-23,1630195,Leandro Bolmaro,SG,3,20,3,16,0,4,Center,1,Jump Shot,10.45
2003-04,1924,Lee Nailon,PF-SF,147,327,147,324,0,3,Center,9,Jump Shot,8.914373088685016
2004-05,1924,Lee Nailon,SF,415,869,415,867,0,2,Center,13,Jump Shot,9.982738780207134
2005-06,1924,Lee Nailon,PF,40,80,40,80,0,0,Center,0,Jump Shot,8.95
2006-07,200796,Leon Powe,C,79,177,79,175,0,2,Center,14,Layup Shot,4.468926553672317
2007-08,200796,Leon Powe,C,154,269,154,268,0,1,Center,15,Layup Shot,2.962825278810409
2008-09,200796,Leon Powe,PF,177,338,177,338,0,0,Center,3,Layup Shot,2.1863905325443787
2009-10,200796,Leon Powe,SF,21,49,21,49,0,0,Center,2,Layup Shot,2.836734693877551
2010-11,200796,Leon Powe,C-PF,59,119,59,117,0,2,Center,7,Jump Shot,5.7899159663865545
2003-04,1910,Leon Smith,C,1,2,1,2,0,0,Center,1,Tip Shot,4.5
2009-10,201991,Lester Hudson,PG,21,53,16,37,5,16,Center,3,Jump Shot,15.773584905660377
2010-11,201991,Lester Hudson,PG,6,24,2,9,4,15,Right Side Center,1,Jump Shot,19.458333333333332
2011-12,201991,Lester Hudson,PG,62,162,46,98,16,64,Center,5,Jump Shot,14.580246913580247
2014-15,201991,Lester Hudson,SG,6,14,3,8,3,6,Center,0,Jump Shot,15.142857142857142
2022-23,1631311,Lester Quinones,SG,2,5,0,1,2,4,Center,0,Pullup Jump shot,21.6
2005-06,101132,Linas Kleiza,PF,77,173,75,160,2,13,Center,9,Jump Shot,9.22543352601156
2006-07,101132,Linas Kleiza,PF,200,474,117,253,83,221,Center,14,Jump Shot,14.852320675105485
2007-08,101132,Linas Kleiza,SF,311,659,217,382,94,277,Center,17,Jump Shot,13.250379362670714
2008-09,101132,Linas Kleiza,SF,289,646,202,379,87,267,Center,15,Jump Shot,12.622291021671826
2010-11,101132,Linas Kleiza,SF,178,406,139,275,39,131,Center,3,Jump Shot,13.307881773399014
2011-12,101132,Linas Kleiza,SF,165,410,103,231,62,179,Center,11,Jump Shot,16.036585365853657
2012-13,101132,Linas Kleiza,SF,48,144,28,78,20,66,Center,1,Jump Shot,15.909722222222221
2021-22,1629623,Lindell Wigginton,PG,26,61,17,35,9,26,Center,4,Jump Shot,12.229508196721312
2022-23,1629623,Lindell Wigginton,PG,18,37,12,19,6,18,Center,2,Jump Shot,15.567567567567568
2003-04,283,Lindsey Hunter,SG,49,143,35,93,14,50,Left Side,1,Jump Shot,15.363636363636363
2004-05,283,Lindsey Hunter,SG,108,302,85,218,23,84,Center,5,Jump Shot,13.403973509933774
2005-06,283,Lindsey Hunter,PG,37,100,26,57,11,43,Center,3,Jump Shot,17.11
2006-07,283,Lindsey Hunter,PG,94,244,56,125,38,119,Center,5,Jump Shot,17.0
2007-08,283,Lindsey Hunter,PG,22,64,15,38,7,26,Center,0,Jump Shot,17.4375
2008-09,283,Lindsey Hunter,PG,27,81,11,34,16,47,Center,3,Jump Shot,18.580246913580247
2009-10,283,Lindsey Hunter,PG,5,30,4,17,1,13,Right Side Center,0,Jump Shot,18.3
2021-22,1630322,Lindy Waters III,SG,71,175,18,29,53,146,Center,3,Jump Shot,21.94857142857143
2022-23,1630322,Lindy Waters III,SG,70,178,12,16,58,162,Left Side Center,5,Jump Shot,23.331460674157302
2003-04,2669,Linton Johnson,SF,72,203,65,170,7,33,Center,5,Jump Shot,12.19704433497537
2004-05,2669,Linton Johnson,SF,0,2,0,1,0,1,Right Side,0,Jump Shot,13.5
2005-06,2669,Linton Johnson,SF,61,149,48,113,13,36,Center,3,Jump Shot,12.06711409395973
2006-07,2669,Linton Johnson,PF,93,190,83,160,10,30,Center,3,Jump Shot,13.436842105263159
2007-08,2669,Linton Johnson,PF,9,19,8,16,1,3,Center,1,Jump Shot,12.736842105263158
2008-09,2669,Linton Johnson,PF,4,11,3,9,1,2,Center,1,Jump Shot,14.363636363636363
2004-05,2763,Lionel Chalmers,PG,42,125,30,76,12,49,Center,1,Jump Shot,15.656
2017-18,1628506,London Perrantes,PG,2,13,2,10,0,3,Center,0,Jump Shot,13.692307692307692
2018-19,1629022,Lonnie Walker IV,SG,16,46,11,33,5,13,Center,2,Jump Shot,13.934782608695652
2019-20,1629022,Lonnie Walker IV,SG,152,357,111,256,41,101,Center,5,Jump Shot,11.88515406162465
2020-21,1629022,Lonnie Walker IV,SG,256,609,156,327,100,282,Center,5,Jump Shot,15.722495894909688
2021-22,1629022,Lonnie Walker IV,SG,311,764,200,411,111,353,Center,7,Jump Shot,16.531413612565444
2022-23,1629022,Lonnie Walker IV,SG,236,527,145,278,91,249,Center,7,Jump Shot,15.161290322580646
2003-04,2437,Lonny Baxter,C-PF,103,209,102,206,1,3,Center,8,Layup Shot,4.751196172248804
2004-05,2437,Lonny Baxter,PF,3,11,3,11,0,0,Center,1,Layup Shot,4.818181818181818
2005-06,2437,Lonny Baxter,C-PF,45,104,45,104,0,0,Center,5,Layup Shot,4.365384615384615
2017-18,1628366,Lonzo Ball,PG,203,564,113,269,90,295,Center,9,Jump Shot,16.05851063829787
2018-19,1628366,Lonzo Ball,PG,185,456,110,228,75,228,Center,4,Jump Shot,14.903508771929825
2019-20,1628366,Lonzo Ball,PG,277,687,129,292,148,395,Center,10,Jump Shot,17.21834061135371
2020-21,1628366,Lonzo Ball,PG,290,700,118,245,172,455,Center,9,Jump Shot,18.93857142857143
2021-22,1628366,Lonzo Ball,PG,162,383,52,123,110,260,Center,4,Jump Shot,19.362924281984334
2003-04,2254,Loren Woods,C,44,96,44,96,0,0,Center,0,Jump Shot,4.03125
2004-05,2254,Loren Woods,C,71,164,71,163,0,1,Center,1,Layup Shot,4.7560975609756095
2005-06,2254,Loren Woods,C,28,59,28,58,0,1,Center,1,Layup Shot,4.101694915254237
2007-08,2254,Loren Woods,C,3,5,3,5,0,0,Center,2,Jump Shot,5.2
2003-04,953,Lorenzen Wright,C,257,586,257,581,0,5,Center,4,Jump Shot,8.042662116040956
2004-05,953,Lorenzen Wright,C,320,683,320,680,0,3,Center,8,Jump Shot,6.7745241581259155
2005-06,953,Lorenzen Wright,C,194,406,194,404,0,2,Center,2,Jump Shot,5.921182266009852
2006-07,953,Lorenzen Wright,C,82,183,82,183,0,0,Center,0,Jump Shot,7.726775956284153
2007-08,953,Lorenzen Wright,C,6,21,6,21,0,0,Center,1,Jump Shot,6.904761904761905
2008-09,953,Lorenzen Wright,C,10,27,10,27,0,0,Center,3,Jump Shot,8.814814814814815
2013-14,203485,Lorenzo Brown,PG,26,86,23,56,3,30,Center,5,Jump Shot,12.80232558139535
2014-15,203485,Lorenzo Brown,PG,52,122,46,94,6,28,Center,4,Jump Shot,11.467213114754099
2015-16,203485,Lorenzo Brown,PG,8,25,7,17,1,8,Center,1,Jump Shot,15.8
2017-18,203485,Lorenzo Brown,PG,14,34,12,22,2,12,Center,2,Pullup Jump shot,14.823529411764707
2018-19,203485,Lorenzo Brown,PG,23,71,17,43,6,28,Center,6,Jump Shot,13.732394366197184
2006-07,200811,Lou Amundson,PF,6,15,6,15,0,0,Center,0,Layup Shot,1.8666666666666667
2007-08,200811,Lou Amundson,PF,8,16,8,16,0,0,Center,3,Layup Shot,2.1875
2008-09,200811,Lou Amundson,PF,134,250,134,249,0,1,Center,8,Layup Shot,2.916
2009-10,200811,Lou Amundson,PF,152,276,152,275,0,1,Center,6,Layup Shot,2.9746376811594204
2010-11,200811,Lou Amundson,PF,83,183,83,183,0,0,Center,2,Layup Shot,3.879781420765027
2011-12,200811,Lou Amundson,PF,89,207,89,207,0,0,Center,4,Jump Shot,4.231884057971015
2012-13,200811,Lou Amundson,PF,32,81,32,81,0,0,Center,1,Jump Shot,3.2098765432098766
2013-14,200811,Lou Amundson,PF,16,32,16,32,0,0,Center,0,Layup Shot,2.5625
2014-15,200811,Lou Amundson,PF,109,255,109,254,0,1,Center,4,Jump Shot,4.874509803921568
2015-16,200811,Lou Amundson,PF,19,53,19,53,0,0,Center,1,Jump Shot,4.754716981132075
2005-06,101150,Lou Williams,PG,23,52,21,43,2,9,Center,9,Jump Shot,9.865384615384615
2006-07,101150,Lou Williams,PG,93,211,81,174,12,37,Center,11,Jump Shot,10.317535545023697
2007-08,101150,Lou Williams,PG,319,752,264,599,55,153,Center,34,Jump Shot,11.835106382978724
2008-09,101150,Lou Williams,SG,336,844,273,624,63,220,Center,20,Jump Shot,12.456161137440759
2009-10,101150,Lou Williams,PG,318,677,248,471,70,206,Center,15,Jump Shot,12.197932053175775
2010-11,101150,Lou Williams,SG,323,794,235,542,88,252,Center,23,Jump Shot,14.916876574307304
2011-12,101150,Lou Williams,PG,318,782,235,553,83,229,Center,21,Jump Shot,14.588235294117647
2012-13,101150,Lou Williams,SG,187,443,115,247,72,196,Center,14,Jump Shot,16.451467268623023
2013-14,101150,Lou Williams,PG,197,493,118,262,79,231,Center,11,Jump Shot,16.851926977687626
2014-15,101150,Lou Williams,SG,375,928,223,481,152,447,Center,19,Jump Shot,17.379310344827587
2015-16,101150,Lou Williams,SG,281,691,173,373,108,318,Center,9,Jump Shot,16.263386396526773
2016-17,101150,Lou Williams,SG,428,997,265,552,163,445,Center,13,Jump Shot,14.984954864593782
2017-18,101150,Lou Williams,SG,582,1337,396,819,186,518,Center,31,Jump Shot,14.724756918474196
2018-19,101150,Lou Williams,SG,484,1138,379,847,105,291,Center,29,Jump Shot,13.21353251318102
2019-20,101150,Lou Williams,PG,391,936,280,621,111,315,Center,13,Jump Shot,14.270299145299145
2020-21,101150,Lou Williams,PG,265,646,196,473,69,173,Center,8,Pullup Jump shot,13.88390092879257
2021-22,101150,Lou Williams,PG,125,320,88,218,37,102,Center,0,Pullup Jump shot,14.903125
2019-20,1629663,Louis King,SF,8,21,4,10,4,11,Center,1,Jump Shot,16.0
2020-21,1629663,Louis King,SF,17,34,13,23,4,11,Center,1,Jump Shot,12.352941176470589
2021-22,1629663,Louis King,SF,15,47,7,20,8,27,Center,6,Jump Shot,19.70212765957447
2022-23,1629663,Louis King,SF,8,13,4,5,4,8,Center,1,Jump Shot,17.615384615384617
2008-09,201601,Luc Mbah a Moute,PF,227,491,227,487,0,4,Center,12,Jump Shot,7.873727087576375
2009-10,201601,Luc Mbah a Moute,PF,177,369,171,352,6,17,Center,6,Jump Shot,7.084010840108401
2010-11,201601,Luc Mbah a Moute,PF,198,428,198,421,0,7,Center,7,Jump Shot,7.714953271028038
2011-12,201601,Luc Mbah a Moute,PF,133,261,132,257,1,4,Center,8,Layup Shot,5.498084291187739
2012-13,201601,Luc Mbah a Moute,SF,151,377,138,340,13,37,Center,4,Jump Shot,8.435013262599469
2013-14,201601,Luc Mbah a Moute,PF-SF,87,193,83,176,4,17,Center,3,Jump Shot,7.647668393782383
2014-15,201601,Luc Mbah a Moute,PF,251,636,189,434,62,202,Center,2,Jump Shot,13.803459119496855
2015-16,201601,Luc Mbah a Moute,PF,93,204,81,167,12,37,Center,3,Jump Shot,7.965686274509804
2016-17,201601,Luc Mbah a Moute,SF,190,368,148,268,42,100,Center,0,Jump Shot,11.065217391304348
2017-18,201601,Luc Mbah a Moute,PF,166,345,103,172,63,173,Center,5,Jump Shot,13.15072463768116
2018-19,201601,Luc Mbah a Moute,PF,8,18,6,12,2,6,Center,0,Jump Shot,10.222222222222221
2019-20,201601,Luc Mbah a Moute,PF,2,5,2,3,0,2,Center,1,Jump Shot,11.6
2014-15,203512,Lucas Nogueira,C,2,8,2,8,0,0,Center,1,Alley Oop Dunk Shot,4.75
2015-16,203512,Lucas Nogueira,C,28,44,27,41,1,3,Center,3,Alley Oop Dunk Shot,3.090909090909091
2016-17,203512,Lucas Nogueira,C,103,156,100,144,3,12,Center,1,Alley Oop Dunk Shot,3.83974358974359
2017-18,203512,Lucas Nogueira,C,49,80,44,61,5,19,Center,6,Jump Shot,6.575
2003-04,446,Lucious Harris,PG,187,463,149,362,38,101,Center,4,Jump Shot,16.406047516198704
2004-05,446,Lucious Harris,SG,118,299,97,234,21,65,Right Side,4,Jump Shot,16.31438127090301
2019-20,1629652,Luguentz Dort,SF,86,218,56,117,30,101,Center,0,Jump Shot,12.706422018348624
2020-21,1629652,Luguentz Dort,SG,247,639,134,310,113,329,Center,11,Jump Shot,14.945226917057903
2021-22,1629652,Luguentz Dort,SG,293,726,163,335,130,391,Center,13,Jump Shot,15.8732782369146
2022-23,1629652,Luguentz Dort,SG,339,873,204,464,135,409,Center,14,Jump Shot,13.67926689576174
2004-05,2784,Luis Flores,PG,14,29,9,19,5,10,Center,4,Jump Shot,14.586206896551724
2015-16,1626242,Luis Montero,SG,5,19,4,10,1,9,Left Side Center,4,Jump Shot,18.263157894736842
2017-18,1626242,Luis Montero,SG,0,1,0,1,0,0,Center,0,Running Layup Shot,2.0
2007-08,2449,Luis Scola,PF,345,670,345,667,0,3,Center,10,Layup Shot,6.594029850746269
2008-09,2449,Luis Scola,PF,424,799,424,796,0,3,Center,11,Jump Shot,7.274092615769712
2009-10,2449,Luis Scola,PF,560,1090,559,1085,1,5,Center,11,Jump Shot,8.107339449541284
2010-11,2449,Luis Scola,PF,569,1129,569,1126,0,3,Center,24,Jump Shot,8.720106288751108
2011-12,2449,Luis Scola,PF,436,888,436,885,0,3,Center,12,Jump Shot,9.254504504504505
2012-13,2449,Luis Scola,PF,432,915,429,899,3,16,Center,10,Jump Shot,10.286338797814208
2013-14,2449,Luis Scola,PF,263,560,262,553,1,7,Center,1,Jump Shot,11.657142857142857
2014-15,2449,Luis Scola,PF,300,642,295,622,5,20,Center,2,Jump Shot,9.426791277258568
2015-16,2449,Luis Scola,PF,269,597,204,437,65,160,Center,4,Jump Shot,11.515912897822446
2016-17,2449,Luis Scola,PF,71,151,54,101,17,50,Center,6,Jump Shot,11.132450331125828
2018-19,1629029,Luka Doncic,SG,506,1186,338,672,168,514,Center,33,Jump Shot,14.962057335581788
2019-20,1629029,Luka Doncic,PG,581,1255,410,714,171,541,Center,31,Step Back Jump shot,14.03027888446215
2020-21,1629029,Luka Doncic,PG,647,1351,455,803,192,548,Center,32,Step Back Jump shot,15.068837897853442
2021-22,1629029,Luka Doncic,PG,641,1403,440,834,201,569,Center,22,Step Back Jump shot,15.364932287954383
2022-23,1629029,Luka Doncic,PG,719,1449,534,908,185,541,Center,24,Step Back Jump shot,14.24016563146998
2021-22,1630568,Luka Garza,C,66,147,50,98,16,49,Center,9,Jump Shot,12.244897959183673
2022-23,1630568,Luka Garza,C,63,116,49,77,14,39,Center,10,Jump Shot,11.086206896551724
2019-20,1629677,Luka Samanic,PF,5,16,2,8,3,8,Center,0,Jump Shot,16.0
2020-21,1629677,Luka Samanic,PF,47,105,35,62,12,43,Center,7,Jump Shot,12.447619047619048
2022-23,1629677,Luka Samanic,PF,26,57,18,26,8,31,Center,0,Jump Shot,14.824561403508772
2010-11,202337,Luke Babbitt,SF,15,55,12,39,3,16,Center,4,Jump Shot,12.290909090909091
2011-12,202337,Luke Babbitt,SF,71,173,28,73,43,100,Center,5,Jump Shot,17.947976878612717
2012-13,202337,Luke Babbitt,PF,86,234,24,56,62,178,Left Side Center,3,Jump Shot,21.747863247863247
2013-14,202337,Luke Babbitt,PF,60,154,24,59,36,95,Center,1,Jump Shot,18.87012987012987
2014-15,202337,Luke Babbitt,SF,92,191,33,77,59,114,Center,7,Jump Shot,17.79581151832461
2015-16,202337,Luke Babbitt,SF,122,289,78,180,44,109,Center,3,Jump Shot,12.941176470588236
2016-17,202337,Luke Babbitt,SF,113,281,26,71,87,210,Left Side Center,0,Jump Shot,21.181494661921707
2017-18,202337,Luke Babbitt,SF,91,215,31,59,60,156,Center,6,Jump Shot,20.93953488372093
2010-11,202376,Luke Harangody,PF,79,206,63,140,16,66,Center,6,Jump Shot,15.281553398058252
2011-12,202376,Luke Harangody,PF,23,65,18,44,5,21,Center,6,Jump Shot,14.661538461538461
2004-05,2739,Luke Jackson,SF,10,27,6,21,4,6,Center,6,Jump Shot,13.074074074074074
2005-06,2739,Luke Jackson,SF,29,85,17,49,12,36,Center,4,Jump Shot,14.8
2006-07,2739,Luke Jackson,SF,19,43,14,26,5,17,Center,4,Jump Shot,12.44186046511628
2007-08,2739,Luke Jackson,SF,26,80,15,50,11,30,Center,4,Jump Shot,14.3625
2017-18,1628379,Luke Kennard,SG,206,465,125,270,81,195,Center,10,Jump Shot,16.509677419354837
2018-19,1628379,Luke Kennard,SG,228,520,122,251,106,269,Center,3,Jump Shot,18.388461538461538
2019-20,1628379,Luke Kennard,SG,151,342,78,159,73,183,Center,8,Jump Shot,17.66374269005848
2020-21,1628379,Luke Kennard,SG,197,414,97,190,100,224,Center,14,Jump Shot,18.44927536231884
2021-22,1628379,Luke Kennard,SG,287,639,97,216,190,423,Center,13,Jump Shot,20.327073552425666
2022-23,1628379,Luke Kennard,SG,188,382,55,113,133,269,Center,2,Jump Shot,20.369109947643977
2017-18,1628436,Luke Kornet,PF,49,125,21,46,28,79,Center,2,Jump Shot,18.248
2018-19,1628436,Luke Kornet,PF,107,283,37,90,70,193,Center,7,Jump Shot,19.551236749116608
2019-20,1628436,Luke Kornet,C,82,187,51,79,31,108,Center,5,Jump Shot,15.641711229946525
2020-21,1628436,Luke Kornet,C-PF,44,101,29,42,15,59,Center,0,Jump Shot,15.990099009900991
2021-22,1628436,Luke Kornet,C,13,27,13,22,0,5,Center,3,Jump Shot,6.814814814814815
2022-23,1628436,Luke Kornet,C,113,170,110,157,3,13,Center,14,Tip Layup Shot,4.194117647058824
2003-04,2557,Luke Ridnour,PG,145,350,118,270,27,80,Center,10,Jump Shot,13.991428571428571
2004-05,2557,Luke Ridnour,PG,299,739,232,561,67,178,Center,7,Jump Shot,13.987821380243572
2005-06,2557,Luke Ridnour,PG,334,799,291,650,43,149,Center,16,Jump Shot,13.901126408010013
2006-07,2557,Luke Ridnour,PG,301,695,252,556,49,139,Center,12,Jump Shot,12.277697841726619
2007-08,2557,Luke Ridnour,PG,147,368,126,297,21,71,Center,11,Jump Shot,13.807065217391305
2008-09,2557,Luke Ridnour,PG,250,621,195,464,55,157,Center,9,Jump Shot,15.782608695652174
2009-10,2557,Luke Ridnour,PG,327,684,259,505,68,179,Center,12,Jump Shot,15.211988304093568
2010-11,2557,Luke Ridnour,PG,319,681,238,497,81,184,Center,11,Jump Shot,14.778267254038179
2011-12,2557,Luke Ridnour,SG,242,550,193,398,49,152,Center,13,Jump Shot,15.405454545454546
2012-13,2557,Luke Ridnour,SG,367,811,301,599,66,212,Center,8,Jump Shot,15.601726263871763
2013-14,2557,Luke Ridnour,PG,126,327,89,219,37,108,Center,2,Jump Shot,16.954128440366972
2014-15,2557,Luke Ridnour,PG,75,176,55,113,20,63,Center,1,Jump Shot,17.636363636363637
2005-06,101195,Luke Schenscher,C,16,26,16,26,0,0,Center,0,Layup Shot,4.769230769230769
2006-07,101195,Luke Schenscher,C,7,23,7,23,0,0,Center,0,Layup Shot,3.1739130434782608
2003-04,2575,Luke Walton,PF,65,153,52,114,13,39,Center,4,Jump Shot,12.169934640522875
2004-05,2575,Luke Walton,SF,74,180,58,119,16,61,Center,8,Jump Shot,11.122222222222222
2005-06,2575,Luke Walton,SF,135,328,117,273,18,55,Center,2,Jump Shot,12.25609756097561
2006-07,2575,Luke Walton,SF,264,557,216,433,48,124,Center,14,Jump Shot,9.863554757630162
2007-08,2575,Luke Walton,SF,215,478,187,394,28,84,Center,4,Jump Shot,10.633891213389122
2008-09,2575,Luke Walton,SF,134,307,117,250,17,57,Center,4,Jump Shot,11.342019543973942
2009-10,2575,Luke Walton,SF,30,84,23,67,7,17,Center,1,Jump Shot,12.25
2010-11,2575,Luke Walton,SF,38,116,30,82,8,34,Center,3,Jump Shot,16.25862068965517
2011-12,2575,Luke Walton,PF-SF,24,65,17,45,7,20,Right Side,1,Jump Shot,17.923076923076923
2012-13,2575,Luke Walton,PF,71,181,51,114,20,67,Center,1,Jump Shot,15.917127071823204
2012-13,202545,Luke Zeller,C,9,26,8,21,1,5,Center,5,Jump Shot,20.26923076923077
2004-05,2736,Luol Deng,SF,280,645,249,528,31,117,Center,11,Jump Shot,11.404651162790698
2005-06,2736,Luol Deng,SF,442,954,421,876,21,78,Center,15,Jump Shot,10.421383647798741
2006-07,2736,Luol Deng,SF,630,1218,629,1211,1,7,Center,11,Jump Shot,10.013136288998359
2007-08,2736,Luol Deng,SF,429,896,421,874,8,22,Center,10,Jump Shot,9.963169642857142
2008-09,2736,Luol Deng,SF,265,591,257,571,8,20,Center,7,Jump Shot,11.27580372250423
2009-10,2736,Luol Deng,SF,473,1014,441,931,32,83,Center,12,Jump Shot,11.814595660749507
2010-11,2736,Luol Deng,SF,531,1155,416,822,115,333,Center,21,Jump Shot,13.182683982683983
2011-12,2736,Luol Deng,SF,311,755,232,540,79,215,Center,15,Jump Shot,13.89933774834437
2012-13,2736,Luol Deng,SF,466,1093,391,860,75,233,Center,15,Jump Shot,12.236962488563586
2013-14,2736,Luol Deng,SF,371,860,314,671,57,189,Center,16,Jump Shot,12.303488372093023
2014-15,2736,Luol Deng,SF,369,787,291,567,78,220,Center,8,Jump Shot,12.489199491740788
2015-16,2736,Luol Deng,PF,338,744,251,489,87,255,Center,16,Jump Shot,12.974462365591398
2016-17,2736,Luol Deng,SF,164,423,113,259,51,164,Center,3,Jump Shot,14.477541371158392
2017-18,2736,Luol Deng,SF,1,2,1,2,0,0,Center,0,Running Layup Shot,2.5
2018-19,2736,Luol Deng,SF,59,118,45,74,14,44,Center,3,Jump Shot,12.432203389830509
2005-06,101129,Luther Head,SG,254,630,141,317,113,313,Center,23,Jump Shot,16.152380952380952
2006-07,101129,Luther Head,SG,306,700,129,299,177,401,Center,16,Jump Shot,17.67
2007-08,101129,Luther Head,SG,206,477,127,252,79,225,Center,10,Jump Shot,15.540880503144654
2008-09,101129,Luther Head,PG-SG,55,144,35,90,20,54,Center,1,Jump Shot,14.756944444444445
2009-10,101129,Luther Head,SG,136,311,99,206,37,105,Center,7,Jump Shot,14.990353697749196
2010-11,101129,Luther Head,PG,67,163,43,100,24,63,Center,2,Jump Shot,15.705521472392638
2006-07,2696,Lynn Greer,SG,61,141,43,89,18,52,Center,13,Jump Shot,15.113475177304965
2021-22,1630640,M.J. Walker,,0,4,0,2,0,2,Center,0,Jump Shot,15.0
2012-13,203146,Maalik Wayns,PG,26,88,19,57,7,31,Center,4,Jump Shot,14.045454545454545
2013-14,203146,Maalik Wayns,PG,1,2,1,2,0,0,Left Side,0,Jump Shot,18.5
2021-22,1630644,Mac McClung,SG-PG,3,6,2,3,1,3,Center,2,Jump Shot,16.0
2022-23,1630644,Mac McClung,SG,9,20,5,9,4,11,Center,0,Jump Shot,14.95
2006-07,1766,Maceo Baston,PF,49,76,46,69,3,7,Center,4,Layup Shot,4.75
2007-08,1766,Maceo Baston,PF,17,25,17,25,0,0,Center,5,Jump Shot,3.04
2008-09,1766,Maceo Baston,PF,25,46,25,45,0,1,Center,0,Layup Shot,4.695652173913044
2003-04,2573,Maciej Lampe,C,43,88,43,84,0,4,Center,5,Jump Shot,12.022727272727273
2004-05,2573,Maciej Lampe,C,49,132,47,128,2,4,Center,6,Jump Shot,11.340909090909092
2005-06,2573,Maciej Lampe,C,2,11,2,11,0,0,Center,1,Jump Shot,8.090909090909092
2020-21,1630201,Malachi Flynn,PG,127,340,73,172,54,168,Center,15,Jump Shot,17.05294117647059
2021-22,1630201,Malachi Flynn,PG,72,183,42,93,30,90,Center,2,Jump Shot,17.672131147540984
2022-23,1630201,Malachi Flynn,PG,87,242,40,109,47,133,Center,7,Jump Shot,17.818181818181817
2016-17,1627781,Malachi Richardson,SG,28,68,20,40,8,28,Right Side Center,1,Jump Shot,18.08823529411765
2017-18,1627781,Malachi Richardson,SG,30,90,18,50,12,40,Center,2,Jump Shot,15.822222222222223
2018-19,1627781,Malachi Richardson,SG,9,29,1,4,8,25,Left Side,1,Jump Shot,22.0
2022-23,1631103,Malaki Branham,SF,269,611,192,356,77,255,Center,15,Jump Shot,14.959083469721767
2016-17,1627763,Malcolm Brogdon,SG,288,632,212,442,76,190,Center,16,Jump Shot,11.110759493670885
2017-18,1627763,Malcolm Brogdon,PG,244,503,182,342,62,161,Center,7,Jump Shot,11.673956262425447
2018-19,1627763,Malcolm Brogdon,SG,378,748,274,504,104,244,Center,13,Jump Shot,10.359625668449198
2019-20,1627763,Malcolm Brogdon,PG,326,744,251,514,75,230,Center,17,Pullup Jump shot,13.365591397849462
2020-21,1627763,Malcolm Brogdon,PG,444,980,299,606,145,374,Center,22,Pullup Jump shot,13.825510204081633
2021-22,1627763,Malcolm Brogdon,PG,243,543,185,357,58,186,Center,10,Jump Shot,12.720073664825046
2022-23,1627763,Malcolm Brogdon,PG,354,732,222,435,132,297,Center,6,Jump Shot,14.154371584699453
2016-17,1627098,Malcolm Delaney,PG,145,388,119,278,26,110,Center,6,Pullup Jump shot,17.190721649484537
2017-18,1627098,Malcolm Delaney,PG,109,285,63,161,46,124,Center,5,Jump Shot,16.72280701754386
2021-22,1630792,Malcolm Hill,SF-SG,24,52,11,16,13,36,Center,4,Jump Shot,18.903846153846153
2022-23,1630792,Malcolm Hill,SF,2,4,1,1,1,3,Left Side,1,Jump Shot,18.25
2011-12,202723,Malcolm Lee,SG,23,59,21,49,2,10,Center,1,Jump Shot,8.40677966101695
2012-13,202723,Malcolm Lee,SG,29,76,21,52,8,24,Center,1,Jump Shot,12.105263157894736
2014-15,202723,Malcolm Lee,SG,0,1,0,1,0,0,Center,0,Driving Jump shot,5.0
2017-18,1626259,Malcolm Miller,SF,13,28,5,7,8,21,Center,1,Jump Shot,18.5
2018-19,1626259,Malcolm Miller,SF,11,26,1,5,10,21,Center,2,Jump Shot,20.923076923076923
2019-20,1626259,Malcolm Miller,SF,12,29,4,7,8,22,Center,4,Jump Shot,19.517241379310345
2011-12,202952,Malcolm Thomas,PF,0,3,0,3,0,0,Center,0,Jump Shot,3.6666666666666665
2012-13,202952,Malcolm Thomas,PF,5,10,5,10,0,0,Center,2,Layup Shot,2.5
2013-14,202952,Malcolm Thomas,PF,7,16,6,12,1,4,Center,2,Jump Shot,10.6875
2014-15,202952,Malcolm Thomas,PF,18,40,18,33,0,7,Center,1,Jump Shot,7.425
2003-04,2124,Malik Allen,PF,83,198,83,198,0,0,Center,5,Jump Shot,12.646464646464647
2004-05,2124,Malik Allen,PF,84,177,84,177,0,0,Center,1,Jump Shot,12.830508474576272
2005-06,2124,Malik Allen,PF,121,247,120,246,1,1,Center,5,Jump Shot,11.129554655870445
2006-07,2124,Malik Allen,PF,107,258,107,257,0,1,Center,7,Jump Shot,11.821705426356589
2007-08,2124,Malik Allen,PF,157,327,156,325,1,2,Center,7,Jump Shot,14.370030581039755
2008-09,2124,Malik Allen,PF,73,170,73,169,0,1,Center,1,Jump Shot,12.717647058823529
2009-10,2124,Malik Allen,PF,46,116,45,110,1,6,Center,11,Jump Shot,13.913793103448276
2010-11,2124,Malik Allen,PF,11,31,11,31,0,0,Center,4,Jump Shot,11.838709677419354
2016-17,1627736,Malik Beasley,SG,33,73,24,45,9,28,Center,7,Jump Shot,12.054794520547945
2017-18,1627736,Malik Beasley,SG,73,178,45,96,28,82,Center,13,Jump Shot,14.601123595505618
2018-19,1627736,Malik Beasley,SG,349,737,186,332,163,405,Center,20,Jump Shot,16.299864314789687
2019-20,1627736,Malik Beasley,SG,227,534,120,258,107,276,Center,5,Jump Shot,16.243445692883896
2020-21,1627736,Malik Beasley,SG,264,600,136,279,128,321,Center,14,Jump Shot,15.875
2021-22,1627736,Malik Beasley,SG,332,850,92,213,240,637,Center,10,Jump Shot,20.25764705882353
2022-23,1627736,Malik Beasley,SG,370,937,135,279,235,658,Center,10,Jump Shot,20.43436499466382
2020-21,1630238,Malik Fitts,PF,1,3,0,1,1,2,Center,0,Jump Shot,17.0
2021-22,1630238,Malik Fitts,PF,8,19,3,9,5,10,Center,2,Jump Shot,16.210526315789473
2008-09,201612,Malik Hairston,SG,24,49,24,48,0,1,Center,3,Jump Shot,7.938775510204081
2009-10,201612,Malik Hairston,SG,40,76,38,65,2,11,Center,4,Jump Shot,8.578947368421053
2017-18,1628370,Malik Monk,SG,153,425,70,182,83,243,Center,13,Jump Shot,19.322352941176472
2018-19,1628370,Malik Monk,SG,227,586,118,256,109,330,Center,15,Jump Shot,17.41296928327645
2019-20,1628370,Malik Monk,SG,212,488,154,284,58,204,Center,8,Jump Shot,13.561475409836065
2020-21,1628370,Malik Monk,SG,173,399,88,187,85,212,Center,8,Jump Shot,16.263157894736842
2021-22,1628370,Malik Monk,SG,391,826,218,384,173,442,Center,23,Jump Shot,15.75181598062954
2022-23,1628370,Malik Monk,SG,357,796,214,398,143,398,Center,8,Jump Shot,15.293969849246231
2019-20,1629005,Malik Newman,SG,0,2,0,1,0,1,Right Side Center,0,Pullup Jump shot,21.5
2021-22,1629005,Malik Newman,PG,3,5,3,4,0,1,Left Side Center,0,Pullup Jump shot,14.4
2003-04,990,Malik Rose,PF,173,404,173,401,0,3,Center,6,Jump Shot,8.091584158415841
2004-05,990,Malik Rose,PF,198,441,197,431,1,10,Center,6,Jump Shot,9.931972789115646
2005-06,990,Malik Rose,PF,105,281,104,280,1,1,Center,3,Jump Shot,7.473309608540926
2006-07,990,Malik Rose,PF,74,186,72,178,2,8,Center,2,Jump Shot,11.075268817204302
2007-08,990,Malik Rose,PF,66,180,64,173,2,7,Center,3,Jump Shot,9.966666666666667
2008-09,990,Malik Rose,PF,45,131,45,124,0,7,Center,3,Jump Shot,11.511450381679388
2020-21,1629603,Mamadi Diakite,PF,16,40,15,32,1,8,Center,1,Jump Shot,10.375
2021-22,1629603,Mamadi Diakite,PF,25,47,25,42,0,5,Center,0,Jump Shot,6.404255319148936
2022-23,1629603,Mamadi Diakite,PF,24,50,17,29,7,21,Center,5,Jump Shot,13.46
2003-04,2055,Mamadou N'diaye,C,27,69,27,69,0,0,Center,2,Layup Shot,3.289855072463768
2004-05,2055,Mamadou N'diaye,C,8,20,8,19,0,1,Center,1,Jump Shot,8.35
2017-18,1628493,Mangok Mathiang,C,4,7,4,7,0,0,Center,1,Layup Shot,2.0
2010-11,202412,Manny Harris,SG,108,289,74,197,34,92,Center,3,Jump Shot,12.370242214532873
2011-12,202412,Manny Harris,SG,60,150,48,114,12,36,Center,9,Jump Shot,12.153333333333334
2013-14,202412,Manny Harris,SG,28,70,21,50,7,20,Center,2,Jump Shot,11.842857142857143
2016-17,202412,Manny Harris,SG,3,15,3,13,0,2,Center,0,Jump Shot,9.866666666666667
2003-04,1938,Manu Ginobili,SG,330,789,242,544,88,245,Center,10,Jump Shot,11.946768060836503
2004-05,1938,Manu Ginobili,SG,367,780,270,522,97,258,Center,14,Jump Shot,11.087179487179487
2005-06,1938,Manu Ginobili,SG,309,669,226,452,83,217,Center,10,Jump Shot,11.547085201793722
2006-07,1938,Manu Ginobili,SG,396,854,268,531,128,323,Center,21,Jump Shot,13.125292740046838
2007-08,1938,Manu Ginobili,SG,453,984,297,595,156,389,Center,22,Jump Shot,14.715447154471544
2008-09,1938,Manu Ginobili,SG,223,491,154,282,69,209,Center,8,Jump Shot,14.74949083503055
2009-10,1938,Manu Ginobili,SG,397,901,266,553,131,348,Center,14,Jump Shot,13.416204217536071
2010-11,1938,Manu Ginobili,SG,441,1017,287,577,154,440,Center,16,Jump Shot,14.941002949852507
2011-12,1938,Manu Ginobili,SG,150,285,98,159,52,126,Center,2,Jump Shot,14.319298245614036
2012-13,1938,Manu Ginobili,SG,229,539,146,304,83,235,Center,12,Jump Shot,14.489795918367347
2013-14,1938,Manu Ginobili,SG,294,627,204,369,90,258,Center,10,Jump Shot,13.604465709728867
2014-15,1938,Manu Ginobili,SG,251,589,162,331,89,258,Center,9,Jump Shot,13.894736842105264
2015-16,1938,Manu Ginobili,SG,197,435,127,256,70,179,Center,5,Jump Shot,13.910344827586206
2016-17,1938,Manu Ginobili,SG,171,439,82,212,89,227,Center,5,Jump Shot,16.047835990888384
2017-18,1938,Manu Ginobili,SG,201,463,137,271,64,192,Center,8,Jump Shot,13.779697624190065
2022-23,1630699,MarJon Beauchamp,SF,96,243,49,101,47,142,Center,14,Jump Shot,17.061728395061728
2011-12,202705,MarShon Brooks,SG,274,640,227,490,47,150,Center,6,Jump Shot,13.0375
2012-13,202705,MarShon Brooks,SG,155,335,140,280,15,55,Center,10,Jump Shot,9.967164179104477
2013-14,202705,MarShon Brooks,SG,57,125,44,100,13,25,Center,14,Jump Shot,11.032
2017-18,202705,MarShon Brooks,SG,51,102,32,70,19,32,Center,3,Jump Shot,13.57843137254902
2018-19,202705,MarShon Brooks,SG,76,169,61,115,15,54,Center,0,Jump Shot,13.29585798816568
2008-09,201188,Marc Gasol,C,350,661,350,660,0,1,Center,13,Jump Shot,5.46142208774584
2009-10,201188,Marc Gasol,C,378,651,378,650,0,1,Center,6,Layup Shot,4.537634408602151
2010-11,201188,Marc Gasol,C,364,691,361,684,3,7,Center,5,Jump Shot,6.5615050651230105
2011-12,201188,Marc Gasol,C,357,740,356,728,1,12,Center,7,Jump Shot,9.116216216216216
2012-13,201188,Marc Gasol,C,429,869,428,855,1,14,Center,14,Jump Shot,9.481012658227849
2013-14,201188,Marc Gasol,C,336,711,334,700,2,11,Center,10,Jump Shot,10.143459915611814
2014-15,201188,Marc Gasol,C,530,1072,527,1055,3,17,Center,25,Jump Shot,9.602611940298507
2015-16,201188,Marc Gasol,C,328,707,326,704,2,3,Center,5,Jump Shot,10.152758132956153
2016-17,201188,Marc Gasol,C,532,1160,428,892,104,268,Center,17,Jump Shot,13.435344827586206
2017-18,201188,Marc Gasol,C,434,1033,325,713,109,320,Center,10,Jump Shot,14.267182962245887
2018-19,201188,Marc Gasol,C,390,870,291,597,99,273,Center,14,Jump Shot,13.76551724137931
2019-20,201188,Marc Gasol,C,119,279,62,131,57,148,Center,1,Jump Shot,16.795698924731184
2020-21,201188,Marc Gasol,C,88,194,38,72,50,122,Center,1,Jump Shot,18.77319587628866
2003-04,1531,Marc Jackson,PF,71,171,71,170,0,1,Center,2,Jump Shot,6.87719298245614
2004-05,1531,Marc Jackson,C,340,731,340,729,0,2,Center,6,Jump Shot,7.422708618331053
2005-06,1531,Marc Jackson,C,174,369,173,367,1,2,Center,6,Jump Shot,10.002710027100271
2006-07,1531,Marc Jackson,PF,159,388,159,387,0,1,Center,1,Jump Shot,12.128865979381443
2015-16,1626273,Marcelo Huertas,PG,97,230,81,169,16,61,Center,7,Jump Shot,12.982608695652173
2016-17,1626273,Marcelo Huertas,PG,25,68,21,49,4,19,Center,3,Jump Shot,12.779411764705882
2007-08,101162,Marcin Gortat,C,8,17,8,17,0,0,Center,2,Layup Shot,3.7058823529411766
2008-09,101162,Marcin Gortat,PF,106,187,105,186,1,1,Center,11,Layup Shot,4.032085561497326
2009-10,101162,Marcin Gortat,C,121,227,121,224,0,3,Center,7,Layup Shot,3.828193832599119
2010-11,101162,Marcin Gortat,C,338,603,337,599,1,4,Center,11,Jump Shot,5.736318407960199
2011-12,101162,Marcin Gortat,C,427,769,427,767,0,2,Center,10,Jump Shot,5.487646293888166
2012-13,101162,Marcin Gortat,C,295,566,295,563,0,3,Center,9,Jump Shot,6.054770318021202
2013-14,101162,Marcin Gortat,C,455,840,454,839,1,1,Center,12,Jump Shot,6.180952380952381
2014-15,101162,Marcin Gortat,C,439,775,439,772,0,3,Center,9,Jump Shot,5.56258064516129
2015-16,101162,Marcin Gortat,C,433,764,433,763,0,1,Center,6,Jump Shot,5.2591623036649215
2016-17,101162,Marcin Gortat,C,390,673,390,672,0,1,Center,9,Jump Shot,4.4665676077265974
2017-18,101162,Marcin Gortat,C,290,560,290,560,0,0,Center,3,Jump Shot,5.4875
2018-19,101162,Marcin Gortat,C,99,186,99,186,0,0,Center,0,Cutting Layup Shot,4.403225806451613
2007-08,201158,Marco Belinelli,SG,36,93,20,52,16,41,Center,5,Jump Shot,18.301075268817204
2008-09,201158,Marco Belinelli,SG,140,317,88,186,52,131,Center,11,Jump Shot,17.1198738170347
2009-10,201158,Marco Belinelli,SG,154,379,94,221,60,158,Center,5,Jump Shot,16.773087071240106
2010-11,201158,Marco Belinelli,SG,302,691,168,367,134,324,Center,10,Jump Shot,17.845151953690305
2011-12,201158,Marco Belinelli,SG,286,686,179,402,107,284,Center,12,Jump Shot,17.459183673469386
2012-13,201158,Marco Belinelli,SG,241,610,162,389,79,221,Center,19,Jump Shot,15.21311475409836
2013-14,201158,Marco Belinelli,SF,337,695,211,402,126,293,Center,13,Jump Shot,16.51654676258993
2014-15,201158,Marco Belinelli,SG,199,470,113,240,86,230,Center,6,Jump Shot,18.0
2015-16,201158,Marco Belinelli,SG,245,635,154,338,91,297,Center,10,Jump Shot,19.68503937007874
2016-17,201158,Marco Belinelli,SG,264,614,162,332,102,282,Center,7,Jump Shot,18.28338762214984
2017-18,201158,Marco Belinelli,SG,337,764,188,369,149,395,Center,8,Jump Shot,18.92539267015707
2018-19,201158,Marco Belinelli,SG,285,690,138,295,147,395,Center,10,Jump Shot,19.18840579710145
2019-20,201158,Marco Belinelli,SG,123,314,56,136,67,178,Center,9,Jump Shot,19.99044585987261
2003-04,2556,Marcus Banks,PG,177,442,150,356,27,86,Center,15,Jump Shot,11.746606334841628
2004-05,2556,Marcus Banks,PG,115,286,94,227,21,59,Center,5,Jump Shot,11.237762237762238
2005-06,2556,Marcus Banks,PG,219,468,197,405,22,63,Center,18,Jump Shot,12.675213675213675
2006-07,2556,Marcus Banks,PG,84,196,79,167,5,29,Center,8,Jump Shot,12.71938775510204
2007-08,2556,Marcus Banks,PG,86,191,46,89,40,102,Center,5,Jump Shot,16.769633507853403
2008-09,2556,Marcus Banks,PG,21,57,18,38,3,19,Center,1,Jump Shot,13.210526315789474
2009-10,2556,Marcus Banks,PG,39,73,32,49,7,24,Center,8,Jump Shot,15.246575342465754
2010-11,2556,Marcus Banks,PG,0,2,0,2,0,0,Left Side,0,Jump Shot,6.5
2003-04,948,Marcus Camby,C,262,549,262,547,0,2,Center,7,Jump Shot,7.712204007285974
2004-05,948,Marcus Camby,C,279,600,279,596,0,4,Center,6,Jump Shot,9.533333333333333
2005-06,948,Marcus Camby,C,302,649,301,638,1,11,Center,11,Jump Shot,10.59322033898305
2006-07,948,Marcus Camby,C,312,659,312,657,0,2,Center,5,Jump Shot,8.678300455235204
2007-08,948,Marcus Camby,C,286,635,280,615,6,20,Center,7,Jump Shot,9.01259842519685
2008-09,948,Marcus Camby,C,254,496,253,492,1,4,Center,4,Jump Shot,7.439516129032258
2009-10,948,Marcus Camby,PF-C,238,501,236,494,2,7,Center,5,Jump Shot,7.261477045908183
2010-11,948,Marcus Camby,C,117,294,117,293,0,1,Center,0,Jump Shot,6.969387755102041
2011-12,948,Marcus Camby,C,128,287,126,282,2,5,Center,4,Jump Shot,7.428571428571429
2012-13,948,Marcus Camby,PF,17,53,17,53,0,0,Center,0,Jump Shot,5.886792452830188
2010-11,202408,Marcus Cousin,C,2,3,2,3,0,0,Center,0,Jump Shot,12.333333333333334
2018-19,1629094,Marcus Derrickson,PF,16,33,6,13,10,20,Center,4,Jump Shot,20.060606060606062
2003-04,2033,Marcus Fizer,SF,134,350,132,333,2,17,Center,9,Jump Shot,8.668571428571429
2004-05,2033,Marcus Fizer,PF,133,292,133,286,0,6,Center,6,Jump Shot,8.934931506849315
2005-06,2033,Marcus Fizer,PF,9,17,8,16,1,1,Right Side Center,2,Jump Shot,13.647058823529411
2021-22,1630585,Marcus Garrett,SG,5,21,4,17,1,4,Center,1,Driving Layup Shot,8.904761904761905
2016-17,1627875,Marcus Georges-Hunt,SG,2,7,1,5,1,2,Center,0,Jump Shot,12.0
2017-18,1627875,Marcus Georges-Hunt,SG,21,48,17,33,4,15,Center,7,Jump Shot,11.3125
2003-04,2409,Marcus Haislip,PF,36,74,35,72,1,2,Center,1,Jump Shot,6.0
2004-05,2409,Marcus Haislip,PF,13,38,13,37,0,1,Center,2,Jump Shot,8.736842105263158
2009-10,2409,Marcus Haislip,SF,10,21,7,16,3,5,Center,4,Jump Shot,13.666666666666666
2009-10,202068,Marcus Landry,SF,16,43,7,15,9,28,Center,5,Jump Shot,17.72093023255814
2011-12,202694,Marcus Morris Sr.,PF,16,54,14,37,2,17,Center,3,Jump Shot,15.5
2012-13,202694,Marcus Morris Sr.,PF-SF,222,526,136,293,86,233,Center,8,Jump Shot,14.870722433460076
2013-14,202694,Marcus Morris Sr.,SF,288,651,189,391,99,260,Center,6,Jump Shot,16.026113671274963
2014-15,202694,Marcus Morris Sr.,PF,331,763,219,450,112,313,Center,10,Jump Shot,16.230668414154653
2015-16,202694,Marcus Morris Sr.,SF,410,945,302,647,108,298,Center,10,Jump Shot,15.027513227513227
2016-17,202694,Marcus Morris Sr.,SF,421,1007,303,650,118,357,Center,14,Jump Shot,16.781529294935453
2017-18,202694,Marcus Morris Sr.,PF,262,611,176,377,86,234,Center,5,Jump Shot,16.497545008183305
2018-19,202694,Marcus Morris Sr.,PF,377,844,231,455,146,389,Center,14,Jump Shot,16.129146919431278
2019-20,202694,Marcus Morris Sr.,SF-PF,355,810,213,462,142,348,Center,26,Jump Shot,17.21604938271605
2020-21,202694,Marcus Morris Sr.,PF,276,584,136,288,140,296,Center,5,Jump Shot,17.921232876712327
2021-22,202694,Marcus Morris Sr.,PF,300,691,199,416,101,275,Center,8,Jump Shot,17.1027496382055
2022-23,202694,Marcus Morris Sr.,PF,274,643,162,336,112,307,Center,2,Jump Shot,17.674961119751167
2017-18,1627779,Marcus Paige,PG,4,14,2,6,2,8,Center,0,Jump Shot,17.357142857142858
2014-15,203935,Marcus Smart,PG,175,477,84,205,91,272,Center,11,Jump Shot,17.542976939203353
2015-16,203935,Marcus Smart,PG,184,529,123,288,61,241,Center,7,Jump Shot,14.415879017013232
2016-17,203935,Marcus Smart,SG,269,749,175,417,94,332,Center,16,Jump Shot,15.253671562082777
2017-18,203935,Marcus Smart,SG,189,515,114,266,75,249,Center,5,Jump Shot,16.322330097087377
2018-19,203935,Marcus Smart,SG,239,567,113,221,126,346,Center,8,Jump Shot,17.606701940035272
2019-20,203935,Marcus Smart,SG,256,682,119,287,137,395,Center,15,Jump Shot,17.95014662756598
2020-21,203935,Marcus Smart,PG,203,510,110,228,93,282,Center,9,Jump Shot,17.376470588235293
2021-22,203935,Marcus Smart,PG,300,718,181,358,119,360,Center,4,Jump Shot,15.575208913649025
2022-23,203935,Marcus Smart,PG,250,602,135,260,115,342,Center,9,Jump Shot,17.026578073089702
2009-10,201977,Marcus Thornton,SG,398,883,281,570,117,313,Center,19,Jump Shot,13.077010192525481
2010-11,201977,Marcus Thornton,SG,350,807,262,567,88,240,Center,20,Jump Shot,13.727385377943
2011-12,201977,Marcus Thornton,SG,352,803,245,493,107,310,Center,15,Jump Shot,13.499377334993774
2012-13,201977,Marcus Thornton,SG,332,774,191,395,141,379,Center,11,Jump Shot,16.419896640826874
2013-14,201977,Marcus Thornton,SG,252,639,143,323,109,316,Center,6,Jump Shot,16.503912363067293
2014-15,201977,Marcus Thornton,SG,140,345,86,202,54,143,Center,1,Jump Shot,15.371014492753623
2015-16,201977,Marcus Thornton,SG,216,541,125,272,91,269,Center,14,Jump Shot,16.380776340110906
2016-17,201977,Marcus Thornton,SG,84,210,56,130,28,80,Center,0,Jump Shot,14.595238095238095
2006-07,200790,Marcus Vinicius,SF,7,15,4,8,3,7,Center,1,Jump Shot,14.4
2007-08,200790,Marcus Vinicius,SF,9,20,4,8,5,12,Center,4,Jump Shot,18.2
2006-07,200766,Marcus Williams,PG,208,526,162,363,46,163,Center,12,Jump Shot,13.903041825095057
2007-08,200766,Marcus Williams,PG,111,293,57,151,54,142,Center,9,Jump Shot,18.423208191126278
2007-08,201173,Marcus Williams,PF-SF,5,20,5,20,0,0,Center,4,Jump Shot,12.0
2008-09,200766,Marcus Williams,PG,4,17,2,11,2,6,Center,1,Jump Shot,16.058823529411764
2008-09,201173,Marcus Williams,PF,2,2,2,2,0,0,Center,2,Turnaround Fadeaway shot,10.5
2009-10,200766,Marcus Williams,PG,104,271,80,190,24,81,Center,5,Jump Shot,15.398523985239853
2006-07,200776,Mardy Collins,SF,87,228,74,181,13,47,Center,10,Jump Shot,11.508771929824562
2007-08,200776,Mardy Collins,SG,57,175,49,143,8,32,Center,9,Jump Shot,9.862857142857143
2008-09,200776,Mardy Collins,PG-SG,105,247,92,216,13,31,Center,6,Jump Shot,7.834008097165992
2009-10,200776,Mardy Collins,SG,47,128,43,111,4,17,Center,3,Jump Shot,11.5703125
2019-20,1629621,Marial Shayok,SG,3,12,1,6,2,6,Center,0,Jump Shot,18.916666666666668
2008-09,201596,Mario Chalmers,PG,278,662,164,351,114,311,Center,8,Jump Shot,15.734138972809667
2009-10,201596,Mario Chalmers,PG,182,454,107,218,75,236,Center,8,Jump Shot,17.015418502202643
2010-11,201596,Mario Chalmers,PG,154,387,72,157,82,230,Center,9,Jump Shot,18.41343669250646
2011-12,201596,Mario Chalmers,PG,223,498,122,238,101,260,Center,10,Jump Shot,16.401606425702813
2012-13,201596,Mario Chalmers,PG,227,529,104,228,123,301,Center,2,Jump Shot,16.80907372400756
2013-14,201596,Mario Chalmers,PG,254,560,167,334,87,226,Center,10,Jump Shot,12.189285714285715
2014-15,201596,Mario Chalmers,PG,267,663,194,415,73,248,Center,12,Jump Shot,13.116138763197586
2015-16,201596,Mario Chalmers,PG,182,444,136,295,46,149,Center,7,Jump Shot,12.29054054054054
2017-18,201596,Mario Chalmers,PG,168,443,115,252,53,191,Center,10,Jump Shot,15.094808126410836
2015-16,1626209,Mario Hezonja,SF,181,418,114,226,67,192,Center,8,Jump Shot,16.89952153110048
2016-17,1626209,Mario Hezonja,SF,117,330,74,186,43,144,Center,18,Jump Shot,17.02121212121212
2017-18,1626209,Mario Hezonja,SF,273,617,183,350,90,267,Center,21,Jump Shot,14.9967585089141
2018-19,1626209,Mario Hezonja,SF,191,464,149,312,42,152,Center,10,Jump Shot,12.357758620689655
2019-20,1626209,Mario Hezonja,PF,92,218,68,140,24,78,Center,7,Jump Shot,12.610091743119266
2004-05,2435,Mario Kasun,C,47,98,47,97,0,1,Center,5,Layup Shot,2.2346938775510203
2005-06,2435,Mario Kasun,C,31,69,31,69,0,0,Center,2,Layup Shot,1.9275362318840579
2007-08,201238,Mario West,SG,21,49,21,45,0,4,Center,5,Layup Shot,5.979591836734694
2008-09,201238,Mario West,SG,14,34,13,33,1,1,Center,5,Jump Shot,4.411764705882353
2009-10,201238,Mario West,SG,12,21,12,20,0,1,Center,2,Driving Layup Shot,3.9523809523809526
2010-11,201238,Mario West,SG,9,21,8,17,1,4,Center,1,Jump Shot,8.714285714285714
2003-04,1548,Mark Blount,C,342,604,342,604,0,0,Center,7,Jump Shot,5.697019867549669
2004-05,1548,Mark Blount,C,327,618,327,617,0,1,Center,6,Jump Shot,8.614886731391586
2005-06,1548,Mark Blount,C,373,734,373,734,0,0,Center,8,Jump Shot,8.998637602179837
2006-07,1548,Mark Blount,C,427,839,418,808,9,31,Center,11,Jump Shot,11.508939213349226
2007-08,1548,Mark Blount,C,238,515,221,471,17,44,Center,6,Jump Shot,11.914563106796116
2008-09,1548,Mark Blount,C,30,78,19,51,11,27,Center,2,Jump Shot,17.384615384615383
2003-04,349,Mark Jackson,PG,34,100,27,59,7,41,Center,0,Jump Shot,14.08
2004-05,2891,Mark Jones,SF,9,31,9,27,0,4,Left Side,1,Jump Shot,13.258064516129032
2003-04,2058,Mark Madsen,C,101,204,101,198,0,6,Center,10,Layup Shot,4.338235294117647
2004-05,2058,Mark Madsen,C,34,66,34,66,0,0,Center,1,Layup Shot,2.196969696969697
2005-06,2058,Mark Madsen,C,27,66,27,59,0,7,Center,0,Layup Shot,4.757575757575758
2006-07,2058,Mark Madsen,C,23,43,23,43,0,0,Center,1,Layup Shot,3.8372093023255816
2007-08,2058,Mark Madsen,PF,3,19,3,19,0,0,Center,1,Layup Shot,3.1578947368421053
2008-09,2058,Mark Madsen,C,3,14,3,14,0,0,Center,1,Jump Hook Shot,5.571428571428571
2003-04,998,Mark Pope,PF,1,2,1,2,0,0,Center,0,Layup Shot,3.5
2004-05,998,Mark Pope,PF,2,6,2,6,0,0,Center,1,Tip Shot,1.5
2022-23,1631109,Mark Williams,C,160,251,160,251,0,0,Center,12,Tip Layup Shot,2.7211155378486054
2014-15,203900,Markel Brown,SG,76,210,59,146,17,64,Center,8,Jump Shot,13.219047619047618
2015-16,203900,Markel Brown,SG,127,322,89,201,38,121,Center,13,Jump Shot,14.562111801242237
2017-18,203900,Markel Brown,SG,2,7,1,2,1,5,Left Side Center,1,Jump Shot,20.285714285714285
2017-18,1628365,Markelle Fultz,SG,45,111,45,110,0,1,Center,2,Driving Layup Shot,6.162162162162162
2018-19,1628365,Markelle Fultz,SG,65,155,61,141,4,14,Center,1,Pullup Jump shot,9.670967741935485
2019-20,1628365,Markelle Fultz,PG,359,772,323,637,36,135,Center,15,Pullup Jump shot,10.441709844559586
2020-21,1628365,Markelle Fultz,PG,41,104,37,88,4,16,Center,3,Pullup Jump shot,10.951923076923077
2021-22,1628365,Markelle Fultz,PG,83,175,79,158,4,17,Center,0,Pullup Jump shot,10.611428571428572
2022-23,1628365,Markelle Fultz,PG,349,679,322,592,27,87,Center,16,Pullup Jump shot,9.30338733431517
2011-12,202693,Markieff Morris,PF,174,436,131,312,43,124,Center,9,Jump Shot,13.162844036697248
2012-13,202693,Markieff Morris,PF,266,653,221,519,45,134,Center,8,Jump Shot,12.464012251148546
2013-14,202693,Markieff Morris,PF,411,845,377,737,34,108,Center,13,Jump Shot,10.887573964497042
2014-15,202693,Markieff Morris,PF,512,1100,455,921,57,179,Center,27,Jump Shot,12.018181818181818
2015-16,202693,Markieff Morris,PF,305,718,258,563,47,155,Center,3,Jump Shot,12.515320334261839
2016-17,202693,Markieff Morris,PF,406,889,335,693,71,196,Center,14,Jump Shot,11.457817772778403
2017-18,202693,Markieff Morris,PF,330,687,254,480,76,207,Center,8,Jump Shot,13.796215429403203
2018-19,202693,Markieff Morris,PF,204,484,136,281,68,203,Center,4,Jump Shot,14.117768595041323
2019-20,202693,Markieff Morris,PF,203,458,115,230,88,228,Center,1,Jump Shot,15.672489082969433
2020-21,202693,Markieff Morris,PF,153,378,88,169,65,209,Center,2,Jump Shot,17.126984126984127
2021-22,202693,Markieff Morris,PF,54,114,41,75,13,39,Center,1,Jump Shot,14.359649122807017
2022-23,202693,Markieff Morris,PF,47,115,19,44,28,71,Center,0,Jump Shot,19.286956521739132
2019-20,1629741,Marko Guduric,SG,62,157,37,74,25,83,Center,8,Jump Shot,15.853503184713375
2003-04,2060,Marko Jaric,PG,185,477,134,327,51,150,Center,10,Jump Shot,14.39203354297694
2004-05,2060,Marko Jaric,PG,189,457,133,306,56,151,Center,12,Jump Shot,15.428884026258206
2005-06,2060,Marko Jaric,PG,226,566,186,433,40,133,Center,7,Jump Shot,13.30565371024735
2006-07,2060,Marko Jaric,SG,136,325,104,240,32,85,Center,3,Jump Shot,13.461538461538462
2007-08,2060,Marko Jaric,SG,227,528,181,401,46,127,Center,9,Jump Shot,13.765151515151516
2008-09,2060,Marko Jaric,SG,48,145,37,117,11,28,Center,3,Jump Shot,11.206896551724139
2021-22,1630250,Marko Simonovic,C,4,15,3,10,1,5,Center,3,Jump Shot,11.933333333333334
2022-23,1630250,Marko Simonovic,C,2,7,1,3,1,4,Center,1,Jump Shot,18.142857142857142
2020-21,1630210,Markus Howard,SG,40,106,22,41,18,65,Center,11,Jump Shot,19.0188679245283
2021-22,1630210,Markus Howard,SG,39,101,11,31,28,70,Center,12,Jump Shot,19.673267326732674
2020-21,1629716,Marques Bolden,C,1,3,1,3,0,0,Center,0,Jump Shot,7.333333333333333
2016-17,1627737,Marquese Chriss,PF,284,632,212,408,72,224,Center,16,Jump Shot,11.38132911392405
2017-18,1627737,Marquese Chriss,PF,202,477,146,287,56,190,Center,12,Jump Shot,12.442348008385745
2018-19,1627737,Marquese Chriss,PF,67,180,51,108,16,72,Center,7,Jump Shot,11.36111111111111
2019-20,1627737,Marquese Chriss,PF,210,385,202,346,8,39,Center,5,Jump Shot,5.2727272727272725
2020-21,1627737,Marquese Chriss,PF,5,14,4,9,1,5,Center,0,Jump Shot,10.642857142857142
2021-22,1627737,Marquese Chriss,PF,62,134,54,109,8,25,Center,4,Jump Shot,7.3283582089552235
2003-04,2605,Marquis Daniels,SG,203,411,192,375,11,36,Center,19,Jump Shot,7.581508515815085
2004-05,2605,Marquis Daniels,SG,220,504,213,469,7,35,Center,9,Jump Shot,7.920634920634921
2005-06,2605,Marquis Daniels,SG,246,512,242,493,4,19,Center,6,Jump Shot,6.71484375
2006-07,2605,Marquis Daniels,SG,129,281,123,255,6,26,Center,1,Jump Shot,8.87900355871886
2007-08,2605,Marquis Daniels,SG,241,561,214,459,27,102,Center,11,Jump Shot,11.233511586452764
2008-09,2605,Marquis Daniels,SF,311,689,293,599,18,90,Center,7,Jump Shot,9.44267053701016
2009-10,2605,Marquis Daniels,SF,124,249,118,221,6,28,Center,5,Jump Shot,7.550200803212851
2010-11,2605,Marquis Daniels,SF,114,232,110,211,4,21,Center,5,Jump Shot,7.551724137931035
2011-12,2605,Marquis Daniels,SG,52,143,52,133,0,10,Center,5,Jump Shot,8.0
2012-13,2605,Marquis Daniels,SF,132,350,112,279,20,71,Center,12,Jump Shot,10.582857142857144
2012-13,203104,Marquis Teague,PG,43,113,39,90,4,23,Center,4,Jump Shot,10.761061946902656
2013-14,203104,Marquis Teague,SG,38,119,33,101,5,18,Center,6,Jump Shot,9.563025210084033
2017-18,203104,Marquis Teague,PG,4,16,3,12,1,4,Center,0,Pullup Jump shot,16.8125
2008-09,201578,Marreese Speights,C,252,502,250,494,2,8,Center,17,Jump Shot,7.701195219123506
2009-10,201578,Marreese Speights,C,212,444,212,439,0,5,Center,5,Jump Shot,8.731981981981981
2010-11,201578,Marreese Speights,C,144,291,143,287,1,4,Center,8,Jump Shot,10.075601374570446
2011-12,201578,Marreese Speights,PF,221,488,221,485,0,3,Center,2,Jump Shot,8.649590163934427
2012-13,201578,Marreese Speights,C,260,584,257,574,3,10,Center,6,Jump Shot,9.611301369863014
2013-14,201578,Marreese Speights,C,195,442,187,411,8,31,Center,8,Jump Shot,9.918552036199095
2014-15,201578,Marreese Speights,C,318,646,313,628,5,18,Center,13,Jump Shot,10.660990712074303
2015-16,201578,Marreese Speights,C,197,456,173,394,24,62,Center,10,Jump Shot,12.532894736842104
2016-17,201578,Marreese Speights,C,244,547,141,271,103,276,Center,7,Jump Shot,15.645338208409507
2017-18,201578,Marreese Speights,C,138,349,52,116,86,233,Center,11,Jump Shot,20.106017191977077
2016-17,1627850,Marshall Plumlee,C,16,30,16,30,0,0,Center,1,Layup Shot,3.533333333333333
2017-18,1627850,Marshall Plumlee,C,1,3,1,3,0,0,Center,0,Layup Shot,1.0
2005-06,101110,Martell Webster,SF,139,348,74,166,65,182,Center,10,Jump Shot,17.477011494252874
2006-07,101110,Martell Webster,SF,195,492,104,242,91,250,Center,16,Jump Shot,17.302845528455286
2007-08,101110,Martell Webster,SF,277,656,154,339,123,317,Center,12,Jump Shot,17.745426829268293
2008-09,101110,Martell Webster,SF,0,1,0,0,0,1,Right Side Center,0,Jump Shot,25.0
2009-10,101110,Martell Webster,SF,259,639,135,307,124,332,Center,13,Jump Shot,16.55712050078247
2010-11,101110,Martell Webster,SF,152,340,97,208,55,132,Center,7,Jump Shot,15.111764705882353
2011-12,101110,Martell Webster,SF,115,272,78,163,37,109,Center,5,Jump Shot,14.602941176470589
2012-13,101110,Martell Webster,SF,281,635,142,307,139,328,Center,15,Jump Shot,16.705511811023623
2013-14,101110,Martell Webster,SF,254,586,108,215,146,371,Center,8,Jump Shot,19.2098976109215
2014-15,101110,Martell Webster,SF,24,91,14,48,10,43,Center,0,Jump Shot,17.36263736263736
2005-06,101149,Martynas Andriuskevicius,C,0,1,0,1,0,0,Center,0,Jump Bank Shot,6.0
2018-19,1628963,Marvin Bagley III,PF,356,706,326,610,30,96,Center,7,Jump Shot,8.223796033994335
2019-20,1628963,Marvin Bagley III,C,78,167,74,145,4,22,Center,4,Jump Shot,7.658682634730539
2020-21,1628963,Marvin Bagley III,PF,247,490,210,382,37,108,Center,3,Jump Shot,8.395918367346939
2021-22,1628963,Marvin Bagley III,PF,225,446,202,349,23,97,Center,7,Jump Shot,8.72645739910314
2022-23,1628963,Marvin Bagley III,C,202,382,183,316,19,66,Center,5,Jump Shot,8.518324607329843
2005-06,101107,Marvin Williams,PF,235,531,222,478,13,53,Center,11,Jump Shot,11.00376647834275
2006-07,101107,Marvin Williams,PF,306,706,295,661,11,45,Center,12,Jump Shot,12.128895184135978
2007-08,101107,Marvin Williams,SF,424,918,423,908,1,10,Center,10,Jump Shot,11.265795206971678
2008-09,101107,Marvin Williams,SF,285,621,230,467,55,154,Center,11,Jump Shot,11.96135265700483
2009-10,101107,Marvin Williams,SF,302,664,262,532,40,132,Center,3,Jump Shot,11.42921686746988
2010-11,101107,Marvin Williams,SF,246,537,209,427,37,110,Center,9,Jump Shot,13.089385474860336
2011-12,101107,Marvin Williams,SF,203,470,145,321,58,149,Center,7,Jump Shot,13.446808510638299
2012-13,101107,Marvin Williams,SF,199,470,145,304,54,166,Center,1,Jump Shot,14.602127659574467
2013-14,101107,Marvin Williams,PF,231,526,147,292,84,234,Center,8,Jump Shot,16.09505703422053
2014-15,101107,Marvin Williams,PF,210,495,115,230,95,265,Center,8,Jump Shot,18.034343434343434
2015-16,101107,Marvin Williams,PF,338,746,186,369,152,377,Center,11,Jump Shot,16.04691689008043
2016-17,101107,Marvin Williams,PF,297,704,173,350,124,354,Center,12,Jump Shot,15.285511363636363
2017-18,101107,Marvin Williams,PF,258,563,132,258,126,305,Center,4,Jump Shot,15.891651865008882
2018-19,101107,Marvin Williams,PF,275,652,135,270,140,382,Center,6,Jump Shot,16.76840490797546
2019-20,101107,Marvin Williams,PF,119,267,63,111,56,156,Center,2,Jump Shot,16.93258426966292
2020-21,1630222,Mason Jones,SG,52,123,28,57,24,66,Center,3,Jump Shot,17.130081300813007
2021-22,1630222,Mason Jones,SG,7,15,6,11,1,4,Center,1,Driving Layup Shot,10.066666666666666
2013-14,203486,Mason Plumlee,C,199,302,199,299,0,3,Center,16,Layup Shot,2.4271523178807946
2014-15,203486,Mason Plumlee,C,280,489,280,486,0,3,Center,4,Layup Shot,2.2699386503067487
2015-16,203486,Mason Plumlee,C,267,517,267,513,0,4,Center,8,Layup Shot,3.5589941972920696
2016-17,203486,Mason Plumlee,C,334,623,334,617,0,6,Center,14,Jump Shot,4.560192616372392
2017-18,203486,Mason Plumlee,C,221,368,221,367,0,1,Center,9,Layup Shot,2.9157608695652173
2018-19,203486,Mason Plumlee,C,262,442,260,432,2,10,Center,1,Turnaround Hook Shot,4.067873303167421
2019-20,203486,Mason Plumlee,C,177,288,177,283,0,5,Center,3,Alley Oop Dunk Shot,3.25
2020-21,203486,Mason Plumlee,C,234,381,234,374,0,7,Center,8,Layup Shot,4.183727034120735
2021-22,203486,Mason Plumlee,C,205,320,205,318,0,2,Center,5,Layup Shot,2.640625
2022-23,203486,Mason Plumlee,C,329,484,329,484,0,0,Center,17,Tip Layup Shot,2.2871900826446283
2003-04,2043,Mateen Cleaves,PG,7,23,7,22,0,1,Center,1,Jump Shot,14.304347826086957
2004-05,2043,Mateen Cleaves,PG,5,14,5,12,0,2,Left Side,1,Jump Shot,12.857142857142858
2005-06,2043,Mateen Cleaves,PG,25,71,21,55,4,16,Center,3,Jump Shot,13.816901408450704
2019-20,1629680,Matisse Thybulle,SG,112,265,56,108,56,157,Center,2,Jump Shot,16.07547169811321
2020-21,1629680,Matisse Thybulle,SG,102,243,59,100,43,143,Center,4,Jump Shot,15.633744855967079
2021-22,1629680,Matisse Thybulle,SG,150,300,105,156,45,144,Center,8,Jump Shot,12.57
2022-23,1629680,Matisse Thybulle,SG,110,253,56,105,54,148,Center,3,Jump Shot,15.288537549407115
2003-04,2440,Matt Barnes,SF,63,138,61,125,2,13,Center,2,Jump Shot,6.159420289855072
2004-05,2440,Matt Barnes,SF,62,151,57,129,5,22,Center,1,Jump Shot,10.463576158940397
2005-06,2440,Matt Barnes,PF-SF,70,140,67,125,3,15,Center,3,Jump Shot,7.485714285714286
2006-07,2440,Matt Barnes,PF,275,628,169,338,106,290,Center,16,Jump Shot,14.183121019108281
2007-08,2440,Matt Barnes,PF,187,442,134,261,53,181,Center,10,Jump Shot,13.726244343891402
2008-09,2440,Matt Barnes,PF,285,674,168,333,117,341,Center,7,Jump Shot,15.363501483679526
2009-10,2440,Matt Barnes,SF,271,557,205,350,66,207,Center,11,Jump Shot,11.242369838420109
2010-11,2440,Matt Barnes,SF,131,279,97,172,34,107,Center,3,Jump Shot,12.222222222222221
2011-12,2440,Matt Barnes,SF,175,387,129,249,46,138,Center,2,Jump Shot,11.883720930232558
2012-13,2440,Matt Barnes,SF,312,675,201,350,111,325,Center,7,Jump Shot,14.122962962962964
2013-14,2440,Matt Barnes,SF,230,526,134,244,96,282,Center,6,Jump Shot,15.5893536121673
2014-15,2440,Matt Barnes,SF,277,623,141,248,136,375,Center,8,Jump Shot,15.959871589085072
2015-16,2440,Matt Barnes,SF,263,692,145,323,118,369,Center,10,Jump Shot,15.38728323699422
2016-17,2440,Matt Barnes,SF,184,472,98,210,86,262,Center,7,Jump Shot,16.28813559322034
2004-05,2588,Matt Bonner,C,247,463,208,371,39,92,Center,11,Jump Shot,13.840172786177106
2005-06,2588,Matt Bonner,PF,209,467,107,224,102,243,Center,13,Jump Shot,18.143468950749465
2006-07,2588,Matt Bonner,PF,106,237,70,143,36,94,Center,17,Jump Shot,14.654008438818565
2007-08,2588,Matt Bonner,PF,121,291,75,154,46,137,Center,11,Jump Shot,16.539518900343644
2008-09,2588,Matt Bonner,PF,266,536,148,268,118,268,Center,5,Jump Shot,16.87313432835821
2009-10,2588,Matt Bonner,PF,166,372,76,141,90,231,Center,5,Jump Shot,18.24462365591398
2010-11,2588,Matt Bonner,PF,172,371,67,141,105,230,Center,4,Jump Shot,18.81401617250674
2011-12,2588,Matt Bonner,PF,154,350,49,100,105,250,Center,2,Jump Shot,20.302857142857142
2012-13,2588,Matt Bonner,PF,112,230,59,110,53,120,Center,6,Jump Shot,17.9
2013-14,2588,Matt Bonner,PF,73,163,31,66,42,97,Center,8,Jump Shot,18.32515337423313
2014-15,2588,Matt Bonner,PF,94,230,48,104,46,126,Center,7,Jump Shot,17.456521739130434
2015-16,2588,Matt Bonner,C,29,56,14,23,15,33,Center,3,Jump Shot,18.267857142857142
2003-04,2679,Matt Carroll,SG,7,16,6,13,1,3,Center,0,Jump Shot,13.875
2004-05,2679,Matt Carroll,SG,70,180,57,141,13,39,Center,6,Jump Shot,14.95
2005-06,2679,Matt Carroll,SG,192,476,120,291,72,185,Center,11,Jump Shot,16.468487394957982
2006-07,2679,Matt Carroll,SG,285,658,174,391,111,267,Right Side,18,Jump Shot,16.513677811550153
2007-08,2679,Matt Carroll,SG,252,589,147,348,105,241,Center,13,Jump Shot,17.471986417657046
2008-09,2679,Matt Carroll,SG,65,171,52,118,13,53,Right Side,3,Jump Shot,17.15204678362573
2009-10,2679,Matt Carroll,SG,18,50,14,31,4,19,Center,6,Jump Shot,16.82
2010-11,2679,Matt Carroll,SG,89,199,72,153,17,46,Center,8,Jump Shot,15.135678391959798
2011-12,2679,Matt Carroll,SG,52,157,44,114,8,43,Center,10,Jump Shot,15.713375796178344
2017-18,1627856,Matt Costello,C,2,4,2,4,0,0,Center,1,Cutting Dunk Shot,1.0
2004-05,2782,Matt Freije,PF,37,127,23,73,14,54,Center,5,Jump Shot,18.480314960629922
2006-07,2782,Matt Freije,PF,16,54,13,32,3,22,Center,0,Jump Shot,15.851851851851851
2003-04,1723,Matt Harpring,SF,193,410,185,377,8,33,Center,7,Jump Shot,9.197560975609756
2004-05,1723,Matt Harpring,SF,418,855,409,812,9,43,Center,14,Jump Shot,8.656140350877193
2005-06,1723,Matt Harpring,SF,322,678,308,639,14,39,Center,10,Jump Shot,9.678466076696164
2006-07,1723,Matt Harpring,SF,322,656,309,617,13,39,Center,15,Jump Shot,9.512195121951219
2007-08,1723,Matt Harpring,SF,237,474,235,464,2,10,Center,3,Jump Shot,9.457805907172995
2008-09,1723,Matt Harpring,SG,111,241,111,239,0,2,Center,2,Jump Shot,8.896265560165975
2019-20,1629760,Matt Mooney,SG,1,4,1,2,0,2,Left Side,1,Jump Shot,18.25
2021-22,1629760,Matt Mooney,SG,0,1,0,0,0,1,Right Side Center,0,Jump Shot,25.0
2021-22,1630346,Matt Ryan,SF,1,5,0,0,1,5,Left Side,1,Jump Shot,25.2
2022-23,1630346,Matt Ryan,SF,40,108,8,24,32,84,Left Side Center,7,Jump Shot,21.685185185185187
2019-20,1629744,Matt Thomas,SG,73,150,26,51,47,99,Center,3,Jump Shot,20.573333333333334
2020-21,1629744,Matt Thomas,SG,50,127,23,47,27,80,Center,9,Jump Shot,20.488188976377952
2021-22,1629744,Matt Thomas,SG,55,134,20,43,35,91,Center,6,Jump Shot,22.082089552238806
2005-06,101190,Matt Walsh,SG,1,1,1,1,0,0,Center,1,Driving Layup Shot,4.0
2017-18,1628475,Matt Williams Jr.,SG,2,6,1,1,1,5,Left Side Center,2,Jump Shot,22.833333333333332
2013-14,203521,Matthew Dellavedova,SG,122,296,65,141,57,155,Center,5,Jump Shot,17.27027027027027
2014-15,203521,Matthew Dellavedova,SG,111,307,43,140,68,167,Center,10,Jump Shot,17.54397394136808
2015-16,203521,Matthew Dellavedova,PG,207,511,109,272,98,239,Center,10,Jump Shot,15.90802348336595
2016-17,203521,Matthew Dellavedova,PG,207,533,129,319,78,214,Center,5,Jump Shot,14.654784240150093
2017-18,203521,Matthew Dellavedova,PG,55,152,26,74,29,78,Center,1,Jump Shot,17.44736842105263
2018-19,203521,Matthew Dellavedova,PG,98,242,54,112,44,130,Center,0,Jump Shot,17.59504132231405
2019-20,203521,Matthew Dellavedova,PG,62,175,41,84,21,91,Center,2,Jump Shot,16.12
2020-21,203521,Matthew Dellavedova,PG,14,56,10,31,4,25,Center,0,Jump Shot,13.803571428571429
2022-23,203521,Matthew Dellavedova,PG,17,50,8,23,9,27,Center,4,Jump Shot,16.92
2006-07,200772,Maurice Ager,SG,22,70,17,55,5,15,Center,6,Jump Shot,12.428571428571429
2007-08,200772,Maurice Ager,SG,21,65,18,46,3,19,Center,6,Jump Shot,13.36923076923077
2008-09,200772,Maurice Ager,SG,15,43,15,37,0,6,Center,9,Jump Shot,10.953488372093023
2010-11,200772,Maurice Ager,SG,6,11,3,7,3,4,Center,3,Jump Shot,15.909090909090908
2004-05,2486,Maurice Baker,PG,0,1,0,1,0,0,Left Side,0,Jump Shot,13.0
2003-04,2466,Maurice Carter,SG,11,35,7,24,4,11,Right Side,0,Jump Shot,16.685714285714287
2004-05,2230,Maurice Evans,SG,165,373,138,291,27,82,Center,11,Jump Shot,10.943699731903486
2005-06,2230,Maurice Evans,SG,154,341,111,225,43,116,Center,5,Jump Shot,13.017595307917889
2006-07,2230,Maurice Evans,SG,234,542,186,409,48,133,Center,12,Jump Shot,11.461254612546126
2007-08,2230,Maurice Evans,SG,262,545,181,336,81,209,Center,6,Jump Shot,11.570642201834863
2008-09,2230,Maurice Evans,SF,208,481,110,234,98,247,Center,12,Jump Shot,15.8004158004158
2009-10,2230,Maurice Evans,SF,175,392,118,224,57,168,Center,13,Jump Shot,14.127551020408163
2010-11,2230,Maurice Evans,SF,177,423,122,257,55,166,Center,8,Jump Shot,14.732860520094563
2011-12,2230,Maurice Evans,SF,45,111,28,67,17,44,Left Side,1,Jump Shot,15.81981981981982
2012-13,203090,Maurice Harkless,SF,260,564,228,447,32,117,Center,11,Jump Shot,7.99468085106383
2013-14,203090,Maurice Harkless,SF,224,483,165,329,59,154,Center,11,Jump Shot,10.488612836438923
2014-15,203090,Maurice Harkless,SF,63,158,53,102,10,56,Center,5,Jump Shot,10.550632911392405
2015-16,203090,Maurice Harkless,SF,195,411,156,271,39,140,Center,5,Jump Shot,9.754257907542579
2016-17,203090,Maurice Harkless,SF,313,623,246,430,67,193,Center,9,Jump Shot,9.382022471910112
2017-18,203090,Maurice Harkless,SF,147,297,98,179,49,118,Center,1,Jump Shot,11.16161616161616
2018-19,203090,Maurice Harkless,SF,189,388,156,268,33,120,Center,8,Jump Shot,9.144329896907216
2019-20,203090,Maurice Harkless,PF-SF,142,283,108,185,34,98,Center,3,Jump Shot,9.92226148409894
2020-21,203090,Maurice Harkless,PF-SF,69,165,46,81,23,84,Center,0,Jump Shot,14.363636363636363
2021-22,203090,Maurice Harkless,SF,83,181,52,80,31,101,Center,2,Jump Shot,14.524861878453038
2016-17,1626254,Maurice Ndour,PF,39,86,38,79,1,7,Center,7,Jump Shot,8.162790697674419
2003-04,1508,Maurice Taylor,PF,367,765,367,763,0,2,Center,12,Jump Shot,9.592156862745098
2004-05,1508,Maurice Taylor,PF-C,203,446,200,437,3,9,Center,9,Jump Shot,9.699551569506726
2005-06,1508,Maurice Taylor,PF,182,389,182,388,0,1,Center,3,Jump Shot,9.03598971722365
2006-07,1508,Maurice Taylor,PF,8,28,8,28,0,0,Center,0,Layup Shot,5.892857142857143
2022-23,1631108,Max Christie,SG,44,106,18,44,26,62,Center,3,Jump Shot,17.443396226415093
2019-20,1629622,Max Strus,SF,2,3,2,2,0,1,Center,0,Jump Shot,8.333333333333334
2020-21,1629622,Max Strus,SF,85,187,35,39,50,148,Center,3,Jump Shot,20.288770053475936
2021-22,1629622,Max Strus,SF,249,564,68,122,181,442,Center,7,Jump Shot,20.648936170212767
2022-23,1629622,Max Strus,SF,324,790,127,227,197,563,Center,9,Jump Shot,19.037974683544302
2017-18,1628467,Maxi Kleber,PF,151,309,111,181,40,128,Center,3,Jump Shot,12.789644012944985
2018-19,1628467,Maxi Kleber,PF,175,386,98,168,77,218,Center,2,Jump Shot,15.821243523316062
2019-20,1628467,Maxi Kleber,PF,237,514,118,195,119,319,Center,6,Jump Shot,16.15953307392996
2020-21,1628467,Maxi Kleber,PF,116,275,29,63,87,212,Center,7,Jump Shot,20.465454545454545
2021-22,1628467,Maxi Kleber,PF,141,354,58,99,83,255,Center,3,Jump Shot,19.364406779661017
2022-23,1628467,Maxi Kleber,C,77,169,38,57,39,112,Center,2,Jump Shot,17.54437869822485
2021-22,1630593,McKinley Wright IV,PG,2,3,1,1,1,2,Right Side Center,2,Pullup Jump shot,19.0
2022-23,1630593,McKinley Wright IV,PG,46,98,37,70,9,28,Center,10,Driving Floating Jump Shot,12.13265306122449
2003-04,2246,Mehmet Okur,PF,251,542,233,494,18,48,Center,7,Jump Shot,9.214022140221402
2004-05,2246,Mehmet Okur,C,354,756,337,693,17,63,Center,22,Jump Shot,9.486772486772487
2005-06,2246,Mehmet Okur,PF,519,1128,439,894,80,234,Center,15,Jump Shot,12.949468085106384
2006-07,2246,Mehmet Okur,C,490,1061,361,725,129,336,Center,30,Jump Shot,14.364750235626767
2007-08,2246,Mehmet Okur,C,374,841,260,547,114,294,Center,12,Jump Shot,14.84898929845422
2008-09,2246,Mehmet Okur,C,431,888,341,686,90,202,Center,17,Jump Shot,12.782657657657658
2009-10,2246,Mehmet Okur,C,355,775,273,562,82,213,Center,9,Jump Shot,12.20774193548387
2010-11,2246,Mehmet Okur,C,22,62,17,46,5,16,Center,0,Jump Shot,13.193548387096774
2011-12,2246,Mehmet Okur,C,52,139,29,67,23,72,Center,1,Jump Shot,17.942446043165468
2003-04,2408,Melvin Ely,PF,66,153,66,152,0,1,Center,4,Jump Shot,5.836601307189542
2004-05,2408,Melvin Ely,PF,227,526,227,526,0,0,Center,8,Hook Shot,5.908745247148289
2005-06,2408,Melvin Ely,PF,216,425,216,423,0,2,Center,6,Hook Shot,5.141176470588236
2006-07,2408,Melvin Ely,PF-C,29,80,29,80,0,0,Center,2,Hook Shot,5.9
2007-08,2408,Melvin Ely,C,85,180,85,180,0,0,Center,5,Hook Shot,6.55
2008-09,2408,Melvin Ely,C,37,95,37,95,0,0,Center,3,Jump Shot,5.757894736842105
2010-11,2408,Melvin Ely,C,28,51,28,51,0,0,Center,2,Layup Shot,4.0588235294117645
2013-14,2408,Melvin Ely,C,3,6,3,6,0,0,Center,0,Jump Shot,6.666666666666667
2018-19,1628982,Melvin Frazier Jr.,SG,7,21,7,15,0,6,Center,4,Jump Shot,11.523809523809524
2019-20,1628982,Melvin Frazier Jr.,SG,15,34,7,18,8,16,Center,3,Jump Shot,15.147058823529411
2021-22,1628982,Melvin Frazier Jr.,SG,13,48,12,27,1,21,Center,2,Jump Shot,11.875
2005-06,2684,Melvin Sanders,SG,16,33,14,30,2,3,Center,7,Jump Shot,11.545454545454545
2003-04,2370,Mengke Bateer,C,4,7,4,7,0,0,Center,1,Jump Shot,8.857142857142858
2003-04,1897,Metta World Peace,SF,468,1112,393,870,75,242,Center,14,Jump Shot,11.194244604316546
2004-05,1897,Metta World Peace,SF,59,119,52,102,7,17,Center,1,Jump Shot,10.453781512605042
2005-06,1897,Metta World Peace,SF,350,867,272,614,78,253,Center,10,Jump Shot,13.61361014994233
2006-07,1897,Metta World Peace,SF,458,1040,365,780,93,260,Center,21,Jump Shot,12.385576923076924
2007-08,1897,Metta World Peace,SF,436,962,352,741,84,221,Center,18,Jump Shot,12.206860706860708
2008-09,1897,Metta World Peace,SF,416,1036,263,654,153,382,Center,12,Jump Shot,15.099420849420849
2009-10,1897,Metta World Peace,SF,306,740,201,444,105,296,Center,5,Jump Shot,14.078378378378378
2010-11,1897,Metta World Peace,SF,260,657,178,425,82,232,Center,8,Jump Shot,13.914764079147641
2011-12,1897,Metta World Peace,SF,182,464,127,276,55,188,Center,9,Jump Shot,14.017241379310345
2012-13,1897,Metta World Peace,SF,330,821,191,412,139,409,Center,9,Jump Shot,15.377588306942753
2013-14,1897,Metta World Peace,SF,56,141,39,87,17,54,Center,2,Jump Shot,14.24113475177305
2015-16,1897,Metta World Peace,SF,55,177,29,93,26,84,Center,4,Jump Shot,14.96045197740113
2016-17,1897,Metta World Peace,SF,19,68,10,30,9,38,Center,3,Jump Shot,19.147058823529413
2012-13,203086,Meyers Leonard,C,151,277,148,270,3,7,Center,6,Jump Shot,7.6859205776173285
2013-14,203086,Meyers Leonard,C,41,91,41,85,0,6,Center,2,Jump Shot,10.428571428571429
2014-15,203086,Meyers Leonard,C,125,245,78,133,47,112,Center,6,Jump Shot,15.277551020408163
2015-16,203086,Meyers Leonard,PF,195,434,109,207,86,227,Center,8,Jump Shot,18.043778801843317
2016-17,203086,Meyers Leonard,PF,146,378,72,165,74,213,Center,6,Jump Shot,18.447089947089946
2017-18,203086,Meyers Leonard,C,46,78,35,52,11,26,Center,6,Jump Shot,13.448717948717949
2018-19,203086,Meyers Leonard,C,132,242,82,131,50,111,Center,4,Jump Shot,14.070247933884298
2019-20,203086,Meyers Leonard,C,119,234,66,106,53,128,Center,1,Jump Shot,15.837606837606838
2020-21,203086,Meyers Leonard,C,3,7,0,0,3,7,Left Side Center,0,Jump Shot,26.714285714285715
2022-23,203086,Meyers Leonard,C,14,29,7,11,7,18,Center,2,Jump Shot,17.20689655172414
2019-20,1629662,Mfiondu Kabengele,C,14,32,5,12,9,20,Center,4,Jump Shot,17.375
2020-21,1629662,Mfiondu Kabengele,PF,33,89,20,39,13,50,Center,11,Jump Shot,15.651685393258427
2022-23,1629662,Mfiondu Kabengele,PF,2,7,2,4,0,3,Center,0,Jump Shot,12.285714285714286
2021-22,1630695,Micah Potter,C,5,11,5,9,0,2,Center,0,Putback Layup Shot,7.909090909090909
2022-23,1630695,Micah Potter,PF,10,15,6,8,4,7,Center,1,Jump Shot,13.733333333333333
2008-09,201563,Michael Beasley,PF,452,957,419,876,33,81,Center,16,Jump Shot,11.042842215256009
2009-10,201563,Michael Beasley,PF,468,1040,440,938,28,102,Center,15,Jump Shot,11.243269230769231
2010-11,201563,Michael Beasley,SF,561,1246,501,1082,60,164,Center,28,Jump Shot,12.06099518459069
2011-12,201563,Michael Beasley,SF,221,496,183,396,38,100,Center,9,Jump Shot,12.665322580645162
2012-13,201563,Michael Beasley,SF,310,766,265,622,45,144,Center,9,Jump Shot,13.04308093994778
2013-14,201563,Michael Beasley,SF,177,355,156,301,21,54,Center,12,Jump Shot,10.79718309859155
2014-15,201563,Michael Beasley,PF,92,212,84,178,8,34,Center,5,Jump Shot,12.141509433962264
2015-16,201563,Michael Beasley,PF,107,205,104,196,3,9,Center,2,Jump Shot,8.921951219512195
2016-17,201563,Michael Beasley,PF,216,406,198,363,18,43,Center,4,Jump Shot,9.75615763546798
2017-18,201563,Michael Beasley,PF,409,807,375,721,34,86,Center,13,Jump Shot,8.992565055762082
2018-19,201563,Michael Beasley,PF,75,153,72,136,3,17,Center,2,Jump Shot,7.1568627450980395
2003-04,2214,Michael Bradley,C-PF,7,15,7,15,0,0,Center,0,Jump Shot,6.866666666666666
2004-05,2214,Michael Bradley,PF,15,24,15,23,0,1,Center,4,Jump Shot,5.916666666666667
2005-06,2214,Michael Bradley,PF,32,79,31,74,1,5,Center,2,Jump Shot,8.658227848101266
2013-14,203487,Michael Carter-Williams,PG,427,1054,372,846,55,208,Center,11,Jump Shot,10.111954459203035
2014-15,203487,Michael Carter-Williams,PG,364,919,328,766,36,153,Center,16,Jump Shot,10.145810663764962
2015-16,203487,Michael Carter-Williams,PG,251,555,236,500,15,55,Center,8,Jump Shot,8.58918918918919
2016-17,203487,Michael Carter-Williams,PG,112,306,97,242,15,64,Center,7,Jump Shot,10.627450980392156
2017-18,203487,Michael Carter-Williams,PG,76,229,62,170,14,59,Center,1,Jump Shot,11.292576419213974
2018-19,203487,Michael Carter-Williams,PG,46,123,36,85,10,38,Center,3,Jump Shot,10.560975609756097
2019-20,203487,Michael Carter-Williams,SG,111,260,89,185,22,75,Center,2,Jump Shot,10.215384615384615
2020-21,203487,Michael Carter-Williams,SG,105,270,90,209,15,61,Center,8,Driving Layup Shot,9.837037037037037
2022-23,203487,Michael Carter-Williams,PG,6,14,5,11,1,3,Center,1,Driving Floating Jump Shot,9.928571428571429
2003-04,688,Michael Curry,SF,76,196,73,181,3,15,Center,0,Jump Shot,13.64795918367347
2004-05,688,Michael Curry,SF,13,29,13,29,0,0,Center,0,Jump Shot,12.862068965517242
2003-04,1720,Michael Doleac,C,140,322,140,322,0,0,Center,3,Jump Shot,11.835403726708075
2004-05,1720,Michael Doleac,C,148,331,148,329,0,2,Center,4,Jump Shot,12.438066465256798
2005-06,1720,Michael Doleac,C,37,88,37,88,0,0,Center,1,Jump Shot,11.022727272727273
2006-07,1720,Michael Doleac,C,82,175,82,174,0,1,Center,2,Jump Shot,12.108571428571429
2007-08,1720,Michael Doleac,C,28,63,28,63,0,0,Center,0,Jump Shot,12.46031746031746
2003-04,714,Michael Finley,SG,514,1159,364,789,150,370,Center,18,Jump Shot,16.638481449525454
2004-05,714,Michael Finley,SG,387,907,271,622,116,285,Center,16,Jump Shot,16.541345093715545
2005-06,714,Michael Finley,SG,286,695,176,416,110,279,Left Side,9,Jump Shot,17.755395683453237
2006-07,714,Michael Finley,SF,273,663,169,377,104,286,Left Side,5,Jump Shot,18.17948717948718
2007-08,714,Michael Finley,SG,315,761,183,404,132,357,Center,10,Jump Shot,18.822601839684626
2008-09,714,Michael Finley,SF,301,688,170,370,131,318,Center,11,Jump Shot,18.085755813953487
2009-10,714,Michael Finley,SF,81,184,49,102,32,82,Center,4,Jump Shot,18.934782608695652
2019-20,1626187,Michael Frazier II,,7,29,3,6,4,23,Right Side Center,1,Jump Shot,19.82758620689655
2016-17,1627771,Michael Gbinije,SG,1,10,1,6,0,4,Center,1,Jump Shot,13.8
2012-13,203077,Michael Kidd-Gilchrist,SF,281,613,279,604,2,9,Center,8,Jump Shot,7.557911908646004
2013-14,203077,Michael Kidd-Gilchrist,SF,167,353,166,344,1,9,Center,1,Layup Shot,6.495750708215297
2014-15,203077,Michael Kidd-Gilchrist,SF,224,482,224,482,0,0,Center,4,Jump Shot,7.549792531120332
2015-16,203077,Michael Kidd-Gilchrist,SF,33,61,30,54,3,7,Center,0,Jump Shot,6.836065573770492
2016-17,203077,Michael Kidd-Gilchrist,SF,295,618,294,609,1,9,Center,7,Jump Shot,7.768608414239482
2017-18,203077,Michael Kidd-Gilchrist,SF,282,560,282,558,0,2,Center,9,Jump Shot,8.260714285714286
2018-19,203077,Michael Kidd-Gilchrist,PF,158,332,142,285,16,47,Center,3,Jump Shot,8.484939759036145
2019-20,203077,Michael Kidd-Gilchrist,PF,22,66,17,46,5,20,Center,0,Jump Shot,12.227272727272727
2003-04,1709,Michael Olowokandi,C,121,285,121,285,0,0,Center,2,Jump Shot,7.235087719298246
2004-05,1709,Michael Olowokandi,C,161,353,161,353,0,0,Center,1,Jump Shot,6.793201133144476
2005-06,1709,Michael Olowokandi,C,107,240,107,240,0,0,Center,0,Jump Shot,6.341666666666667
2006-07,1709,Michael Olowokandi,C,19,46,19,46,0,0,Center,0,Jump Shot,5.8478260869565215
2019-20,1629008,Michael Porter Jr.,SF,195,383,133,236,62,147,Center,12,Jump Shot,13.151436031331592
2020-21,1629008,Michael Porter Jr.,SF,443,817,273,435,170,382,Center,10,Jump Shot,15.429620563035495
2021-22,1629008,Michael Porter Jr.,SF,37,103,27,55,10,48,Center,1,Jump Shot,16.75728155339806
2022-23,1629008,Michael Porter Jr.,SF,398,817,210,363,188,454,Center,6,Jump Shot,17.511627906976745
2003-04,2072,Michael Redd,SG,633,1439,506,1076,127,363,Center,40,Jump Shot,12.75677553856845
2004-05,2072,Michael Redd,SG,625,1418,521,1125,104,293,Center,39,Jump Shot,13.39703808180536
2005-06,2072,Michael Redd,SG,682,1516,519,1103,163,413,Center,30,Jump Shot,13.361477572559366
2006-07,2072,Michael Redd,SF,477,1025,360,719,117,306,Center,19,Jump Shot,12.805853658536586
2007-08,2072,Michael Redd,SG,550,1243,420,884,130,359,Center,26,Jump Shot,13.119871279163315
2008-09,2072,Michael Redd,SG,249,547,179,356,70,191,Center,6,Jump Shot,13.851919561243145
2009-10,2072,Michael Redd,SG,75,212,57,153,18,59,Center,1,Jump Shot,13.089622641509434
2010-11,2072,Michael Redd,SG,18,45,14,28,4,17,Center,1,Jump Shot,15.955555555555556
2011-12,2072,Michael Redd,SG,144,360,102,228,42,132,Center,3,Jump Shot,15.363888888888889
2003-04,1913,Michael Ruffin,PF,38,117,38,117,0,0,Center,1,Layup Shot,3.871794871794872
2004-05,1913,Michael Ruffin,C,41,99,41,98,0,1,Center,3,Layup Shot,3.0606060606060606
2005-06,1913,Michael Ruffin,C,34,77,34,75,0,2,Center,2,Tip Shot,3.064935064935065
2006-07,1913,Michael Ruffin,PF,5,18,5,18,0,0,Center,0,Layup Shot,0.8888888888888888
2007-08,1913,Michael Ruffin,C,33,62,33,62,0,0,Center,6,Layup Shot,1.2903225806451613
2008-09,1913,Michael Ruffin,PF,2,7,2,7,0,0,Center,1,Layup Shot,0.0
2003-04,1565,Michael Stewart,C-PF,5,12,5,12,0,0,Center,1,Jump Shot,4.416666666666667
2004-05,1565,Michael Stewart,PF,11,21,11,21,0,0,Center,1,Tip Shot,1.9523809523809523
2003-04,2552,Michael Sweetney,PF,69,140,69,139,0,1,Center,3,Layup Shot,5.335714285714285
2004-05,2552,Michael Sweetney,C,237,446,237,445,0,1,Center,5,Layup Shot,3.9529147982062782
2005-06,2552,Michael Sweetney,C,200,444,200,444,0,0,Center,3,Layup Shot,5.292792792792793
2006-07,2552,Michael Sweetney,C,58,134,58,134,0,0,Center,5,Layup Shot,3.014925373134328
2006-07,101153,Mickael Gelabale,SF,122,264,111,217,11,47,Center,8,Jump Shot,11.238636363636363
2007-08,101153,Mickael Gelabale,SG,69,157,53,120,16,37,Center,9,Jump Shot,13.904458598726114
2012-13,101153,Mickael Gelabale,SF,72,139,56,87,16,52,Center,7,Jump Shot,13.971223021582734
2003-04,2554,Mickael Pietrus,PG,96,231,61,126,35,105,Center,4,Jump Shot,13.606060606060606
2004-05,2554,Mickael Pietrus,SF,214,501,147,306,67,195,Center,12,Jump Shot,14.6187624750499
2005-06,2554,Mickael Pietrus,SF,169,418,113,242,56,176,Center,11,Jump Shot,14.155502392344498
2006-07,2554,Mickael Pietrus,SF,286,586,193,346,93,240,Center,14,Jump Shot,13.426621160409557
2007-08,2554,Mickael Pietrus,SF,170,387,104,204,66,183,Center,12,Jump Shot,14.89922480620155
2008-09,2554,Mickael Pietrus,SG,176,426,96,203,80,223,Center,4,Jump Shot,16.23474178403756
2009-10,2554,Mickael Pietrus,SF,233,539,117,233,116,306,Center,17,Jump Shot,18.178107606679035
2010-11,2554,Mickael Pietrus,SG-SF,143,364,58,129,85,235,Left Side,11,Jump Shot,20.145604395604394
2011-12,2554,Mickael Pietrus,SG,104,270,43,88,61,182,Left Side,3,Jump Shot,19.692592592592593
2012-13,2554,Mickael Pietrus,SF,34,98,14,34,20,64,Center,1,Jump Shot,18.46938775510204
2011-12,202148,Mickell Gladness,PF,25,59,25,59,0,0,Center,1,Jump Shot,6.203389830508475
2018-19,1628969,Mikal Bridges,SF,242,563,137,250,105,313,Center,12,Jump Shot,15.154529307282415
2019-20,1628969,Mikal Bridges,SF,247,484,177,290,70,194,Center,9,Jump Shot,12.138429752066116
2020-21,1628969,Mikal Bridges,SF,363,669,229,354,134,315,Center,8,Jump Shot,13.853512705530642
2021-22,1628969,Mikal Bridges,SF,458,858,343,546,115,312,Center,11,Jump Shot,12.820512820512821
2022-23,1628969,Mikal Bridges,SF,593,1267,424,825,169,442,Center,11,Jump Shot,13.973954222573006
2003-04,1710,Mike Bibby,PG,527,1170,379,792,148,378,Center,21,Jump Shot,14.729059829059828
2004-05,1710,Mike Bibby,PG,560,1264,429,900,131,364,Center,23,Jump Shot,15.70490506329114
2005-06,1710,Mike Bibby,PG,597,1382,405,885,192,497,Center,25,Jump Shot,17.84081041968162
2006-07,1710,Mike Bibby,PG,471,1166,298,685,173,481,Center,20,Jump Shot,18.41337907375643
2007-08,1710,Mike Bibby,PG,248,603,155,355,93,248,Center,14,Jump Shot,18.38971807628524
2008-09,1710,Mike Bibby,PG,437,1005,270,577,167,428,Center,16,Jump Shot,19.424875621890546
2009-10,1710,Mike Bibby,PG,268,643,142,320,126,323,Center,6,Jump Shot,19.674961119751167
2010-11,1710,Mike Bibby,PG,248,576,95,228,153,348,Left Side Center,11,Jump Shot,20.432291666666668
2011-12,1710,Mike Bibby,PG,35,124,8,39,27,85,Left Side Center,1,Jump Shot,21.508064516129032
2007-08,201144,Mike Conley,PG,189,442,159,351,30,91,Center,10,Jump Shot,9.81447963800905
2008-09,201144,Mike Conley,PG,323,729,235,513,88,216,Center,11,Jump Shot,12.960219478737997
2009-10,201144,Mike Conley,PG,369,830,287,618,82,212,Center,15,Jump Shot,11.971084337349398
2010-11,201144,Mike Conley,PG,423,953,343,736,80,217,Center,22,Jump Shot,11.755508919202518
2011-12,201144,Mike Conley,PG,296,684,236,525,60,159,Center,9,Jump Shot,12.691520467836257
2012-13,201144,Mike Conley,PG,414,940,308,647,106,293,Center,20,Jump Shot,12.538297872340426
2013-14,201144,Mike Conley,PG,463,1030,358,739,105,291,Center,23,Jump Shot,13.006796116504855
2014-15,201144,Mike Conley,PG,393,882,286,605,107,277,Center,27,Jump Shot,13.063492063492063
2015-16,201144,Mike Conley,PG,294,696,216,481,78,215,Center,13,Jump Shot,13.452586206896552
2016-17,201144,Mike Conley,PG,464,1009,293,590,171,419,Center,27,Jump Shot,15.762140733399406
2017-18,201144,Mike Conley,PG,64,168,40,91,24,77,Center,2,Jump Shot,14.857142857142858
2018-19,201144,Mike Conley,PG,490,1120,335,694,155,426,Center,33,Jump Shot,14.853571428571428
2019-20,201144,Mike Conley,PG,232,567,136,311,96,256,Center,5,Jump Shot,15.848324514991182
2020-21,201144,Mike Conley,PG,284,640,146,305,138,335,Center,10,Jump Shot,16.6875
2021-22,201144,Mike Conley,PG,344,791,175,377,169,414,Center,15,Jump Shot,16.571428571428573
2022-23,201144,Mike Conley,PG,261,610,126,259,135,351,Center,9,Jump Shot,17.595081967213115
2003-04,2399,Mike Dunleavy,SF,323,720,229,466,94,254,Center,14,Jump Shot,14.544444444444444
2004-05,2399,Mike Dunleavy,SF,408,905,301,629,107,276,Center,16,Jump Shot,13.919337016574586
2005-06,2399,Mike Dunleavy,SF,331,816,257,556,74,260,Center,12,Jump Shot,14.784313725490197
2006-07,2399,Mike Dunleavy,SG-PF,384,850,314,626,70,224,Center,15,Jump Shot,14.489411764705883
2007-08,2399,Mike Dunleavy,SG,532,1117,367,728,165,389,Center,10,Jump Shot,14.313339301700985
2008-09,2399,Mike Dunleavy,SG,93,232,61,142,32,90,Center,3,Jump Shot,15.844827586206897
2009-10,2399,Mike Dunleavy,SF,229,558,154,322,75,236,Center,3,Jump Shot,16.387096774193548
2010-11,2399,Mike Dunleavy,SG,240,520,138,266,102,254,Center,6,Jump Shot,17.534615384615385
2011-12,2399,Mike Dunleavy,SF,238,503,156,296,82,207,Center,6,Jump Shot,15.594433399602385
2012-13,2399,Mike Dunleavy,SF,276,624,148,325,128,299,Center,10,Jump Shot,17.221153846153847
2013-14,2399,Mike Dunleavy,SF,333,774,210,450,123,324,Center,8,Jump Shot,17.085271317829456
2014-15,2399,Mike Dunleavy,SF,209,481,102,218,107,263,Center,1,Jump Shot,17.968814968814968
2015-16,2399,Mike Dunleavy,SF,77,188,38,89,39,99,Center,2,Jump Shot,15.824468085106384
2016-17,2399,Mike Dunleavy,SF,93,219,40,86,53,133,Center,4,Jump Shot,17.831050228310502
2006-07,200837,Mike Hall,SF,1,4,1,4,0,0,Left Side,1,Jump Shot,14.0
2007-08,200839,Mike Harris,PF,27,54,27,52,0,2,Center,2,Layup Shot,5.388888888888889
2009-10,200839,Mike Harris,PF,11,30,11,29,0,1,Center,2,Jump Shot,6.433333333333334
2010-11,200839,Mike Harris,PF,3,6,3,6,0,0,Center,2,Jump Shot,8.166666666666666
2013-14,200839,Mike Harris,PF,29,61,29,59,0,2,Center,4,Jump Shot,11.78688524590164
2003-04,2229,Mike James,PG,272,657,166,376,106,281,Center,17,Jump Shot,15.791476407914764
2004-05,2229,Mike James,PG,331,751,231,492,100,259,Center,29,Jump Shot,14.733688415446071
2005-06,2229,Mike James,PG,576,1228,407,846,169,382,Center,42,Jump Shot,13.932410423452769
2006-07,2229,Mike James,PG,297,702,217,487,80,215,Center,10,Jump Shot,13.97008547008547
2007-08,2229,Mike James,PG,101,290,70,193,31,97,Center,3,Jump Shot,14.158620689655173
2008-09,2229,Mike James,PG,197,514,128,330,69,184,Center,9,Jump Shot,15.182879377431906
2009-10,2229,Mike James,PG,6,20,4,14,2,6,Center,0,Jump Shot,16.9
2011-12,2229,Mike James,PG,20,49,14,39,6,10,Center,1,Jump Shot,10.285714285714286
2012-13,2229,Mike James,PG,101,271,53,146,48,125,Center,5,Jump Shot,15.797047970479705
2013-14,2229,Mike James,PG,5,21,4,16,1,5,Center,0,Jump Shot,14.619047619047619
2017-18,1628455,Mike James,PG,123,321,97,223,26,98,Center,11,Jump Shot,13.29595015576324
2020-21,1628455,Mike James,PG,34,92,23,61,11,31,Center,1,Step Back Jump shot,14.0
2003-04,2034,Mike Miller,SF,270,616,190,401,80,215,Center,11,Jump Shot,14.685064935064934
2004-05,2034,Mike Miller,SF,387,766,247,443,140,323,Center,26,Jump Shot,15.672323759791123
2005-06,2034,Mike Miller,SG,354,760,216,421,138,339,Center,13,Jump Shot,16.67236842105263
2006-07,2034,Mike Miller,SG,465,1010,263,512,202,498,Center,22,Jump Shot,17.203960396039605
2007-08,2034,Mike Miller,SG,414,824,259,465,155,359,Center,12,Jump Shot,15.58616504854369
2008-09,2034,Mike Miller,SF,264,548,179,323,85,225,Center,10,Jump Shot,14.921532846715328
2009-10,2034,Mike Miller,SG,217,433,135,262,82,171,Center,7,Jump Shot,14.66974595842956
2010-11,2034,Mike Miller,SG,81,202,38,84,43,118,Center,4,Jump Shot,18.554455445544555
2011-12,2034,Mike Miller,SG,91,209,38,92,53,117,Right Side Center,3,Jump Shot,18.904306220095695
2012-13,2034,Mike Miller,SF,100,231,27,56,73,175,Right Side Center,4,Jump Shot,20.67965367965368
2013-14,2034,Mike Miller,SF,213,443,106,210,107,233,Center,9,Jump Shot,18.82844243792325
2014-15,2034,Mike Miller,SF,37,114,5,16,32,98,Left Side Center,1,Jump Shot,23.24561403508772
2015-16,2034,Mike Miller,SF,22,62,3,10,19,52,Right Side Center,2,Jump Shot,22.129032258064516
2016-17,2034,Mike Miller,SF,9,23,1,3,8,20,Left Side Center,2,Jump Shot,23.0
2013-14,203488,Mike Muscala,PF,31,73,31,70,0,3,Center,0,Jump Shot,10.342465753424657
2014-15,203488,Mike Muscala,PF,83,151,74,129,9,22,Center,8,Jump Shot,10.059602649006623
2015-16,203488,Mike Muscala,C,76,152,64,113,12,39,Center,9,Jump Shot,11.881578947368421
2016-17,203488,Mike Muscala,C,170,336,124,227,46,109,Center,10,Jump Shot,13.470238095238095
2017-18,203488,Mike Muscala,C,143,312,81,145,62,167,Center,5,Jump Shot,15.778846153846153
2018-19,203488,Mike Muscala,PF,145,361,56,105,89,256,Center,4,Jump Shot,19.65927977839335
2019-20,203488,Mike Muscala,C,77,189,23,46,54,143,Center,6,Jump Shot,20.38095238095238
2020-21,203488,Mike Muscala,C,119,267,51,83,68,184,Center,1,Jump Shot,19.43820224719101
2021-22,203488,Mike Muscala,C,113,248,43,85,70,163,Center,4,Jump Shot,19.10483870967742
2022-23,203488,Mike Muscala,C,131,292,50,85,81,207,Center,2,Jump Shot,20.102739726027398
2012-13,203118,Mike Scott,PF,70,147,70,146,0,1,Center,12,Jump Shot,6.605442176870748
2013-14,203118,Mike Scott,PF,301,628,239,428,62,200,Center,11,Jump Shot,12.285031847133759
2014-15,203118,Mike Scott,PF,201,453,135,261,66,192,Center,3,Jump Shot,15.189845474613687
2015-16,203118,Mike Scott,PF,176,376,114,218,62,158,Center,9,Jump Shot,13.72872340425532
2016-17,203118,Mike Scott,PF,17,59,13,32,4,27,Center,3,Jump Shot,15.627118644067796
2017-18,203118,Mike Scott,PF,276,524,210,361,66,163,Center,7,Jump Shot,14.047709923664122
2018-19,203118,Mike Scott,PF,168,420,67,168,101,252,Center,6,Jump Shot,18.05
2019-20,203118,Mike Scott,PF,149,350,69,133,80,217,Center,2,Jump Shot,17.725714285714286
2020-21,203118,Mike Scott,PF,76,211,23,56,53,155,Center,3,Jump Shot,20.492890995260662
2008-09,201446,Mike Taylor,PG,110,267,97,227,13,40,Center,6,Jump Shot,9.310861423220974
2016-17,1627861,Mike Tobey,C,1,4,1,4,0,0,Center,0,Jump Shot,5.25
2003-04,2366,Mike Wilks,PG,17,36,11,26,6,10,Center,8,Jump Shot,12.416666666666666
2004-05,2366,Mike Wilks,PG,32,77,27,61,5,16,Center,13,Jump Shot,11.428571428571429
2005-06,2366,Mike Wilks,PG,29,90,26,71,3,19,Center,7,Jump Shot,13.533333333333333
2006-07,2366,Mike Wilks,PG,66,141,61,126,5,15,Center,9,Jump Shot,12.02836879432624
2007-08,2366,Mike Wilks,PG,17,36,14,28,3,8,Center,7,Jump Shot,14.944444444444445
2009-10,2366,Mike Wilks,PG,6,12,4,9,2,3,Right Side Center,0,Jump Shot,16.416666666666668
2003-04,1630,Mikki Moore,PF-C,50,99,50,99,0,0,Center,2,Jump Shot,7.242424242424242
2004-05,1630,Mikki Moore,PF,144,287,143,282,1,5,Center,8,Jump Shot,7.2020905923344944
2005-06,1630,Mikki Moore,C,54,124,54,122,0,2,Center,4,Jump Shot,8.60483870967742
2006-07,1630,Mikki Moore,C,308,506,308,505,0,1,Center,4,Jump Shot,6.952569169960475
2007-08,1630,Mikki Moore,PF,282,489,282,487,0,2,Center,5,Jump Shot,6.361963190184049
2008-09,1630,Mikki Moore,PF-C,114,206,114,206,0,0,Center,3,Jump Shot,8.08252427184466
2009-10,1630,Mikki Moore,C,54,90,54,90,0,0,Center,2,Jump Shot,9.344444444444445
2011-12,1630,Mikki Moore,C,9,20,9,20,0,0,Center,0,Jump Shot,11.25
2006-07,101148,Mile Ilic,C,0,3,0,3,0,0,Center,0,Hook Shot,4.666666666666667
2018-19,1628970,Miles Bridges,SF,237,511,172,311,65,200,Center,10,Jump Shot,12.391389432485322
2019-20,1628970,Miles Bridges,SF,319,753,220,453,99,300,Center,13,Jump Shot,12.378486055776893
2020-21,1628970,Miles Bridges,PF,313,622,197,332,116,290,Center,15,Jump Shot,13.530546623794212
2021-22,1628970,Miles Bridges,PF,596,1214,442,749,154,465,Center,24,Jump Shot,11.93822075782537
2021-22,1630540,Miles McBride,PG,32,108,15,40,17,68,Center,4,Jump Shot,18.675925925925927
2022-23,1630540,Miles McBride,PG,77,215,37,81,40,134,Center,4,Jump Shot,18.09767441860465
2012-13,203101,Miles Plumlee,C,5,21,5,21,0,0,Center,4,Jump Shot,6.809523809523809
2013-14,203101,Miles Plumlee,C,286,553,286,553,0,0,Center,5,Hook Shot,4.039783001808318
2014-15,203101,Miles Plumlee,C,136,254,136,254,0,0,Center,3,Layup Shot,3.220472440944882
2015-16,203101,Miles Plumlee,C,140,233,140,233,0,0,Center,9,Hook Shot,2.587982832618026
2016-17,203101,Miles Plumlee,C,44,92,44,92,0,0,Center,2,Hook Shot,2.6847826086956523
2017-18,203101,Miles Plumlee,C,105,180,105,180,0,0,Center,3,Hook Shot,3.0444444444444443
2018-19,203101,Miles Plumlee,C,32,48,32,48,0,0,Center,0,Dunk Shot,2.9583333333333335
2017-18,1628462,Milos Teodosic,PG,151,360,63,128,88,232,Center,2,Jump Shot,20.7
2018-19,1628462,Milos Teodosic,PG,17,40,7,13,10,27,Center,0,Jump Shot,20.725
2003-04,1960,Milt Palacio,PG,104,298,100,272,4,26,Center,4,Jump Shot,9.503355704697986
2004-05,1960,Milt Palacio,PG,175,392,173,380,2,12,Center,11,Jump Shot,8.650510204081632
2005-06,1960,Milt Palacio,PG,171,403,170,387,1,16,Center,8,Jump Shot,7.5310173697270475
2017-18,1628495,Milton Doyle,SG,13,47,9,24,4,23,Center,2,Jump Shot,15.02127659574468
2016-17,1627851,Mindaugas Kuzminskas,SF,158,369,104,201,54,168,Center,7,Jump Shot,12.766937669376693
2017-18,1627851,Mindaugas Kuzminskas,SF,0,2,0,2,0,0,Center,0,Layup Shot,4.0
2013-14,203545,Miroslav Raduljica,C,68,126,68,126,0,0,Center,5,Layup Shot,3.484126984126984
2014-15,203545,Miroslav Raduljica,C,3,8,3,8,0,0,Center,0,Jump Shot,4.375
2012-13,203141,Mirza Teletovic,PF,71,185,34,77,37,108,Center,8,Jump Shot,18.654054054054054
2013-14,203141,Mirza Teletovic,SF,220,528,85,180,135,348,Center,9,Jump Shot,18.901515151515152
2014-15,203141,Mirza Teletovic,PF,122,319,60,126,62,193,Center,2,Jump Shot,17.454545454545453
2015-16,203141,Mirza Teletovic,PF,332,777,151,317,181,460,Center,17,Jump Shot,17.90990990990991
2016-17,203141,Mirza Teletovic,PF,156,417,52,113,104,304,Center,2,Jump Shot,20.496402877697843
2017-18,203141,Mirza Teletovic,PF,25,57,4,12,21,45,Center,0,Jump Shot,21.982456140350877
2014-15,203956,Mitch McGary,PF,88,165,88,163,0,2,Center,8,Layup Shot,5.096969696969697
2015-16,203956,Mitch McGary,PF,11,23,11,19,0,4,Center,4,Jump Shot,10.08695652173913
2003-04,348,Mitchell Butler,SG,54,124,43,94,11,30,Center,3,Jump Shot,11.975806451612904
2018-19,1628249,Mitchell Creek,SF,8,16,8,14,0,2,Center,0,Cutting Layup Shot,5.625
2018-19,1629011,Mitchell Robinson,C,202,291,202,291,0,0,Center,9,Alley Oop Dunk Shot,1.0309278350515463
2019-20,1629011,Mitchell Robinson,C,253,341,253,341,0,0,Center,13,Alley Oop Dunk Shot,0.8621700879765396
2020-21,1629011,Mitchell Robinson,C,115,176,115,176,0,0,Center,5,Alley Oop Dunk Shot,0.9204545454545454
2021-22,1629011,Mitchell Robinson,C,261,343,261,343,0,0,Center,8,Dunk Shot,0.7521865889212828
2022-23,1629011,Mitchell Robinson,C,188,280,188,280,0,0,Center,3,Tip Layup Shot,0.8357142857142857
2019-20,1629671,Miye Oni,SF,12,32,5,13,7,19,Center,2,Jump Shot,16.65625
2020-21,1629671,Miye Oni,SG,35,99,5,11,30,88,Left Side,11,Jump Shot,21.515151515151516
2021-22,1629671,Miye Oni,SG,2,9,1,1,1,8,Left Side,1,Jump Shot,21.333333333333332
2018-19,1628964,Mo Bamba,C,117,243,96,173,21,70,Center,0,Jump Shot,12.012345679012345
2019-20,1628964,Mo Bamba,C,132,286,95,179,37,107,Center,1,Jump Shot,11.877622377622378
2020-21,1628964,Mo Bamba,C,142,301,104,183,38,118,Center,7,Jump Shot,13.149501661129568
2021-22,1628964,Mo Bamba,C,296,617,189,336,107,281,Center,10,Jump Shot,13.80713128038898
2022-23,1628964,Mo Bamba,C,117,241,69,117,48,124,Center,1,Jump Shot,14.622406639004149
2003-04,2590,Mo Williams,SG,115,303,105,264,10,39,Center,10,Jump Shot,13.726072607260726
2004-05,2590,Mo Williams,PG,323,737,291,638,32,99,Center,22,Jump Shot,12.546811397557667
2005-06,2590,Mo Williams,PG,267,629,194,438,73,191,Center,13,Jump Shot,14.89825119236884
2006-07,2590,Mo Williams,PG,468,1049,389,821,79,228,Center,15,Jump Shot,14.149666348903718
2007-08,2590,Mo Williams,PG,441,919,352,688,89,231,Center,16,Jump Shot,14.897714907508162
2008-09,2590,Mo Williams,PG,526,1126,343,706,183,420,Center,18,Jump Shot,16.591474245115453
2009-10,2590,Mo Williams,PG,377,854,219,484,158,370,Center,4,Jump Shot,17.704918032786885
2010-11,2590,Mo Williams,PG,291,730,212,486,79,244,Center,15,Jump Shot,16.143835616438356
2011-12,2590,Mo Williams,SG,260,611,167,372,93,239,Center,2,Jump Shot,17.343698854337152
2012-13,2590,Mo Williams,PG,229,533,170,379,59,154,Center,9,Jump Shot,15.088180112570356
2013-14,2590,Mo Williams,PG,280,672,197,447,83,225,Center,3,Jump Shot,16.657738095238095
2014-15,2590,Mo Williams,PG,341,860,222,512,119,348,Center,21,Jump Shot,18.901162790697676
2015-16,2590,Mo Williams,PG,132,302,96,200,36,102,Center,7,Jump Shot,16.97682119205298
2005-06,101145,Monta Ellis,SG,132,318,104,236,28,82,Center,7,Jump Shot,11.022012578616351
2006-07,101145,Monta Ellis,SG,480,1010,441,867,39,143,Center,15,Jump Shot,10.14059405940594
2007-08,101145,Monta Ellis,SG,652,1227,640,1175,12,52,Center,17,Jump Shot,9.191524042379788
2008-09,101145,Monta Ellis,SG,194,430,186,404,8,26,Center,13,Jump Shot,11.390697674418604
2009-10,101145,Monta Ellis,SG,631,1406,554,1178,77,228,Center,20,Jump Shot,11.700568990042674
2010-11,101145,Monta Ellis,SG,726,1611,589,1232,137,379,Center,30,Jump Shot,13.686530105524518
2011-12,101145,Monta Ellis,SG,450,1040,388,839,62,201,Center,25,Jump Shot,12.933653846153845
2012-13,101145,Monta Ellis,SG,597,1436,503,1108,94,328,Center,27,Jump Shot,12.525766016713092
2013-14,101145,Monta Ellis,SG,576,1278,507,1069,69,209,Center,25,Jump Shot,11.336463223787167
2014-15,101145,Monta Ellis,SG,602,1354,521,1070,81,284,Center,32,Jump Shot,13.11152141802068
2015-16,101145,Monta Ellis,SG,433,1015,349,739,84,276,Center,16,Jump Shot,14.355665024630541
2016-17,101145,Monta Ellis,SG,245,555,204,422,41,133,Center,7,Jump Shot,12.834234234234234
2017-18,1628420,Monte Morris,PG,4,6,4,5,0,1,Center,1,Driving Layup Shot,6.5
2018-19,1628420,Monte Morris,PG,346,702,252,475,94,227,Center,10,Jump Shot,13.467236467236468
2019-20,1628420,Monte Morris,PG,260,566,195,394,65,172,Center,7,Jump Shot,13.469964664310954
2020-21,1628420,Monte Morris,PG,186,387,135,253,51,134,Center,5,Jump Shot,13.478036175710594
2021-22,1628420,Monte Morris,PG,374,773,250,459,124,314,Center,14,Jump Shot,15.641655886157826
2022-23,1628420,Monte Morris,PG,247,515,169,311,78,204,Center,6,Jump Shot,15.500970873786407
2015-16,1626149,Montrezl Harrell,PF,58,90,58,89,0,1,Center,4,Dunk Shot,3.433333333333333
2016-17,1626149,Montrezl Harrell,C,225,344,224,338,1,6,Center,19,Jump Shot,3.4069767441860463
2017-18,1626149,Montrezl Harrell,C,348,548,347,541,1,7,Center,5,Layup Shot,3.510948905109489
2018-19,1626149,Montrezl Harrell,C,546,888,543,871,3,17,Center,16,Layup Shot,3.39527027027027
2019-20,1626149,Montrezl Harrell,C,471,812,471,794,0,18,Center,13,Driving Layup Shot,3.666256157635468
2020-21,1626149,Montrezl Harrell,C,375,603,375,593,0,10,Center,7,Layup Shot,4.24212271973466
2021-22,1626149,Montrezl Harrell,C,358,555,354,538,4,17,Center,16,Layup Shot,4.317117117117117
2022-23,1626149,Montrezl Harrell,C,125,209,125,203,0,6,Center,8,Layup Shot,3.54066985645933
2003-04,983,Moochie Norris,PG,80,217,60,159,20,58,Center,6,Jump Shot,14.373271889400922
2004-05,983,Moochie Norris,PG,35,109,35,97,0,12,Center,3,Jump Shot,13.596330275229358
2005-06,983,Moochie Norris,PG,46,112,42,98,4,14,Center,8,Jump Shot,12.857142857142858
2018-19,1629021,Moritz Wagner,C,71,171,49,94,22,77,Center,5,Jump Shot,13.23391812865497
2019-20,1629021,Moritz Wagner,C,145,266,120,186,25,80,Center,10,Jump Shot,9.109022556390977
2020-21,1629021,Moritz Wagner,C,104,229,73,138,31,91,Center,3,Jump Shot,12.052401746724891
2021-22,1629021,Moritz Wagner,C,197,396,131,195,66,201,Center,10,Jump Shot,13.946969696969697
2022-23,1629021,Moritz Wagner,C,198,396,147,233,51,163,Center,8,Jump Shot,11.724747474747474
2007-08,201165,Morris Almond,SG,4,15,3,11,1,4,Right Side,2,Jump Shot,14.733333333333333
2008-09,201165,Morris Almond,SG,33,81,28,64,5,17,Center,4,Jump Shot,11.234567901234568
2011-12,201165,Morris Almond,SG,6,17,5,14,1,3,Center,0,Jump Shot,15.411764705882353
2003-04,2050,Morris Peterson,SF,238,587,112,247,126,340,Center,12,Jump Shot,17.603066439522998
2004-05,2050,Morris Peterson,SG,356,848,227,513,129,335,Center,14,Jump Shot,14.27004716981132
2005-06,2050,Morris Peterson,SG,478,1096,301,648,177,448,Center,25,Jump Shot,15.683394160583942
2006-07,2050,Morris Peterson,SF,222,517,116,222,106,295,Center,13,Jump Shot,17.392649903288202
2007-08,2050,Morris Peterson,SG,215,516,102,229,113,287,Center,7,Jump Shot,17.09108527131783
2008-09,2050,Morris Peterson,SG,73,183,40,98,33,85,Center,3,Jump Shot,17.584699453551913
2009-10,2050,Morris Peterson,SG,116,301,54,130,62,171,Center,1,Jump Shot,17.920265780730897
2010-11,2050,Morris Peterson,SG,2,5,2,4,0,1,Left Side,0,Jump Shot,14.2
2019-20,1629650,Moses Brown,C,4,10,4,10,0,0,Center,2,Hook Shot,1.5
2020-21,1629650,Moses Brown,C,146,268,146,268,0,0,Center,11,Tip Layup Shot,1.7686567164179106
2021-22,1629650,Moses Brown,C,64,108,64,108,0,0,Center,5,Cutting Dunk Shot,2.037037037037037
2022-23,1629650,Moses Brown,C,61,96,61,96,0,0,Center,9,Dunk Shot,1.6875
2021-22,1630541,Moses Moody,SG,80,183,40,73,40,110,Center,9,Jump Shot,17.016393442622952
2022-23,1630541,Moses Moody,SG,108,227,59,92,49,135,Center,15,Jump Shot,16.568281938325992
2021-22,1630589,Moses Wright,PF,1,4,1,3,0,1,Center,0,Jump Shot,12.75
2006-07,200754,Mouhamed Sene,C,18,49,18,49,0,0,Center,5,Jump Shot,6.204081632653061
2007-08,200754,Mouhamed Sene,C,11,24,11,24,0,0,Center,5,Layup Shot,3.5416666666666665
2008-09,200754,Mouhamed Sene,C,6,9,6,9,0,0,Center,2,Slam Dunk Shot,5.0
2022-23,1631217,Moussa Diabate,PF,24,47,23,45,1,2,Center,7,Layup Shot,3.5319148936170213
2010-11,201203,Mustafa Shakur,PG,21,59,20,49,1,10,Center,4,Jump Shot,12.016949152542374
2013-14,201203,Mustafa Shakur,PG,0,3,0,2,0,1,Center,0,Jump Shot,15.0
2019-20,1628539,Mychal Mulder,SF,26,67,10,15,16,52,Center,0,Jump Shot,20.71641791044776
2020-21,1628539,Mychal Mulder,PG,119,265,34,51,85,214,Right Side Center,11,Jump Shot,20.535849056603773
2021-22,1628539,Mychal Mulder,PG,24,77,7,23,17,54,Center,4,Jump Shot,19.233766233766232
2011-12,202814,Mychel Thompson,SG,7,24,3,13,4,11,Left Side,0,Jump Shot,18.25
2017-18,1627988,Myke Henry,SF,41,109,22,51,19,58,Center,0,Jump Shot,15.302752293577981
2021-22,1629619,Myles Powell,PG,5,17,4,11,1,6,Center,3,Pullup Jump shot,13.058823529411764
2015-16,1626167,Myles Turner,C,264,530,261,516,3,14,Center,12,Jump Shot,10.775471698113208
2016-17,1626167,Myles Turner,C,444,869,404,754,40,115,Center,14,Jump Shot,11.537399309551208
2017-18,1626167,Myles Turner,C,306,639,250,482,56,157,Center,7,Jump Shot,14.071987480438185
2018-19,1626167,Myles Turner,C,380,780,304,584,76,196,Center,11,Jump Shot,13.371794871794872
2019-20,1626167,Myles Turner,C,268,587,182,337,86,250,Center,2,Jump Shot,14.99488926746167
2020-21,1626167,Myles Turner,C,206,432,137,226,69,206,Center,7,Jump Shot,13.761574074074074
2021-22,1626167,Myles Turner,C,200,393,139,210,61,183,Center,3,Jump Shot,14.274809160305344
2022-23,1626167,Myles Turner,C,402,733,309,484,93,249,Center,9,Jump Shot,11.826739427012278
2020-21,1630230,Naji Marshall,SF,82,209,53,126,29,83,Center,2,Jump Shot,12.655502392344498
2021-22,1630230,Naji Marshall,SF,109,269,88,164,21,105,Center,16,Jump Shot,12.256505576208179
2022-23,1630230,Naji Marshall,SF,247,571,181,353,66,218,Center,13,Jump Shot,12.82661996497373
2012-13,201986,Nando De Colo,SG,105,241,74,159,31,82,Center,11,Jump Shot,13.746887966804978
2013-14,201986,Nando De Colo,SF,64,153,46,100,18,53,Center,6,Jump Shot,14.032679738562091
2019-20,1629642,Nassir Little,PF,65,151,51,92,14,59,Center,6,Jump Shot,11.112582781456954
2020-21,1629642,Nassir Little,PF,78,167,50,87,28,80,Center,8,Jump Shot,15.1437125748503
2021-22,1629642,Nassir Little,SF,145,315,94,161,51,154,Center,7,Jump Shot,14.431746031746032
2022-23,1629642,Nassir Little,SF,134,303,76,145,58,158,Center,5,Jump Shot,16.656765676567655
2020-21,1630268,Nate Darling,SG,2,7,0,0,2,7,Left Side Center,1,Jump Shot,25.285714285714285
2020-21,1630207,Nate Hinton,SG,15,42,11,23,4,19,Center,7,Jump Shot,17.023809523809526
2021-22,1630207,Nate Hinton,SG,0,1,0,1,0,0,Center,0,Driving Floating Jump Shot,8.0
2005-06,101126,Nate Robinson,PG,230,565,172,419,58,146,Center,13,Jump Shot,12.633628318584071
2006-07,101126,Nate Robinson,PG,227,523,144,310,83,213,Center,19,Jump Shot,14.564053537284895
2007-08,101126,Nate Robinson,PG,331,782,234,490,97,292,Center,32,Jump Shot,15.451406649616368
2008-09,101126,Nate Robinson,PG,449,1028,324,643,125,385,Center,19,Jump Shot,13.914396887159533
2009-10,101126,Nate Robinson,PG,215,493,128,270,87,223,Center,20,Jump Shot,16.582150101419877
2010-11,101126,Nate Robinson,PG,150,376,85,176,65,200,Center,4,Jump Shot,18.279255319148938
2011-12,101126,Nate Robinson,PG,205,484,139,303,66,181,Center,8,Jump Shot,15.964876033057852
2012-13,101126,Nate Robinson,PG,399,921,258,573,141,348,Center,18,Jump Shot,15.530944625407166
2013-14,101126,Nate Robinson,PG,164,383,106,229,58,154,Center,9,Jump Shot,15.4177545691906
2014-15,101126,Nate Robinson,PG,88,255,57,143,31,112,Center,4,Jump Shot,16.70980392156863
2015-16,101126,Nate Robinson,PG,0,1,0,0,0,1,Center,0,Jump Shot,24.0
2013-14,203489,Nate Wolters,PG,170,389,152,327,18,62,Center,9,Jump Shot,9.67866323907455
2014-15,203489,Nate Wolters,PG,20,57,20,50,0,7,Center,1,Jump Shot,8.087719298245615
2017-18,203489,Nate Wolters,PG,1,6,1,6,0,0,Center,1,Floating Jump shot,9.666666666666666
2008-09,201605,Nathan Jawai,PF,1,4,1,4,0,0,Center,1,Turnaround Jump Shot,3.25
2009-10,201605,Nathan Jawai,C,49,111,49,110,0,1,Center,1,Layup Shot,3.6036036036036037
2020-21,1630233,Nathan Knight,PF,37,100,31,67,6,33,Center,8,Jump Shot,9.65
2021-22,1630233,Nathan Knight,PF,45,88,41,75,4,13,Center,9,Driving Layup Shot,5.193181818181818
2022-23,1630233,Nathan Knight,PF,46,81,38,59,8,22,Center,8,Jump Shot,8.308641975308642
2017-18,1628513,Naz Mitrou-Long,SG,1,1,0,0,1,1,Center,0,Jump Shot,25.0
2018-19,1628513,Naz Mitrou-Long,SG,6,20,4,9,2,11,Center,1,Jump Shot,14.8
2019-20,1628513,Naz Mitrou-Long,SG,6,17,4,5,2,12,Center,1,Jump Shot,21.352941176470587
2019-20,1629675,Naz Reid,C,100,243,68,146,32,97,Center,4,Jump Shot,11.707818930041153
2020-21,1629675,Naz Reid,C,304,581,243,407,61,174,Center,10,Jump Shot,9.485370051635112
2021-22,1629675,Naz Reid,C,233,476,176,310,57,166,Center,10,Jump Shot,10.163865546218487
2022-23,1629675,Naz Reid,C,310,577,235,360,75,217,Center,5,Jump Shot,11.353552859618718
2003-04,1737,Nazr Mohammed,C,246,472,246,472,0,0,Center,11,Jump Shot,5.078389830508475
2004-05,1737,Nazr Mohammed,C,289,602,289,601,0,1,Center,12,Jump Shot,4.239202657807309
2005-06,1737,Nazr Mohammed,C,190,377,190,377,0,0,Center,8,Layup Shot,4.1936339522546415
2006-07,1737,Nazr Mohammed,C,118,222,118,222,0,0,Center,4,Jump Shot,5.171171171171171
2007-08,1737,Nazr Mohammed,C,272,528,272,527,0,1,Center,6,Jump Shot,6.8143939393939394
2008-09,1737,Nazr Mohammed,C,41,101,41,101,0,0,Center,0,Jump Shot,6.118811881188119
2009-10,1737,Nazr Mohammed,C,189,342,189,342,0,0,Center,5,Layup Shot,4.590643274853801
2010-11,1737,Nazr Mohammed,C,234,448,234,447,0,1,Center,4,Jump Shot,5.955357142857143
2011-12,1737,Nazr Mohammed,C,79,169,79,168,0,1,Center,0,Jump Shot,6.6390532544378695
2012-13,1737,Nazr Mohammed,C,66,180,66,178,0,2,Center,4,Jump Shot,7.233333333333333
2013-14,1737,Nazr Mohammed,C,54,126,54,126,0,0,Center,6,Jump Shot,7.031746031746032
2014-15,1737,Nazr Mohammed,C,13,30,13,30,0,0,Center,4,Jump Shot,7.333333333333333
2015-16,1737,Nazr Mohammed,C,3,5,3,5,0,0,Center,2,Jump Shot,10.0
2003-04,2569,Ndudi Ebi,SF,6,14,6,14,0,0,Center,6,Jump Shot,8.357142857142858
2004-05,2569,Ndudi Ebi,SG,11,21,11,20,0,1,Center,1,Jump Shot,6.9523809523809526
2021-22,1629674,Neemias Queta,C,17,38,17,38,0,0,Center,2,Jump Shot,5.026315789473684
2022-23,1629674,Neemias Queta,C,6,9,6,9,0,0,Center,0,Putback Layup Shot,2.6666666666666665
2015-16,202357,Nemanja Bjelica,PF,110,235,62,110,48,125,Center,3,Jump Shot,15.038297872340426
2016-17,202357,Nemanja Bjelica,PF,151,356,95,179,56,177,Center,9,Jump Shot,14.308988764044944
2017-18,202357,Nemanja Bjelica,PF,171,371,95,188,76,183,Center,5,Jump Shot,14.382749326145552
2018-19,202357,Nemanja Bjelica,PF,284,593,181,336,103,257,Center,2,Jump Shot,13.050590219224283
2019-20,202357,Nemanja Bjelica,PF,314,653,180,333,134,320,Center,9,Jump Shot,14.856049004594182
2020-21,202357,Nemanja Bjelica,PF,89,196,62,111,27,85,Center,6,Jump Shot,13.21938775510204
2021-22,202357,Nemanja Bjelica,C,160,342,106,193,54,149,Center,1,Jump Shot,13.707602339181287
2013-14,203517,Nemanja Nedovic,SG,8,39,5,21,3,18,Center,3,Jump Shot,17.23076923076923
2004-05,2420,Nenad Krstic,PF,281,570,281,568,0,2,Center,9,Layup Shot,5.571929824561403
2005-06,2420,Nenad Krstic,PF,447,881,446,877,1,4,Center,6,Jump Shot,7.994324631101022
2006-07,2420,Nenad Krstic,C,170,323,170,322,0,1,Center,7,Jump Shot,8.405572755417957
2007-08,2420,Nenad Krstic,C,123,300,123,298,0,2,Center,1,Jump Shot,12.036666666666667
2008-09,2420,Nenad Krstic,C,191,407,191,407,0,0,Center,6,Jump Shot,11.535626535626536
2009-10,2420,Nenad Krstic,C,281,560,280,555,1,5,Center,5,Jump Shot,10.994642857142857
2010-11,2420,Nenad Krstic,C,231,452,231,452,0,0,Center,4,Jump Shot,9.070796460176991
2003-04,2403,Nene,PF,334,630,334,628,0,2,Center,9,Jump Shot,4.660317460317461
2004-05,2403,Nene,C,194,386,194,384,0,2,Center,6,Layup Shot,4.860103626943006
2005-06,2403,Nene,PF,0,1,0,1,0,0,Center,0,Jump Shot,3.0
2006-07,2403,Nene,C,294,516,294,515,0,1,Center,7,Layup Shot,3.641472868217054
2007-08,2403,Nene,PF,29,71,29,70,0,1,Center,1,Layup Shot,5.47887323943662
2008-09,2403,Nene,C,428,709,427,704,1,5,Center,11,Layup Shot,4.820874471086037
2009-10,2403,Nene,C,421,717,421,715,0,2,Center,6,Layup Shot,4.2594142259414225
2010-11,2403,Nene,C,402,654,401,649,1,5,Center,10,Layup Shot,4.490825688073395
2011-12,2403,Nene,C,211,393,211,389,0,4,Center,12,Jump Shot,6.506361323155216
2012-13,2403,Nene,PF,285,594,285,593,0,1,Center,6,Jump Shot,7.242424242424242
2013-14,2403,Nene,PF,299,594,298,589,1,5,Center,12,Jump Shot,8.018518518518519
2014-15,2403,Nene,PF,307,601,306,596,1,5,Center,9,Jump Shot,7.75540765391015
2015-16,2403,Nene,PF,209,384,209,381,0,3,Center,3,Jump Shot,6.854166666666667
2016-17,2403,Nene,C,245,397,242,388,3,9,Center,6,Jump Shot,5.085642317380352
2017-18,2403,Nene,C,136,239,136,237,0,2,Center,0,Layup Shot,4.2384937238493725
2018-19,2403,Nene,C,60,116,60,113,0,3,Center,0,Jump Shot,7.301724137931035
2014-15,203457,Nerlens Noel,C,302,653,302,653,0,0,Center,13,Jump Shot,5.0826952526799385
2015-16,203457,Nerlens Noel,C,306,587,305,585,1,2,Center,12,Jump Shot,5.098807495741056
2016-17,203457,Nerlens Noel,C,184,309,184,308,0,1,Center,5,Jump Shot,4.504854368932039
2017-18,203457,Nerlens Noel,C,55,105,55,104,0,1,Center,2,Alley Oop Dunk Shot,4.333333333333333
2018-19,203457,Nerlens Noel,C,162,276,162,276,0,0,Center,4,Jump Shot,4.242753623188406
2019-20,203457,Nerlens Noel,C,184,269,183,266,1,3,Center,3,Alley Oop Dunk Shot,4.5762081784386615
2020-21,203457,Nerlens Noel,C,137,223,137,220,0,3,Center,5,Alley Oop Dunk Shot,3.295964125560538
2021-22,203457,Nerlens Noel,C,32,60,32,57,0,3,Center,0,Jump Shot,5.483333333333333
2022-23,203457,Nerlens Noel,C,13,36,12,34,1,2,Center,0,Jump Shot,9.333333333333334
2019-20,1629651,Nic Claxton,C,27,48,26,41,1,7,Center,2,Jump Shot,5.833333333333333
2020-21,1629651,Nic Claxton,C,90,145,89,140,1,5,Center,2,Alley Oop Dunk Shot,3.0827586206896553
2021-22,1629651,Nic Claxton,C,178,264,178,264,0,0,Center,5,Cutting Dunk Shot,2.0643939393939394
2022-23,1629651,Nic Claxton,C,414,587,414,585,0,2,Center,7,Alley Oop Dunk Shot,2.2844974446337307
2013-14,201979,Nick Calathes,SG,142,311,123,250,19,61,Center,3,Jump Shot,10.196141479099678
2014-15,201979,Nick Calathes,SG,104,247,93,204,11,43,Center,2,Jump Shot,9.024291497975709
2004-05,2555,Nick Collison,C,189,353,189,350,0,3,Center,16,Layup Shot,3.056657223796034
2005-06,2555,Nick Collison,PF,207,394,207,391,0,3,Center,6,Jump Shot,6.403553299492386
2006-07,2555,Nick Collison,C,318,636,318,634,0,2,Center,7,Jump Shot,4.913522012578617
2007-08,2555,Nick Collison,PF,322,641,322,639,0,2,Center,5,Jump Shot,7.210608424336973
2008-09,2555,Nick Collison,C,243,428,243,426,0,2,Center,12,Jump Shot,5.119158878504673
2009-10,2555,Nick Collison,C,182,309,181,305,1,4,Center,4,Layup Shot,4.624595469255663
2010-11,2555,Nick Collison,C,137,242,137,242,0,0,Center,2,Jump Shot,5.090909090909091
2011-12,2555,Nick Collison,PF,120,201,120,200,0,1,Center,0,Jump Shot,5.248756218905473
2012-13,2555,Nick Collison,C,176,296,176,292,0,4,Center,1,Jump Shot,6.45945945945946
2013-14,2555,Nick Collison,PF,134,240,130,224,4,16,Center,0,Jump Shot,6.8125
2014-15,2555,Nick Collison,PF,106,253,90,193,16,60,Center,2,Jump Shot,10.909090909090908
2015-16,2555,Nick Collison,PF,50,109,50,107,0,2,Center,1,Layup Shot,4.963302752293578
2016-17,2555,Nick Collison,PF,14,23,14,22,0,1,Center,3,Floating Jump shot,4.782608695652174
2017-18,2555,Nick Collison,PF,13,19,13,19,0,0,Center,1,Cutting Layup Shot,2.8947368421052633
2007-08,201174,Nick Fazekas,PF,46,82,46,80,0,2,Center,11,Layup Shot,4.902439024390244
2014-15,203910,Nick Johnson,SG,26,75,21,54,5,21,Center,6,Jump Shot,9.693333333333333
2020-21,1630208,Nick Richards,PF,4,9,4,8,0,1,Center,1,Layup Shot,4.555555555555555
2021-22,1630208,Nick Richards,C,60,90,60,90,0,0,Center,9,Layup Shot,2.2888888888888888
2022-23,1630208,Nick Richards,C,197,313,196,312,1,1,Center,4,Cutting Dunk Shot,2.159744408945687
2003-04,89,Nick Van Exel,PG,187,479,141,329,46,150,Center,10,Jump Shot,14.24634655532359
2004-05,89,Nick Van Exel,SG,214,561,114,304,100,257,Center,9,Jump Shot,16.5650623885918
2005-06,89,Nick Van Exel,PG,136,343,81,189,55,154,Center,1,Jump Shot,16.897959183673468
2007-08,201156,Nick Young,SG,210,478,170,378,40,100,Center,11,Jump Shot,13.42468619246862
2008-09,201156,Nick Young,SG,336,756,280,592,56,164,Center,21,Jump Shot,14.472222222222221
2009-10,201156,Nick Young,SG,233,558,164,388,69,170,Center,10,Jump Shot,15.736559139784946
2010-11,201156,Nick Young,SG,412,935,307,664,105,271,Center,14,Jump Shot,16.235294117647058
2011-12,201156,Nick Young,SG,316,784,213,502,103,282,Center,20,Jump Shot,16.818877551020407
2012-13,201156,Nick Young,SG,224,542,149,332,75,210,Center,9,Jump Shot,16.881918819188193
2013-14,201156,Nick Young,SG,387,889,252,539,135,350,Center,18,Jump Shot,16.319460067491562
2014-15,201156,Nick Young,SG,174,476,91,251,83,225,Center,5,Jump Shot,18.17016806722689
2015-16,201156,Nick Young,SG,126,369,49,135,77,234,Left Side Center,3,Jump Shot,20.902439024390244
2016-17,201156,Nick Young,SG,267,624,102,212,165,412,Center,7,Jump Shot,20.205128205128204
2017-18,201156,Nick Young,SG,201,488,78,162,123,326,Center,19,Jump Shot,20.633196721311474
2018-19,201156,Nick Young,SG,3,9,0,1,3,8,Left Side Center,0,Jump Shot,22.77777777777778
2019-20,1629638,Nickeil Alexander-Walker,SG,98,266,52,133,46,133,Center,7,Jump Shot,15.357142857142858
2020-21,1629638,Nickeil Alexander-Walker,SG,192,458,116,239,76,219,Center,9,Jump Shot,15.043668122270743
2021-22,1629638,Nickeil Alexander-Walker,SG,253,680,148,342,105,338,Center,8,Jump Shot,15.305882352941177
2022-23,1629638,Nickeil Alexander-Walker,SG,131,295,70,136,61,159,Center,3,Jump Shot,16.406779661016948
2020-21,1630185,Nico Mannion,PG,39,114,17,54,22,60,Center,4,Jump Shot,17.763157894736842
2008-09,201587,Nicolas Batum,SF,161,361,99,193,62,168,Center,7,Jump Shot,13.952908587257618
2009-10,201587,Nicolas Batum,SF,139,268,85,136,54,132,Center,6,Jump Shot,15.041044776119403
2010-11,201587,Nicolas Batum,SF,367,807,249,465,118,342,Center,13,Jump Shot,14.680297397769516
2011-12,201587,Nicolas Batum,SF,289,641,182,367,107,274,Center,6,Jump Shot,14.263650546021841
2012-13,201587,Nicolas Batum,SF,352,832,187,389,165,443,Center,12,Jump Shot,17.29326923076923
2013-14,201587,Nicolas Batum,SF,381,819,236,417,145,402,Center,14,Jump Shot,16.426129426129425
2014-15,201587,Nicolas Batum,SF,239,599,140,291,99,308,Center,7,Jump Shot,17.425709515859765
2015-16,201587,Nicolas Batum,SF,372,873,233,474,139,399,Center,6,Jump Shot,17.27262313860252
2016-17,201587,Nicolas Batum,SG,393,975,258,570,135,405,Center,11,Jump Shot,16.787692307692307
2017-18,201587,Nicolas Batum,SG,270,650,178,376,92,274,Center,7,Jump Shot,17.50769230769231
2018-19,201587,Nicolas Batum,SF,253,562,137,264,116,298,Center,9,Jump Shot,16.6423487544484
2019-20,201587,Nicolas Batum,SF,28,81,14,32,14,49,Center,0,Jump Shot,17.617283950617285
2020-21,201587,Nicolas Batum,SF,191,412,81,140,110,272,Center,6,Jump Shot,18.59223300970874
2021-22,201587,Nicolas Batum,PF,179,387,71,117,108,270,Center,6,Jump Shot,19.702842377260982
2022-23,201587,Nicolas Batum,PF,160,381,36,64,124,317,Left Side Center,8,Jump Shot,21.118110236220474
2016-17,1627852,Nicolas Brussino,SG,52,141,23,46,29,95,Left Side Center,10,Jump Shot,20.51063829787234
2017-18,1627852,Nicolas Brussino,SF,0,2,0,0,0,2,Right Side Center,0,Jump Shot,23.5
2016-17,1627879,Nicolas Laprovittola,PG,20,47,10,20,10,27,Center,0,Jump Shot,15.787234042553191
2019-20,1629740,Nicolo Melli,C,136,323,67,117,69,206,Center,7,Jump Shot,18.656346749226007
2020-21,1629740,Nicolo Melli,PF,46,141,23,56,23,85,Center,3,Jump Shot,17.879432624113477
2017-18,1628502,Nigel Hayes,SF,11,33,7,17,4,16,Left Side,1,Jump Shot,17.424242424242426
2019-20,1628430,Nigel Williams-Goss,PG,5,16,3,9,2,7,Center,0,Jump Shot,15.125
2014-15,203917,Nik Stauskas,SG,108,296,60,147,48,149,Center,9,Jump Shot,17.097972972972972
2015-16,203917,Nik Stauskas,SG,210,545,104,220,106,325,Center,12,Jump Shot,16.811009174311927
2016-17,203917,Nik Stauskas,SG,250,630,119,275,131,355,Center,11,Jump Shot,16.68888888888889
2017-18,203917,Nik Stauskas,SG,60,154,20,54,40,100,Center,3,Jump Shot,18.935064935064936
2018-19,203917,Nik Stauskas,SG,136,338,66,150,70,188,Center,5,Jump Shot,17.24852071005917
2021-22,203917,Nik Stauskas,SG,5,14,1,4,4,10,Right Side,1,Jump Shot,20.285714285714285
2015-16,203999,Nikola Jokic,C,307,600,279,516,28,84,Center,10,Jump Shot,7.658333333333333
2016-17,203999,Nikola Jokic,C,494,854,449,715,45,139,Center,20,Jump Shot,8.973067915690866
2017-18,203999,Nikola Jokic,C,504,1010,393,730,111,280,Center,12,Jump Shot,11.941584158415841
2018-19,203999,Nikola Jokic,C,616,1206,533,936,83,270,Center,25,Jump Shot,9.927031509121061
2019-20,203999,Nikola Jokic,C,565,1071,485,816,80,255,Center,26,Jump Shot,11.543417366946779
2020-21,203999,Nikola Jokic,C,732,1293,640,1056,92,237,Center,26,Jump Shot,10.093580819798918
2021-22,203999,Nikola Jokic,C,764,1311,667,1023,97,288,Center,28,Jump Shot,9.735316552250191
2022-23,203999,Nikola Jokic,C,646,1022,589,873,57,149,Center,17,Jump Shot,8.164383561643836
2022-23,1631107,Nikola Jovic,PF,28,69,20,34,8,35,Center,2,Jump Shot,15.797101449275363
2014-15,202703,Nikola Mirotic,PF,253,624,154,311,99,313,Center,11,Jump Shot,15.554487179487179
2015-16,202703,Nikola Mirotic,PF,248,609,113,263,135,346,Center,5,Jump Shot,17.288998357963877
2016-17,202703,Nikola Mirotic,PF,258,623,129,248,129,375,Center,9,Jump Shot,17.43338683788122
2017-18,202703,Nikola Mirotic,PF,306,684,171,326,135,358,Center,10,Jump Shot,16.795321637426902
2018-19,202703,Nikola Mirotic,PF,238,542,122,224,116,318,Center,9,Jump Shot,17.933579335793358
2010-11,201593,Nikola Pekovic,C,136,263,136,263,0,0,Center,2,Layup Shot,3.3612167300380227
2011-12,201593,Nikola Pekovic,C,256,454,256,454,0,0,Center,13,Layup Shot,2.33920704845815
2012-13,201593,Nikola Pekovic,C,385,741,385,741,0,0,Center,16,Layup Shot,3.0944669365721995
2013-14,201593,Nikola Pekovic,C,379,701,379,701,0,0,Center,9,Layup Shot,3.420827389443652
2014-15,201593,Nikola Pekovic,C,139,328,139,328,0,0,Center,4,Layup Shot,3.7439024390243905
2015-16,201593,Nikola Pekovic,C,19,50,19,50,0,0,Center,0,Layup Shot,4.52
2011-12,202696,Nikola Vucevic,C,131,291,128,283,3,8,Center,5,Jump Shot,8.75257731958763
2012-13,202696,Nikola Vucevic,C,461,889,461,886,0,3,Center,14,Jump Shot,7.428571428571429
2013-14,202696,Nikola Vucevic,C,353,696,353,696,0,0,Center,7,Jump Shot,7.885057471264368
2014-15,202696,Nikola Vucevic,C,631,1206,629,1200,2,6,Center,27,Jump Shot,8.593698175787727
2015-16,202696,Nikola Vucevic,C,533,1046,531,1037,2,9,Center,16,Jump Shot,9.776290630975144
2016-17,202696,Nikola Vucevic,C,483,1031,460,956,23,75,Center,10,Jump Shot,10.864209505334626
2017-18,202696,Nikola Vucevic,C,399,840,335,636,64,204,Center,10,Jump Shot,12.786904761904761
2018-19,202696,Nikola Vucevic,C,701,1354,617,1123,84,231,Center,19,Jump Shot,10.384047267355982
2019-20,202696,Nikola Vucevic,C,493,1033,395,744,98,289,Center,14,Jump Shot,11.985479186834462
2020-21,202696,Nikola Vucevic,C,666,1396,490,956,176,440,Center,25,Jump Shot,14.050859598853869
2021-22,202696,Nikola Vucevic,C,546,1154,442,823,104,331,Center,11,Jump Shot,12.493934142114385
2022-23,202696,Nikola Vucevic,C,597,1148,476,801,121,347,Center,16,Jump Shot,12.313588850174217
2003-04,2401,Nikoloz Tskitishvili,PF,40,122,37,111,3,11,Center,9,Jump Shot,14.008196721311476
2004-05,2401,Nikoloz Tskitishvili,PF,22,74,20,57,2,17,Center,2,Jump Shot,15.14864864864865
2005-06,2401,Nikoloz Tskitishvili,SF-PF,13,37,12,34,1,3,Center,4,Jump Shot,11.432432432432432
2014-15,203943,Noah Vonleh,PF,30,76,25,63,5,13,Center,3,Jump Shot,8.118421052631579
2015-16,203943,Noah Vonleh,PF,117,278,106,232,11,46,Center,2,Jump Shot,9.161870503597122
2016-17,203943,Noah Vonleh,PF,129,269,123,250,6,19,Center,10,Jump Shot,6.698884758364312
2017-18,203943,Noah Vonleh,PF,104,234,84,168,20,66,Center,6,Jump Shot,11.311965811965813
2018-19,203943,Noah Vonleh,PF,207,440,161,303,46,137,Center,8,Jump Shot,10.472727272727273
2019-20,203943,Noah Vonleh,C,52,92,49,77,3,15,Center,3,Hook Shot,6.282608695652174
2020-21,203943,Noah Vonleh,PF,0,3,0,1,0,2,Center,0,Step Back Jump shot,18.333333333333332
2022-23,203943,Noah Vonleh,C,11,24,10,20,1,4,Center,1,Layup Shot,6.541666666666667
2005-06,101230,Noel Felix,SF,6,25,5,22,1,3,Center,2,Jump Shot,12.6
2011-12,202701,Nolan Smith,PG,67,180,54,135,13,45,Center,12,Jump Shot,12.9
2012-13,202701,Nolan Smith,PG,42,114,36,86,6,28,Center,14,Jump Shot,13.149122807017545
2015-16,1626181,Norman Powell,SG,97,228,61,140,36,88,Center,12,Jump Shot,13.736842105263158
2016-17,1626181,Norman Powell,SG,227,505,171,333,56,172,Center,18,Jump Shot,11.318811881188118
2017-18,1626181,Norman Powell,SG,150,374,97,188,53,186,Center,11,Jump Shot,14.61229946524064
2018-19,1626181,Norman Powell,SG,193,400,125,230,68,170,Center,5,Jump Shot,13.2325
2019-20,1626181,Norman Powell,SG,296,598,187,325,109,273,Center,9,Jump Shot,13.677257525083611
2020-21,1626181,Norman Powell,SG-SF,438,918,267,502,171,416,Center,13,Jump Shot,13.764705882352942
2021-22,1626181,Norman Powell,SF-SG,279,605,173,352,106,253,Center,13,Jump Shot,13.905785123966941
2022-23,1626181,Norman Powell,SG,340,710,226,423,114,287,Center,12,Jump Shot,13.573239436619719
2011-12,202708,Norris Cole,PG,177,450,156,374,21,76,Center,10,Jump Shot,11.537777777777778
2012-13,202708,Norris Cole,PG,179,424,144,327,35,97,Center,16,Jump Shot,11.983490566037736
2013-14,202708,Norris Cole,PG,207,500,147,326,60,174,Center,7,Jump Shot,13.026
2014-15,202708,Norris Cole,PG,229,557,175,382,54,175,Center,6,Jump Shot,14.384201077199283
2015-16,202708,Norris Cole,PG,196,484,163,382,33,102,Center,4,Jump Shot,14.061983471074381
2016-17,202708,Norris Cole,PG,16,52,13,39,3,13,Center,3,Jump Shot,14.384615384615385
2019-20,203658,Norvel Pelle,C,25,48,25,47,0,1,Center,4,Layup Shot,2.1458333333333335
2020-21,203658,Norvel Pelle,C,8,15,8,15,0,0,Center,2,Dunk Shot,1.2
2021-22,203658,Norvel Pelle,C,3,5,3,5,0,0,Center,1,Dunk Shot,0.0
2017-18,1628384,O.G. Anunoby,,163,346,90,149,73,197,Center,3,Jump Shot,14.523121387283236
2018-19,1628384,O.G. Anunoby,,183,404,116,202,67,202,Center,7,Jump Shot,13.514851485148515
2022-23,1628384,O.G. Anunoby,,421,885,279,518,142,367,Center,14,Jump Shot,13.152542372881356
2008-09,201564,O.J. Mayo,SG,562,1283,417,905,145,378,Center,26,Jump Shot,15.02494154325799
2009-10,201564,O.J. Mayo,SG,542,1183,406,828,136,355,Center,20,Jump Shot,14.080304311073542
2010-11,201564,O.J. Mayo,SG,304,747,208,483,96,264,Center,9,Jump Shot,16.105756358768406
2011-12,201564,O.J. Mayo,SG,300,736,200,461,100,275,Center,16,Jump Shot,15.64945652173913
2012-13,201564,O.J. Mayo,SG,461,1026,319,677,142,349,Center,18,Jump Shot,15.317738791423002
2013-14,201564,O.J. Mayo,SG,224,549,140,323,84,226,Center,8,Jump Shot,16.7632058287796
2014-15,201564,O.J. Mayo,SG,296,701,197,424,99,277,Center,11,Jump Shot,15.189728958630528
2015-16,201564,O.J. Mayo,SG,119,316,67,159,52,157,Center,4,Jump Shot,17.310126582278482
2019-20,1628384,OG Anunoby,,286,566,197,338,89,228,Center,3,Jump Shot,11.083038869257951
2020-21,1628384,OG Anunoby,,249,519,145,258,104,261,Center,8,Jump Shot,14.271676300578035
2021-22,1628384,OG Anunoby,,309,697,194,380,115,317,Center,10,Jump Shot,14.639885222381636
2020-21,1630167,Obi Toppin,PF,104,209,78,124,26,85,Center,5,Jump Shot,11.976076555023923
2021-22,1630167,Obi Toppin,PF,251,473,199,304,52,169,Center,10,Jump Shot,9.978858350951374
2022-23,1630167,Obi Toppin,PF,187,419,102,172,85,247,Center,5,Jump Shot,15.486873508353222
2004-05,1918,Obinna Ekezie,C,79,182,79,181,0,1,Center,4,Jump Shot,6.78021978021978
2022-23,1630534,Ochai Agbaji,SG,165,386,84,158,81,228,Center,11,Jump Shot,16.39378238341969
2013-14,203136,Ognjen Kuzmic,C,5,13,5,13,0,0,Center,2,Jump Shot,5.769230769230769
2014-15,203136,Ognjen Kuzmic,C,8,12,8,12,0,0,Center,2,Jump Shot,7.333333333333333
2016-17,1627855,Okaro White,PF,33,87,21,53,12,34,Center,4,Jump Shot,12.919540229885058
2017-18,1627855,Okaro White,PF,7,16,3,5,4,11,Center,0,Jump Shot,17.625
2018-19,1627855,Okaro White,PF,0,2,0,0,0,2,Right Side Center,0,Jump Shot,24.5
2007-08,200762,Oleksiy Pecherov,C,44,125,27,65,17,60,Center,4,Jump Shot,16.824
2008-09,200762,Oleksiy Pecherov,C,39,101,25,58,14,43,Center,5,Jump Shot,15.237623762376238
2009-10,200762,Oleksiy Pecherov,C,77,188,63,136,14,52,Center,9,Jump Shot,14.585106382978724
2009-10,201802,Oliver Lafayette,SG,3,6,2,4,1,2,Center,0,Jump Shot,18.333333333333332
2003-04,932,Oliver Miller,C,53,100,53,99,0,1,Center,3,Layup Shot,2.88
2021-22,1630846,Olivier Sarr,C,58,101,45,72,13,29,Center,1,Jump Shot,10.366336633663366
2022-23,1630846,Olivier Sarr,C,15,30,14,22,1,8,Center,3,Jump Shot,7.966666666666667
2003-04,2241,Omar Cook,PG,7,27,7,26,0,1,Center,1,Jump Shot,14.74074074074074
2004-05,2241,Omar Cook,PG,10,24,10,20,0,4,Center,1,Jump Shot,16.458333333333332
2017-18,204179,Omari Johnson,PF,9,21,5,9,4,12,Center,0,Jump Shot,16.952380952380953
2018-19,1629016,Omari Spellman,PF,98,244,54,116,44,128,Center,4,Jump Shot,14.12295081967213
2019-20,1629016,Omari Spellman,C,127,295,84,185,43,110,Center,1,Jump Shot,13.816949152542373
2010-11,201600,Omer Asik,C,78,141,78,141,0,0,Center,5,Layup Shot,1.5177304964539007
2011-12,201600,Omer Asik,C,79,156,79,156,0,0,Center,4,Layup Shot,1.955128205128205
2012-13,201600,Omer Asik,C,332,614,332,613,0,1,Center,7,Layup Shot,2.042345276872964
2013-14,201600,Omer Asik,C,101,190,101,190,0,0,Center,1,Layup Shot,2.3
2014-15,201600,Omer Asik,C,213,412,213,412,0,0,Center,4,Layup Shot,1.3592233009708738
2015-16,201600,Omer Asik,C,104,195,104,195,0,0,Center,1,Layup Shot,1.5025641025641026
2016-17,201600,Omer Asik,C,31,65,31,65,0,0,Center,0,Layup Shot,1.2
2017-18,201600,Omer Asik,C,9,22,9,22,0,0,Center,0,Driving Layup Shot,2.8636363636363638
2021-22,1630209,Omer Yurtseven,C,130,247,129,236,1,11,Center,14,Jump Shot,5.364372469635628
2022-23,1630209,Omer Yurtseven,C,16,27,13,20,3,7,Center,3,Jump Shot,9.814814814814815
2009-10,201956,Omri Casspi,SF,300,672,225,469,75,203,Center,19,Jump Shot,12.577380952380953
2010-11,201956,Omri Casspi,SF,225,546,133,299,92,247,Center,10,Jump Shot,15.395604395604396
2011-12,201956,Omri Casspi,SF,166,412,113,244,53,168,Center,8,Jump Shot,12.53883495145631
2012-13,201956,Omri Casspi,SF,63,160,38,84,25,76,Center,2,Jump Shot,15.71875
2013-14,201956,Omri Casspi,PF,173,410,112,234,61,176,Center,4,Jump Shot,13.753658536585366
2014-15,201956,Omri Casspi,SF,209,427,174,340,35,87,Center,13,Jump Shot,8.032786885245901
2015-16,201956,Omri Casspi,PF,299,622,187,348,112,274,Center,10,Jump Shot,12.995176848874598
2016-17,201956,Omri Casspi,PF,77,164,62,121,15,43,Center,1,Jump Shot,8.609756097560975
2017-18,201956,Omri Casspi,SF,120,207,110,185,10,22,Center,7,Jump Shot,6.0772946859903385
2018-19,201956,Omri Casspi,SF,86,161,71,118,15,43,Center,1,Jump Shot,8.602484472049689
2020-21,1630168,Onyeka Okongwu,C,96,149,96,146,0,3,Center,3,Layup Shot,3.5838926174496644
2021-22,1630168,Onyeka Okongwu,C,156,226,156,226,0,0,Center,3,Layup Shot,2.256637168141593
2022-23,1630168,Onyeka Okongwu,C,317,497,313,484,4,13,Center,3,Jump Shot,4.17102615694165
2005-06,101158,Orien Greene,PG,100,253,91,213,9,40,Center,11,Jump Shot,11.58498023715415
2006-07,101158,Orien Greene,SG,23,62,21,51,2,11,Center,4,Jump Shot,10.887096774193548
2007-08,101158,Orien Greene,SG,3,11,3,10,0,1,Center,1,Jump Shot,10.0
2010-11,101158,Orien Greene,SG,1,2,1,2,0,0,Center,1,Layup Shot,1.0
2012-13,203111,Orlando Johnson,SG,72,180,36,86,36,94,Center,5,Jump Shot,16.81111111111111
2013-14,203111,Orlando Johnson,SG,36,113,27,66,9,47,Center,6,Jump Shot,14.11504424778761
2015-16,203111,Orlando Johnson,SG,9,34,7,24,2,10,Center,0,Jump Shot,11.852941176470589
2022-23,1631115,Orlando Robinson,C,47,89,47,83,0,6,Center,1,Cutting Layup Shot,4.820224719101123
2019-20,1629052,Oshae Brissett,SF,13,36,10,21,3,15,Center,3,Jump Shot,11.25
2020-21,1629052,Oshae Brissett,SF,73,151,40,73,33,78,Center,4,Jump Shot,14.43046357615894
2021-22,1629052,Oshae Brissett,SF,208,506,125,269,83,237,Center,6,Jump Shot,13.452569169960475
2022-23,1629052,Oshae Brissett,SF,123,319,75,164,48,155,Center,3,Jump Shot,13.589341692789969
2003-04,970,Othella Harrington,PF,100,202,100,202,0,0,Center,6,Jump Shot,7.03960396039604
2004-05,970,Othella Harrington,PF,217,424,217,424,0,0,Center,6,Jump Shot,8.025943396226415
2005-06,970,Othella Harrington,C,135,273,135,273,0,0,Center,1,Jump Shot,9.142857142857142
2006-07,970,Othella Harrington,PF,25,56,25,56,0,0,Center,1,Jump Shot,7.285714285714286
2007-08,970,Othella Harrington,C,18,42,18,42,0,0,Center,1,Jump Shot,8.904761904761905
2008-09,201629,Othello Hunter,PF,11,20,11,20,0,0,Center,3,Layup Shot,3.9
2009-10,201629,Othello Hunter,SF,4,12,4,12,0,0,Center,1,Layup Shot,3.3333333333333335
2009-10,201785,Othyus Jeffers,SG,12,29,12,29,0,0,Center,4,Layup Shot,2.3793103448275863
2010-11,201785,Othyus Jeffers,SG,31,65,30,61,1,4,Center,0,Jump Shot,5.892307692307693
2013-14,201785,Othyus Jeffers,SG,3,6,3,4,0,2,Center,2,Jump Shot,9.333333333333334
2013-14,203490,Otto Porter Jr.,SF,33,91,29,70,4,21,Center,7,Jump Shot,14.23076923076923
2014-15,203490,Otto Porter Jr.,SF,176,391,141,287,35,104,Center,8,Jump Shot,13.948849104859335
2015-16,203490,Otto Porter Jr.,SF,339,716,241,450,98,266,Center,7,Jump Shot,15.168994413407821
2016-17,203490,Otto Porter Jr.,SF,414,802,266,462,148,340,Center,10,Jump Shot,15.854114713216958
2017-18,203490,Otto Porter Jr.,SF,445,885,307,572,138,313,Center,12,Jump Shot,15.376271186440677
2018-19,203490,Otto Porter Jr.,SF,299,643,195,387,104,256,Center,6,Jump Shot,16.141524105754275
2019-20,203490,Otto Porter Jr.,SF,62,140,38,78,24,62,Center,2,Jump Shot,15.7
2020-21,203490,Otto Porter Jr.,SF-PF,98,227,59,123,39,104,Center,4,Jump Shot,16.45374449339207
2021-22,203490,Otto Porter Jr.,PF,193,416,113,200,80,216,Center,3,Jump Shot,16.25
2022-23,203490,Otto Porter Jr.,SF,15,30,9,13,6,17,Center,0,Jump Shot,18.3
2022-23,1631172,Ousmane Dieng,SF,76,181,50,83,26,98,Center,4,Jump Shot,15.662983425414364
2003-04,136,P.J. Brown,PF,339,712,339,711,0,1,Center,13,Jump Shot,9.432584269662922
2004-05,136,P.J. Brown,PF,338,758,338,758,0,0,Center,10,Jump Shot,9.571240105540896
2005-06,136,P.J. Brown,C,269,583,269,583,0,0,Center,8,Jump Shot,10.090909090909092
2006-07,136,P.J. Brown,PF,170,418,170,416,0,2,Center,3,Jump Shot,9.464114832535886
2007-08,136,P.J. Brown,PF,14,41,14,40,0,1,Center,0,Jump Shot,8.439024390243903
2017-18,1628408,P.J. Dozier,,1,2,1,2,0,0,Right Side Center,1,Pullup Jump shot,11.5
2018-19,1628408,P.J. Dozier,,8,21,6,13,2,8,Center,3,Jump Shot,13.333333333333334
2019-20,1628408,P.J. Dozier,,65,157,48,108,17,49,Center,4,Pullup Jump shot,13.987261146496815
2020-21,1628408,P.J. Dozier,,148,355,101,206,47,149,Center,6,Jump Shot,13.983098591549295
2021-22,1628408,P.J. Dozier,,36,99,21,51,15,48,Center,0,Jump Shot,16.656565656565657
2006-07,200782,P.J. Tucker,SF,11,22,11,22,0,0,Center,1,Layup Shot,1.7727272727272727
2012-13,200782,P.J. Tucker,SG,210,444,188,374,22,70,Center,12,Jump Shot,8.837837837837839
2013-14,200782,P.J. Tucker,SF,265,614,191,424,74,190,Center,15,Jump Shot,10.960912052117264
2014-15,200782,P.J. Tucker,SF,261,596,174,344,87,252,Center,17,Jump Shot,13.901006711409396
2015-16,200782,P.J. Tucker,SF,239,582,171,376,68,206,Center,9,Jump Shot,11.414089347079038
2016-17,200782,P.J. Tucker,SF,199,482,129,286,70,196,Center,6,Jump Shot,12.842323651452283
2017-18,200782,P.J. Tucker,PF,172,441,57,131,115,310,Center,5,Jump Shot,18.41269841269841
2018-19,200782,P.J. Tucker,PF,207,523,61,136,146,387,Right Side,4,Jump Shot,18.39770554493308
2019-20,200782,P.J. Tucker,PF,177,426,70,127,107,299,Right Side,7,Jump Shot,17.920187793427232
2020-21,200782,P.J. Tucker,PF,66,177,26,58,40,119,Left Side,1,Jump Shot,16.785310734463277
2021-22,200782,P.J. Tucker,PF,207,428,127,235,80,193,Center,9,Jump Shot,13.27570093457944
2022-23,200782,P.J. Tucker,PF,96,225,41,85,55,140,Left Side,2,Jump Shot,16.075555555555557
2019-20,1629023,P.J. Washington,PF,268,589,182,359,86,230,Center,7,Jump Shot,11.799660441426147
2020-21,1629023,P.J. Washington,PF,302,686,190,396,112,290,Center,4,Jump Shot,12.919825072886297
2021-22,1629023,P.J. Washington,C,250,532,140,231,110,301,Center,16,Jump Shot,15.353383458646617
2022-23,1629023,P.J. Washington,PF,434,978,285,550,149,428,Center,25,Jump Shot,14.300613496932515
2022-23,1628408,PJ Dozier,SG,10,33,8,17,2,16,Center,4,Pullup Jump shot,17.363636363636363
2014-15,203798,PJ Hairston,SG,87,269,38,106,49,163,Center,2,Jump Shot,18.713754646840147
2015-16,203798,PJ Hairston,SF,145,408,75,167,70,241,Center,3,Jump Shot,17.220588235294116
2012-13,203143,Pablo Prigioni,PG,100,220,47,86,53,134,Center,5,Jump Shot,17.618181818181817
2013-14,203143,Pablo Prigioni,PG,88,191,23,51,65,140,Left Side Center,1,Jump Shot,19.884816753926703
2014-15,203143,Pablo Prigioni,PG,91,228,34,62,57,166,Center,2,Jump Shot,20.49561403508772
2015-16,203143,Pablo Prigioni,PG,54,146,27,52,27,94,Center,8,Jump Shot,19.15068493150685
2022-23,1631094,Paolo Banchero,PF,479,1122,394,837,85,285,Center,20,Pullup Jump shot,11.935828877005347
2004-05,2776,Pape Sow,C,23,58,23,58,0,0,Center,6,Layup Shot,4.482758620689655
2005-06,2776,Pape Sow,C,53,123,53,123,0,0,Center,1,Layup Shot,3.7560975609756095
2006-07,2776,Pape Sow,C,3,9,3,9,0,0,Center,2,Jump Shot,8.777777777777779
2010-11,202377,Pape Sy,SF,2,6,2,5,0,1,Center,0,Jump Shot,6.333333333333333
2021-22,1628238,Paris Bass,SF,2,6,2,4,0,2,Center,1,Jump Shot,11.166666666666666
2016-17,1627783,Pascal Siakam,PF,103,204,102,198,1,6,Center,3,Jump Shot,6.519607843137255
2017-18,1627783,Pascal Siakam,PF,253,498,224,366,29,132,Center,12,Jump Shot,8.779116465863455
2018-19,1627783,Pascal Siakam,PF,519,945,440,731,79,214,Center,12,Jump Shot,8.238095238095237
2019-20,1627783,Pascal Siakam,PF,500,1104,369,739,131,365,Center,22,Jump Shot,12.192934782608695
2020-21,1627783,Pascal Siakam,PF,437,961,364,715,73,246,Center,13,Jump Shot,11.079084287200832
2021-22,1627783,Pascal Siakam,PF,596,1207,521,989,75,218,Center,20,Jump Shot,10.740679370339684
2022-23,1627783,Pascal Siakam,C,630,1313,537,1026,93,287,Center,18,Jump Shot,11.845392231530845
2005-06,2469,Pat Burke,C,63,127,61,120,2,7,Center,6,Jump Shot,10.15748031496063
2006-07,2469,Pat Burke,C,23,65,17,43,6,22,Center,6,Jump Shot,12.353846153846154
2015-16,1626192,Pat Connaughton,SG,13,49,8,28,5,21,Center,4,Jump Shot,14.16326530612245
2016-17,1626192,Pat Connaughton,SG,37,72,20,39,17,33,Center,11,Jump Shot,14.180555555555555
2017-18,1626192,Pat Connaughton,SG,165,390,91,180,74,210,Center,12,Jump Shot,16.120512820512822
2018-19,1626192,Pat Connaughton,SG,163,350,97,150,66,200,Center,17,Jump Shot,15.928571428571429
2019-20,1626192,Pat Connaughton,SG,137,301,82,135,55,166,Center,8,Jump Shot,15.398671096345515
2020-21,1626192,Pat Connaughton,SG,168,387,67,115,101,272,Center,5,Jump Shot,19.012919896640827
2021-22,1626192,Pat Connaughton,SF,227,496,81,126,146,370,Center,6,Jump Shot,19.717741935483872
2022-23,1626192,Pat Connaughton,SG,165,421,56,99,109,322,Center,1,Jump Shot,19.847980997624703
2003-04,1727,Pat Garrity,PF,1,3,1,3,0,0,Left Side,0,Jump Shot,18.666666666666668
2004-05,1727,Pat Garrity,PF,123,306,74,159,49,147,Center,6,Jump Shot,18.669934640522875
2005-06,1727,Pat Garrity,PF,101,242,51,113,50,129,Center,3,Jump Shot,19.520661157024794
2006-07,1727,Pat Garrity,PF,22,70,11,38,11,32,Center,3,Jump Shot,18.0
2007-08,1727,Pat Garrity,PF,27,80,19,43,8,37,Center,3,Jump Shot,18.4875
2016-17,1627868,Patricio Garino,SG,0,7,0,2,0,5,Left Side,0,Jump Shot,22.428571428571427
2022-23,1631116,Patrick Baldwin Jr.,SF,43,109,11,25,32,84,Right Side Center,3,Jump Shot,20.825688073394495
2012-13,201976,Patrick Beverley,PG,79,189,43,93,36,96,Center,4,Jump Shot,15.783068783068783
2013-14,201976,Patrick Beverley,PG,198,480,107,226,91,254,Center,7,Jump Shot,15.404166666666667
2014-15,201976,Patrick Beverley,PG,204,532,89,209,115,323,Center,8,Jump Shot,16.622180451127818
2015-16,201976,Patrick Beverley,PG,258,594,134,284,124,310,Center,14,Jump Shot,15.313131313131313
2016-17,201976,Patrick Beverley,SG,227,541,118,255,109,286,Center,10,Jump Shot,15.412199630314232
2017-18,201976,Patrick Beverley,SG,48,119,24,59,24,60,Center,2,Jump Shot,15.252100840336135
2018-19,201976,Patrick Beverley,PG,194,477,82,195,112,282,Center,5,Jump Shot,16.48218029350105
2019-20,201976,Patrick Beverley,PG,147,341,67,135,80,206,Center,2,Jump Shot,16.727272727272727
2020-21,201976,Patrick Beverley,PG,93,220,37,79,56,141,Center,1,Jump Shot,17.668181818181818
2021-22,201976,Patrick Beverley,PG,177,436,94,194,83,242,Center,7,Jump Shot,16.126146788990827
2022-23,201976,Patrick Beverley,PG,144,360,64,121,80,239,Center,9,Jump Shot,18.18611111111111
2014-15,203565,Patrick Christopher,SG,3,12,3,8,0,4,Right Side Center,0,Jump Shot,15.583333333333334
2010-11,201607,Patrick Ewing,SF,0,5,0,3,0,2,Left Side Center,0,Jump Shot,17.6
2016-17,1627775,Patrick McCaw,SG,106,245,65,122,41,123,Center,11,Jump Shot,15.0
2017-18,1627775,Patrick McCaw,SG,92,225,73,145,19,80,Center,4,Jump Shot,12.862222222222222
2018-19,1627775,Patrick McCaw,SG,26,63,17,35,9,28,Center,1,Jump Shot,13.0
2019-20,1627775,Patrick McCaw,SF,67,162,44,91,23,71,Center,1,Jump Shot,13.209876543209877
2020-21,1627775,Patrick McCaw,SF,1,1,1,1,0,0,Center,0,Running Layup Shot,1.0
2006-07,200753,Patrick O'Bryant,C,10,32,10,32,0,0,Center,3,Jump Shot,11.9375
2007-08,200753,Patrick O'Bryant,C,16,29,16,29,0,0,Center,3,Layup Shot,5.413793103448276
2008-09,200753,Patrick O'Bryant,C,45,84,45,82,0,2,Center,7,Jump Shot,10.738095238095237
2009-10,200753,Patrick O'Bryant,C,8,15,8,14,0,1,Center,6,Jump Shot,9.533333333333333
2010-11,202335,Patrick Patterson,PF,149,267,149,265,0,2,Center,4,Jump Shot,9.595505617977528
2011-12,202335,Patrick Patterson,PF,225,511,225,508,0,3,Center,7,Jump Shot,10.140900195694716
2012-13,202335,Patrick Patterson,PF,319,623,268,491,51,132,Center,9,Jump Shot,12.32263242375602
2013-14,202335,Patrick Patterson,PF,225,489,170,338,55,151,Center,7,Jump Shot,13.889570552147239
2014-15,202335,Patrick Patterson,PF,240,535,135,252,105,283,Center,10,Jump Shot,16.34766355140187
2015-16,202335,Patrick Patterson,PF,204,492,98,200,106,292,Center,6,Jump Shot,17.152439024390244
2016-17,202335,Patrick Patterson,PF,154,384,60,131,94,253,Center,6,Jump Shot,18.158854166666668
2017-18,202335,Patrick Patterson,PF,106,266,40,95,66,171,Center,0,Jump Shot,17.50375939849624
2018-19,202335,Patrick Patterson,PF,82,219,36,82,46,137,Center,1,Jump Shot,17.410958904109588
2019-20,202335,Patrick Patterson,PF,95,233,28,61,67,172,Center,10,Jump Shot,19.630901287553648
2020-21,202335,Patrick Patterson,PF,72,165,32,53,40,112,Center,4,Jump Shot,18.145454545454545
2020-21,1630172,Patrick Williams,PF,255,528,201,390,54,138,Center,6,Jump Shot,11.738636363636363
2021-22,1630172,Patrick Williams,PF,54,102,39,73,15,29,Center,0,Jump Shot,12.715686274509803
2022-23,1630172,Patrick Williams,PF,314,677,199,400,115,277,Center,8,Jump Shot,14.137370753323486
2009-10,201988,Patty Mills,PG,10,24,8,20,2,4,Center,5,Jump Shot,13.25
2010-11,201988,Patty Mills,PG,135,328,88,195,47,133,Center,5,Jump Shot,16.088414634146343
2011-12,201988,Patty Mills,PG,63,130,39,74,24,56,Center,6,Jump Shot,16.33076923076923
2012-13,201988,Patty Mills,PG,113,241,61,111,52,130,Center,14,Jump Shot,17.282157676348547
2013-14,201988,Patty Mills,PG,309,666,174,348,135,318,Center,12,Jump Shot,17.62012012012012
2014-15,201988,Patty Mills,PG,128,336,66,154,62,182,Center,8,Jump Shot,18.613095238095237
2015-16,201988,Patty Mills,PG,260,612,137,292,123,320,Center,2,Jump Shot,18.666666666666668
2016-17,201988,Patty Mills,PG,273,621,126,266,147,355,Center,5,Jump Shot,18.752012882447666
2017-18,201988,Patty Mills,PG,280,682,126,268,154,414,Center,11,Jump Shot,19.872434017595307
2018-19,201988,Patty Mills,PG,282,663,123,259,159,404,Center,7,Jump Shot,19.043740573152338
2019-20,201988,Patty Mills,PG,258,598,104,195,154,403,Center,7,Jump Shot,19.95819397993311
2020-21,201988,Patty Mills,PG,252,611,91,182,161,429,Center,5,Jump Shot,20.23731587561375
2021-22,201988,Patty Mills,SG,324,794,97,226,227,568,Center,5,Jump Shot,20.93954659949622
2022-23,201988,Patty Mills,PG,86,209,37,75,49,134,Center,3,Jump Shot,20.42105263157895
2003-04,2200,Pau Gasol,PF,506,1049,502,1034,4,15,Center,35,Jump Shot,5.959961868446139
2004-05,2200,Pau Gasol,PF,357,695,356,689,1,6,Center,13,Jump Shot,5.054676258992806
2005-06,2200,Pau Gasol,PF,600,1194,597,1182,3,12,Center,22,Jump Shot,5.9463986599664995
2006-07,2200,Pau Gasol,C,462,858,459,847,3,11,Center,22,Jump Shot,6.827505827505828
2007-08,2200,Pau Gasol,C,475,890,471,874,4,16,Center,18,Jump Shot,7.022471910112359
2008-09,2200,Pau Gasol,C,592,1045,591,1043,1,2,Center,24,Jump Shot,5.868899521531101
2009-10,2200,Pau Gasol,C,452,844,452,839,0,5,Center,17,Jump Shot,5.540284360189573
2010-11,2200,Pau Gasol,C,593,1120,592,1117,1,3,Center,15,Jump Shot,7.3625
2011-12,2200,Pau Gasol,PF,459,917,452,890,7,27,Center,11,Jump Shot,9.21483097055616
2012-13,2200,Pau Gasol,PF,270,579,262,551,8,28,Center,14,Jump Shot,9.699481865284975
2013-14,2200,Pau Gasol,C,425,885,421,871,4,14,Center,23,Jump Shot,8.656497175141244
2014-15,2200,Pau Gasol,PF,570,1153,558,1127,12,26,Center,22,Jump Shot,8.810928013876843
2015-16,2200,Pau Gasol,C,467,995,443,926,24,69,Center,19,Jump Shot,11.063316582914572
2016-17,2200,Pau Gasol,C,303,604,247,500,56,104,Center,2,Jump Shot,11.503311258278146
2017-18,2200,Pau Gasol,C,287,627,244,507,43,120,Center,5,Jump Shot,10.85645933014354
2018-19,2200,Pau Gasol,C,42,94,36,81,6,13,Center,1,Jump Shot,9.595744680851064
2006-07,200781,Paul Davis,C,22,52,22,52,0,0,Center,6,Jump Shot,7.596153846153846
2007-08,200781,Paul Davis,PF,24,65,24,65,0,0,Center,2,Jump Shot,10.584615384615384
2008-09,200781,Paul Davis,PF,40,98,40,97,0,1,Center,1,Jump Shot,9.744897959183673
2009-10,200781,Paul Davis,PF,2,4,2,4,0,0,Center,1,Jump Shot,9.75
2010-11,202331,Paul George,SG,179,394,138,257,41,137,Center,11,Jump Shot,13.49492385786802
2011-12,202331,Paul George,SG,281,639,191,405,90,234,Center,13,Jump Shot,13.685446009389672
2012-13,202331,Paul George,SF,493,1176,323,707,170,469,Center,14,Jump Shot,15.011054421768707
2013-14,202331,Paul George,SF,577,1361,395,862,182,499,Center,22,Jump Shot,15.351947097722263
2014-15,202331,Paul George,SF,18,49,9,27,9,22,Center,0,Jump Shot,16.408163265306122
2015-16,202331,Paul George,SF,603,1445,395,883,208,562,Center,27,Jump Shot,16.1840830449827
2016-17,202331,Paul George,SF,620,1345,427,852,193,493,Center,29,Jump Shot,16.59628252788104
2017-18,202331,Paul George,SF,576,1340,332,731,244,609,Center,21,Jump Shot,16.09179104477612
2018-19,202331,Paul George,SF,707,1614,415,857,292,757,Center,26,Jump Shot,16.06195786864932
2019-20,202331,Paul George,SF,343,782,186,401,157,381,Center,12,Jump Shot,16.946291560102303
2020-21,202331,Paul George,SF,445,953,274,537,171,416,Center,10,Jump Shot,15.672612801678909
2021-22,202331,Paul George,PF,268,636,177,379,91,257,Center,12,Jump Shot,16.11320754716981
2022-23,202331,Paul George,SG,459,1004,301,578,158,426,Center,19,Pullup Jump shot,16.185258964143426
2003-04,1514,Paul Grant,C,11,23,11,23,0,0,Center,1,Jump Shot,8.434782608695652
2006-07,200794,Paul Millsap,PF,209,398,208,395,1,3,Center,11,Layup Shot,3.8115577889447234
2007-08,200794,Paul Millsap,PF,253,502,253,498,0,4,Center,11,Layup Shot,5.195219123505976
2008-09,200794,Paul Millsap,PF,400,749,400,745,0,4,Center,12,Layup Shot,4.806408544726302
2009-10,200794,Paul Millsap,PF,385,716,384,707,1,9,Center,8,Jump Shot,6.850558659217877
2010-11,200794,Paul Millsap,PF,525,988,516,965,9,23,Center,20,Jump Shot,9.146761133603238
2011-12,200794,Paul Millsap,PF,426,861,419,830,7,31,Center,21,Jump Shot,8.43437862950058
2012-13,200794,Paul Millsap,PF,429,875,416,836,13,39,Center,18,Jump Shot,8.381714285714287
2013-14,200794,Paul Millsap,PF,483,1047,407,835,76,212,Center,17,Jump Shot,9.902578796561604
2014-15,200794,Paul Millsap,PF,443,930,366,714,77,216,Center,11,Jump Shot,9.838709677419354
2015-16,200794,Paul Millsap,PF,501,1066,427,834,74,232,Center,12,Jump Shot,9.918386491557223
2016-17,200794,Paul Millsap,PF,430,972,355,731,75,241,Center,22,Jump Shot,11.705761316872428
2017-18,200794,Paul Millsap,PF,202,435,163,322,39,113,Center,8,Jump Shot,11.32183908045977
2018-19,200794,Paul Millsap,PF,322,665,264,506,58,159,Center,8,Jump Shot,9.481203007518797
2019-20,200794,Paul Millsap,PF,211,438,157,314,54,124,Center,2,Jump Shot,10.294520547945206
2020-21,200794,Paul Millsap,PF,191,401,142,258,49,143,Center,2,Jump Shot,11.960099750623442
2021-22,200794,Paul Millsap,C,45,115,37,80,8,35,Center,0,Jump Shot,10.443478260869565
2003-04,1718,Paul Pierce,SG,602,1497,487,1113,115,384,Center,19,Jump Shot,14.509686038744155
2004-05,1718,Paul Pierce,SF,556,1223,448,931,108,292,Center,20,Jump Shot,13.040065412919052
2005-06,1718,Paul Pierce,SF,689,1462,578,1148,111,314,Center,48,Jump Shot,12.176470588235293
2006-07,1718,Paul Pierce,SG,373,850,266,575,107,275,Center,17,Jump Shot,14.731764705882354
2007-08,1718,Paul Pierce,SF,509,1098,366,733,143,365,Center,13,Jump Shot,13.765938069216757
2008-09,1718,Paul Pierce,SF,540,1181,421,877,119,304,Center,22,Jump Shot,13.384419983065198
2009-10,1718,Paul Pierce,SF,409,867,300,604,109,263,Center,15,Jump Shot,12.829296424452133
2010-11,1718,Paul Pierce,SF,507,1021,396,724,111,297,Center,19,Jump Shot,13.110675808031342
2011-12,1718,Paul Pierce,SF,394,890,294,617,100,273,Center,13,Jump Shot,13.892134831460675
2012-13,1718,Paul Pierce,SF,476,1092,331,710,145,382,Center,14,Jump Shot,14.603479853479854
2013-14,1718,Paul Pierce,SF,321,712,209,412,112,300,Center,13,Jump Shot,15.191011235955056
2014-15,1718,Paul Pierce,SF,293,656,175,353,118,303,Center,12,Jump Shot,16.58079268292683
2015-16,1718,Paul Pierce,SF,143,394,69,155,74,239,Center,2,Jump Shot,19.538071065989847
2016-17,1718,Paul Pierce,SF,28,70,13,27,15,43,Center,2,Jump Shot,19.514285714285716
2020-21,1630194,Paul Reed,PF,42,78,42,72,0,6,Center,13,Jump Shot,5.833333333333333
2021-22,1630194,Paul Reed,C,54,96,52,88,2,8,Center,7,Layup Shot,4.927083333333333
2022-23,1630194,Paul Reed,C,124,209,123,203,1,6,Center,9,Layup Shot,3.5933014354066986
2003-04,2321,Paul Shirley,PF,10,23,10,22,0,1,Center,2,Jump Shot,9.73913043478261
2004-05,2321,Paul Shirley,PF,5,11,5,11,0,0,Right Side,4,Jump Shot,15.454545454545455
2019-20,1628778,Paul Watson,SF,10,26,6,14,4,12,Center,3,Jump Shot,14.115384615384615
2020-21,1628778,Paul Watson,SF,38,82,8,18,30,64,Left Side Center,7,Jump Shot,20.036585365853657
2021-22,1628778,Paul Watson,SF,12,35,6,9,6,26,Center,1,Jump Shot,19.257142857142856
2016-17,1627835,Paul Zipser,SF,88,221,55,122,33,99,Center,4,Jump Shot,16.06787330316742
2017-18,1627835,Paul Zipser,SF,81,234,44,124,37,110,Center,7,Jump Shot,16.91025641025641
2005-06,2750,Pavel Podkolzin,C,0,2,0,2,0,0,Left Side,0,Jump Shot,13.0
2020-21,1630202,Payton Pritchard,SG,184,418,82,170,102,248,Center,7,Jump Shot,18.22488038277512
2021-22,1630202,Payton Pritchard,PG,160,373,59,128,101,245,Center,15,Jump Shot,20.10455764075067
2022-23,1630202,Payton Pritchard,PG,101,245,45,91,56,154,Center,11,Jump Shot,18.73061224489796
2003-04,978,Peja Stojakovic,SF,665,1386,425,832,240,554,Center,17,Jump Shot,15.34920634920635
2004-05,978,Peja Stojakovic,SF,451,1016,277,583,174,433,Center,6,Jump Shot,16.416338582677167
2005-06,978,Peja Stojakovic,SF,445,1018,283,614,162,404,Center,8,Jump Shot,16.243614931237722
2006-07,978,Peja Stojakovic,SF,83,196,49,112,34,84,Center,7,Jump Shot,16.913265306122447
2007-08,978,Peja Stojakovic,SF,451,1026,220,502,231,524,Center,13,Jump Shot,18.02729044834308
2008-09,978,Peja Stojakovic,SF,287,718,142,335,145,383,Center,11,Jump Shot,18.832869080779943
2009-10,978,Peja Stojakovic,SF,278,688,146,336,132,352,Center,6,Jump Shot,18.09011627906977
2010-11,978,Peja Stojakovic,SF,100,227,43,91,57,136,Right Side Center,1,Jump Shot,19.537444933920703
2013-14,203544,Pero Antic,C,123,294,67,123,56,171,Center,7,Jump Shot,16.904761904761905
2014-15,203544,Pero Antic,C,108,296,56,123,52,173,Center,0,Jump Shot,17.29054054054054
2012-13,203103,Perry Jones III,SF,39,99,39,97,0,2,Center,14,Jump Shot,10.070707070707071
2013-14,203103,Perry Jones III,PF,83,181,61,120,22,61,Center,6,Jump Shot,13.0
2014-15,203103,Perry Jones III,SF,73,183,59,124,14,59,Center,3,Jump Shot,13.049180327868852
2004-05,2762,Peter John Ramos,C,5,10,5,10,0,0,Center,5,Jump Shot,9.8
2021-22,1627822,Petr Cornelie,PF,5,15,4,7,1,8,Center,4,Jump Shot,15.4
2013-14,203491,Peyton Siva,SG,18,57,11,32,7,25,Center,1,Jump Shot,13.263157894736842
2022-23,1631212,Peyton Watson,SG,29,59,23,45,6,14,Center,9,Jump Shot,8.813559322033898
2013-14,203515,Phil Pressey,PG,78,253,50,147,28,106,Center,5,Jump Shot,15.980237154150197
2014-15,203515,Phil Pressey,PG,64,174,48,109,16,65,Center,7,Jump Shot,13.367816091954023
2015-16,203515,Phil Pressey,PG,30,78,26,60,4,18,Center,5,Jump Shot,10.371794871794872
2016-17,203510,Pierre Jackson,PG,13,39,10,28,3,11,Center,0,Jump Shot,13.794871794871796
2010-11,200817,Pooh Jeter,PG,106,259,100,229,6,30,Center,9,Jump Shot,16.652509652509654
2003-04,461,Popeye Jones,PF,0,2,0,2,0,0,Center,0,Jump Shot,8.0
2006-07,200822,Pops Mensah-Bonsu,PF,11,17,11,17,0,0,Center,6,Layup Shot,1.2941176470588236
2008-09,200822,Pops Mensah-Bonsu,PF,39,103,39,101,0,2,Center,0,Layup Shot,3.533980582524272
2009-10,200822,Pops Mensah-Bonsu,PF,13,33,13,33,0,0,Center,5,Layup Shot,1.6666666666666667
2010-11,200822,Pops Mensah-Bonsu,PF,1,3,1,3,0,0,Center,0,Layup Shot,1.3333333333333333
2020-21,1630173,Precious Achiuwa,PF,124,228,124,227,0,1,Center,13,Layup Shot,2.8771929824561404
2021-22,1630173,Precious Achiuwa,C,265,603,209,447,56,156,Center,4,Jump Shot,9.742951907131012
2022-23,1630173,Precious Achiuwa,C,196,404,167,296,29,108,Center,11,Jump Shot,9.371287128712872
2003-04,1542,Predrag Drobnjak,C,149,379,138,343,11,36,Center,8,Jump Shot,12.026385224274406
2004-05,1542,Predrag Drobnjak,C,238,543,213,472,25,71,Center,8,Jump Shot,11.795580110497237
2003-04,2056,Primoz Brezec,C,12,26,12,26,0,0,Center,8,Layup Shot,3.6538461538461537
2004-05,2056,Primoz Brezec,C,387,756,387,756,0,0,Center,9,Jump Shot,7.3505291005291005
2005-06,2056,Primoz Brezec,C,409,791,409,789,0,2,Center,10,Jump Shot,9.587863463969658
2006-07,2056,Primoz Brezec,C,122,274,121,271,1,3,Center,4,Jump Shot,9.66058394160584
2007-08,2056,Primoz Brezec,C,44,94,44,94,0,0,Center,11,Jump Shot,9.212765957446809
2009-10,2056,Primoz Brezec,C,9,26,9,26,0,0,Center,2,Jump Shot,8.5
2021-22,1629656,Quentin Grimes,SG,95,235,23,46,72,189,Left Side Center,4,Jump Shot,21.56595744680851
2022-23,1629656,Quentin Grimes,SG,282,602,125,195,157,407,Center,15,Jump Shot,17.37043189368771
2003-04,2047,Quentin Richardson,SG,425,1068,305,727,120,341,Center,23,Jump Shot,12.450374531835205
2004-05,2047,Quentin Richardson,SG,407,1045,181,414,226,631,Center,19,Jump Shot,17.68995215311005
2005-06,2047,Quentin Richardson,SF,163,459,99,271,64,188,Center,8,Jump Shot,14.33115468409586
2006-07,2047,Quentin Richardson,SF,228,545,131,287,97,258,Center,5,Jump Shot,14.98348623853211
2007-08,2047,Quentin Richardson,SF,199,555,130,341,69,214,Center,1,Jump Shot,15.437837837837838
2008-09,2047,Quentin Richardson,SG,262,667,142,338,120,329,Center,5,Jump Shot,15.338830584707646
2009-10,2047,Quentin Richardson,SF,242,561,100,203,142,358,Right Side Center,8,Jump Shot,17.63101604278075
2010-11,2047,Quentin Richardson,SF,87,255,45,109,42,146,Center,4,Jump Shot,16.396078431372548
2011-12,2047,Quentin Richardson,SF,74,197,32,76,42,121,Center,6,Jump Shot,18.695431472081218
2012-13,2047,Quentin Richardson,SF,1,11,0,7,1,4,Center,0,Jump Shot,10.090909090909092
2022-23,1631245,Quenton Jackson,PG,19,42,18,30,1,12,Center,2,Jump Shot,10.523809523809524
2012-13,203112,Quincy Acy,PF,42,75,41,73,1,2,Center,5,Jump Shot,7.426666666666667
2013-14,203112,Quincy Acy,SF,66,141,62,126,4,15,Center,1,Jump Shot,7.6879432624113475
2014-15,203112,Quincy Acy,PF,152,331,134,271,18,60,Center,7,Jump Shot,12.3987915407855
2015-16,203112,Quincy Acy,PF,119,213,100,165,19,48,Center,9,Jump Shot,9.64319248826291
2016-17,203112,Quincy Acy,PF,70,170,33,80,37,90,Center,3,Jump Shot,15.658823529411764
2017-18,203112,Quincy Acy,PF,130,365,28,73,102,292,Center,7,Jump Shot,20.671232876712327
2018-19,203112,Quincy Acy,PF,4,18,2,3,2,15,Center,0,Jump Shot,21.166666666666668
2006-07,200763,Quincy Douby,PG,48,126,36,76,12,50,Center,9,Jump Shot,15.817460317460318
2007-08,200763,Quincy Douby,PG,132,335,90,213,42,122,Center,12,Jump Shot,14.859701492537313
2008-09,200763,Quincy Douby,PG,42,110,28,64,14,46,Center,6,Jump Shot,16.418181818181818
2003-04,1900,Quincy Lewis,SF,7,20,5,15,2,5,Center,4,Jump Shot,16.2
2012-13,203113,Quincy Miller,PF,4,12,4,11,0,1,Center,3,Jump Shot,8.25
2013-14,203113,Quincy Miller,PF,94,256,64,162,30,94,Center,10,Jump Shot,13.515625
2014-15,203113,Quincy Miller,PF,9,38,6,20,3,18,Center,2,Jump Shot,15.947368421052632
2010-11,202347,Quincy Pondexter,SF,73,180,55,130,18,50,Center,6,Jump Shot,12.183333333333334
2011-12,202347,Quincy Pondexter,SF,108,239,86,166,22,73,Center,8,Jump Shot,12.401673640167363
2012-13,202347,Quincy Pondexter,SF,128,299,68,147,60,152,Center,3,Jump Shot,14.852842809364548
2013-14,202347,Quincy Pondexter,SG,31,79,20,45,11,34,Center,4,Jump Shot,14.025316455696203
2014-15,202347,Quincy Pondexter,SF-SG,188,447,97,203,91,244,Center,5,Jump Shot,16.085011185682326
2017-18,202347,Quincy Pondexter,SF,14,49,11,27,3,22,Center,3,Jump Shot,14.26530612244898
2018-19,202347,Quincy Pondexter,SF,29,58,23,40,6,18,Center,7,Jump Shot,10.379310344827585
2016-17,1626188,Quinn Cook,PG,33,66,22,40,11,26,Center,6,Jump Shot,15.803030303030303
2017-18,1626188,Quinn Cook,PG,122,252,76,148,46,104,Center,9,Jump Shot,16.21825396825397
2018-19,1626188,Quinn Cook,PG,204,439,123,239,81,200,Center,21,Jump Shot,16.990888382687928
2019-20,1626188,Quinn Cook,PG,91,214,60,129,31,85,Center,15,Jump Shot,15.266355140186915
2020-21,1626188,Quinn Cook,PG,29,68,18,42,11,26,Center,11,Pullup Jump shot,15.0
2019-20,1629683,Quinndary Weatherspoon,SG,5,17,4,12,1,5,Center,0,Jump Shot,13.235294117647058
2020-21,1629683,Quinndary Weatherspoon,SG,16,35,15,29,1,6,Center,3,Pullup Jump shot,9.085714285714285
2021-22,1629683,Quinndary Weatherspoon,SG,12,21,11,16,1,5,Center,1,Pullup Jump shot,8.142857142857142
2004-05,2624,Quinton Ross,SG,161,373,160,369,1,4,Center,6,Jump Shot,10.077747989276139
2005-06,2624,Quinton Ross,SF,130,308,130,301,0,7,Center,3,Jump Shot,12.685064935064934
2006-07,2624,Quinton Ross,SG,177,379,175,369,2,10,Center,10,Jump Shot,11.646437994722955
2007-08,2624,Quinton Ross,SG,131,335,122,314,9,21,Center,8,Jump Shot,14.26865671641791
2008-09,2624,Quinton Ross,SF,99,259,66,171,33,88,Center,1,Jump Shot,15.799227799227799
2009-10,2624,Quinton Ross,SF-SG,40,111,36,90,4,21,Center,3,Jump Shot,14.225225225225225
2010-11,2624,Quinton Ross,SF,26,59,26,56,0,3,Left Side,4,Jump Shot,16.406779661016948
2003-04,2417,Qyntel Woods,SF,88,237,78,208,10,29,Center,5,Jump Shot,11.375527426160337
2004-05,2417,Qyntel Woods,SF,5,12,5,12,0,0,Center,1,Jump Shot,8.916666666666666
2005-06,2417,Qyntel Woods,SF,129,254,107,194,22,60,Center,4,Jump Shot,10.393700787401574
2020-21,1630181,R.J. Hampton,SG-PG,136,313,109,226,27,87,Center,15,Jump Shot,11.817891373801917
2021-22,1630181,R.J. Hampton,SG,175,457,111,274,64,183,Center,14,Jump Shot,13.223194748358862
2022-23,1630181,R.J. Hampton,PG,102,237,61,121,41,116,Center,4,Jump Shot,15.569620253164556
2019-20,1629628,RJ Barrett,SG,292,727,229,530,63,197,Center,12,Jump Shot,10.247592847317744
2020-21,1629628,RJ Barrett,SG,467,1060,343,751,124,309,Center,20,Jump Shot,11.019811320754718
2021-22,1629628,RJ Barrett,SF,487,1194,349,790,138,404,Center,24,Jump Shot,11.529313232830821
2022-23,1629628,RJ Barrett,SG,510,1176,389,786,121,390,Center,18,Jump Shot,11.062074829931973
2015-16,1626154,RJ Hunter,SG,36,98,17,35,19,63,Center,6,Jump Shot,19.612244897959183
2016-17,1626154,RJ Hunter,SG,0,1,0,0,0,1,Right Side Center,0,Jump Shot,24.0
2017-18,1626154,RJ Hunter,SG,7,20,4,6,3,14,Center,0,Jump Shot,19.35
2018-19,1626154,RJ Hunter,SG,6,13,2,3,4,10,Left Side Center,0,Jump Shot,22.76923076923077
2021-22,1630612,RJ Nembhard Jr.,SG,6,18,6,16,0,2,Center,3,Driving Layup Shot,7.444444444444445
2003-04,1711,Raef LaFrentz,C,57,124,49,84,8,40,Center,1,Jump Shot,14.096774193548388
2004-05,1711,Raef LaFrentz,PF,341,688,259,463,82,225,Center,7,Jump Shot,11.274709302325581
2005-06,1711,Raef LaFrentz,PF,238,552,126,266,112,286,Center,3,Jump Shot,16.994565217391305
2006-07,1711,Raef LaFrentz,PF,39,102,37,79,2,23,Center,1,Jump Shot,13.686274509803921
2007-08,1711,Raef LaFrentz,C,27,61,27,57,0,4,Center,5,Layup Shot,6.737704918032787
2004-05,2737,Rafael Araujo,C,76,175,75,172,1,3,Center,3,Jump Shot,6.582857142857143
2005-06,2737,Rafael Araujo,C,53,145,53,144,0,1,Center,0,Jump Shot,6.413793103448276
2006-07,2737,Rafael Araujo,C,27,65,27,65,0,0,Center,4,Jump Shot,8.36923076923077
2003-04,1747,Rafer Alston,PG,287,764,126,330,161,434,Center,18,Jump Shot,17.464659685863875
2004-05,1747,Rafer Alston,PG,403,974,264,585,139,389,Center,19,Jump Shot,13.989733059548255
2005-06,1747,Rafer Alston,PG,280,738,178,426,102,312,Center,7,Jump Shot,15.302168021680217
2006-07,1747,Rafer Alston,PG,383,1020,191,491,192,529,Center,17,Jump Shot,16.037254901960786
2007-08,1747,Rafer Alston,PG,364,924,221,517,143,407,Center,10,Jump Shot,15.641774891774892
2008-09,1747,Rafer Alston,PG,316,820,204,489,112,331,Center,8,Jump Shot,14.151219512195121
2009-10,1747,Rafer Alston,PG,155,446,97,278,58,168,Center,8,Jump Shot,14.307174887892376
2022-23,1630564,RaiQuan Gray,PF,6,12,4,7,2,5,Center,1,Jump Shot,11.083333333333334
2003-04,1952,Raja Bell,SG,329,805,267,639,62,166,Center,15,Jump Shot,15.284472049689441
2004-05,1952,Raja Bell,SG,303,667,249,533,54,134,Center,9,Jump Shot,16.533733133433284
2005-06,1952,Raja Bell,SG,425,930,228,484,197,446,Left Side,10,Jump Shot,18.959139784946238
2006-07,1952,Raja Bell,SG,410,950,205,454,205,496,Center,8,Jump Shot,18.746315789473684
2007-08,1952,Raja Bell,SG,317,753,141,314,176,439,Right Side Center,4,Jump Shot,19.96547144754316
2008-09,1952,Raja Bell,SG,299,684,185,413,114,271,Right Side Center,13,Jump Shot,18.961988304093566
2009-10,1952,Raja Bell,SG,28,61,16,34,12,27,Center,1,Jump Shot,19.459016393442624
2010-11,1952,Raja Bell,SG,191,467,123,274,68,193,Center,5,Jump Shot,18.70877944325482
2011-12,1952,Raja Bell,SG,81,174,47,87,34,87,Right Side Center,0,Jump Shot,18.50574712643678
2006-07,200765,Rajon Rondo,PG,188,450,182,421,6,29,Center,12,Jump Shot,7.328888888888889
2007-08,200765,Rajon Rondo,PG,351,713,346,694,5,19,Center,13,Jump Shot,8.130434782608695
2008-09,200765,Rajon Rondo,PG,383,759,368,711,15,48,Center,7,Jump Shot,6.627140974967062
2009-10,200765,Rajon Rondo,PG,459,904,442,824,17,80,Center,10,Jump Shot,7.662610619469026
2010-11,200765,Rajon Rondo,PG,318,670,308,627,10,43,Center,6,Jump Shot,9.229850746268657
2011-12,200765,Rajon Rondo,PG,256,572,246,530,10,42,Center,6,Jump Shot,8.393356643356643
2012-13,200765,Rajon Rondo,PG,225,465,213,415,12,50,Center,5,Jump Shot,10.161290322580646
2013-14,200765,Rajon Rondo,PG,141,350,115,260,26,90,Center,7,Jump Shot,11.397142857142857
2014-15,200765,Rajon Rondo,PG,275,645,248,559,27,86,Center,7,Jump Shot,10.877519379844962
2015-16,200765,Rajon Rondo,PG,355,782,293,612,62,170,Center,13,Jump Shot,10.90153452685422
2016-17,200765,Rajon Rondo,PG,229,561,179,428,50,133,Center,2,Jump Shot,11.470588235294118
2017-18,200765,Rajon Rondo,PG,231,494,181,344,50,150,Center,9,Jump Shot,10.987854251012147
2018-19,200765,Rajon Rondo,PG,175,432,124,290,51,142,Center,3,Jump Shot,12.0
2019-20,200765,Rajon Rondo,PG,137,328,96,203,41,125,Center,0,Jump Shot,13.076219512195122
2020-21,200765,Rajon Rondo,PG,95,215,59,126,36,89,Center,3,Jump Shot,12.967441860465117
2021-22,200765,Rajon Rondo,PG,68,176,37,88,31,88,Center,1,Jump Shot,15.573863636363637
2015-16,1626176,Rakeem Christmas,PF,2,2,2,2,0,0,Center,0,Reverse Layup Shot,0.5
2016-17,1626176,Rakeem Christmas,PF,19,43,19,43,0,0,Center,2,Jump Shot,3.2093023255813953
2007-08,201196,Ramon Sessions,PG,51,117,48,110,3,7,Center,5,Jump Shot,9.051282051282051
2008-09,201196,Ramon Sessions,PG,345,775,339,741,6,34,Center,15,Jump Shot,7.918709677419355
2009-10,201196,Ramon Sessions,PG,253,555,252,540,1,15,Center,11,Jump Shot,7.8882882882882885
2010-11,201196,Ramon Sessions,PG,362,776,359,761,3,15,Center,16,Jump Shot,7.46520618556701
2011-12,201196,Ramon Sessions,PG,242,565,199,468,43,97,Center,7,Jump Shot,10.208849557522123
2012-13,201196,Ramon Sessions,SG,276,676,243,569,33,107,Center,9,Jump Shot,8.751479289940828
2013-14,201196,Ramon Sessions,PG,330,769,295,645,35,124,Center,9,Jump Shot,8.728218465539662
2014-15,201196,Ramon Sessions,PG,125,334,106,274,19,60,Center,2,Jump Shot,9.751497005988025
2015-16,201196,Ramon Sessions,PG,280,591,244,481,36,110,Center,3,Jump Shot,8.593908629441625
2016-17,201196,Ramon Sessions,PG,100,263,79,201,21,62,Center,4,Jump Shot,10.722433460076045
2017-18,201196,Ramon Sessions,PG,42,117,34,91,8,26,Center,3,Jump Shot,9.461538461538462
2006-07,201043,Randolph Morris,C,1,6,1,6,0,0,Center,0,Jump Shot,5.833333333333333
2007-08,201043,Randolph Morris,C,21,58,21,58,0,0,Center,4,Jump Shot,6.844827586206897
2008-09,201043,Randolph Morris,C,7,17,7,17,0,0,Center,2,Jump Shot,8.529411764705882
2009-10,201043,Randolph Morris,PF,23,41,23,41,0,0,Center,10,Turnaround Jump Shot,5.902439024390244
2006-07,200751,Randy Foye,PG,300,691,232,506,68,185,Center,26,Jump Shot,12.852387843704776
2007-08,200751,Randy Foye,PG,198,462,137,314,61,148,Center,13,Jump Shot,15.13852813852814
2008-09,200751,Randy Foye,SG,399,981,288,673,111,308,Center,27,Jump Shot,13.629969418960245
2009-10,200751,Randy Foye,PG,256,619,193,437,63,182,Center,18,Jump Shot,16.73182552504039
2010-11,200751,Randy Foye,SG,206,531,135,314,71,217,Center,9,Jump Shot,17.807909604519775
2011-12,200751,Randy Foye,SG,256,643,129,315,127,328,Center,12,Jump Shot,17.66407465007776
2012-13,200751,Randy Foye,SG,293,738,115,304,178,434,Center,8,Jump Shot,19.223577235772357
2013-14,200751,Randy Foye,SG,361,875,172,377,189,498,Center,17,Jump Shot,18.330285714285715
2014-15,200751,Randy Foye,SG,148,402,54,139,94,263,Center,7,Jump Shot,19.98507462686567
2015-16,200751,Randy Foye,SG,169,482,94,232,75,250,Center,7,Jump Shot,17.263485477178424
2016-17,200751,Randy Foye,SG,117,324,51,122,66,202,Center,7,Jump Shot,18.135802469135804
2005-06,2450,Randy Holcomb,SF,1,1,1,1,0,0,Center,0,Jump Shot,18.0
2003-04,988,Randy Livingston,PG,2,10,2,7,0,3,Left Side Center,0,Jump Shot,14.6
2004-05,988,Randy Livingston,PG,22,52,17,44,5,8,Center,3,Jump Shot,13.01923076923077
2005-06,988,Randy Livingston,PG,0,2,0,2,0,0,Center,0,Layup Shot,2.0
2006-07,988,Randy Livingston,PG,0,3,0,3,0,0,Left Side Center,0,Jump Shot,12.666666666666666
2005-06,101119,Rashad McCants,SG,241,535,174,355,67,180,Center,10,Jump Shot,12.753271028037384
2006-07,101119,Rashad McCants,SG,62,177,42,102,20,75,Center,7,Jump Shot,15.497175141242938
2007-08,101119,Rashad McCants,SG,428,944,286,595,142,349,Center,24,Jump Shot,15.440677966101696
2008-09,101119,Rashad McCants,SG,192,488,129,299,63,189,Center,9,Jump Shot,14.262295081967213
2015-16,1626173,Rashad Vaughn,SG,81,265,38,119,43,146,Center,9,Jump Shot,17.2188679245283
2016-17,1626173,Rashad Vaughn,SG,57,156,31,75,26,81,Center,7,Jump Shot,16.833333333333332
2017-18,1626173,Rashad Vaughn,SG,23,56,9,19,14,37,Center,2,Jump Shot,18.875
2003-04,1740,Rashard Lewis,SF,535,1229,390,843,145,386,Center,17,Jump Shot,13.88527257933279
2004-05,1740,Rashard Lewis,SF,532,1151,359,719,173,432,Center,20,Jump Shot,14.130321459600347
2005-06,1740,Rashard Lewis,SF,538,1151,396,781,142,370,Center,10,Jump Shot,13.684622067767158
2006-07,1740,Rashard Lewis,SF,463,1005,312,618,151,387,Center,27,Jump Shot,14.659701492537314
2007-08,1740,Rashard Lewis,PF,516,1135,290,582,226,553,Center,19,Jump Shot,15.910132158590308
2008-09,1740,Rashard Lewis,PF,478,1089,258,535,220,554,Center,20,Jump Shot,16.337924701561064
2009-10,1740,Rashard Lewis,PF,350,805,182,382,168,423,Center,17,Jump Shot,16.582608695652173
2010-11,1740,Rashard Lewis,SF-PF,252,582,165,338,87,244,Center,12,Jump Shot,15.644329896907216
2011-12,1740,Rashard Lewis,SF,84,220,69,154,15,66,Center,0,Jump Shot,13.113636363636363
2012-13,1740,Rashard Lewis,PF,103,249,52,118,51,131,Center,3,Jump Shot,16.91566265060241
2013-14,1740,Rashard Lewis,SF,98,236,52,102,46,134,Center,1,Jump Shot,16.639830508474578
2003-04,739,Rasheed Wallace,PF,425,974,343,726,82,248,Center,9,Jump Shot,13.178644763860369
2004-05,739,Rasheed Wallace,PF,467,1062,392,826,75,236,Center,17,Jump Shot,12.227871939736346
2005-06,739,Rasheed Wallace,PF,459,1067,304,633,155,434,Center,11,Jump Shot,16.142455482661667
2006-07,739,Rasheed Wallace,C,357,843,253,547,104,296,Center,10,Jump Shot,14.86832740213523
2007-08,739,Rasheed Wallace,C,376,870,264,555,112,315,Center,13,Jump Shot,15.757471264367815
2008-09,739,Rasheed Wallace,C,302,720,189,401,113,319,Center,11,Jump Shot,17.70138888888889
2009-10,739,Rasheed Wallace,C,266,650,184,360,82,290,Center,2,Jump Shot,15.804615384615385
2012-13,739,Rasheed Wallace,C,55,142,33,73,22,69,Center,2,Jump Shot,16.41549295774648
2003-04,1725,Rasho Nesterovic,C,328,700,328,700,0,0,Center,3,Jump Shot,7.5528571428571425
2004-05,1725,Rasho Nesterovic,C,198,430,198,430,0,0,Center,0,Jump Shot,7.506976744186047
2005-06,1725,Rasho Nesterovic,C,172,334,172,332,0,2,Center,5,Jump Shot,7.37125748502994
2006-07,1725,Rasho Nesterovic,C,230,421,230,420,0,1,Center,1,Jump Shot,7.3610451306413305
2007-08,1725,Rasho Nesterovic,C,257,467,256,464,1,3,Center,5,Jump Shot,7.235546038543897
2008-09,1725,Rasho Nesterovic,C,224,437,224,436,0,1,Center,3,Jump Shot,9.263157894736842
2009-10,1725,Rasho Nesterovic,C,81,149,81,149,0,0,Center,2,Jump Shot,9.644295302013424
2003-04,2446,Rasual Butler,SF,119,250,69,142,50,108,Center,12,Jump Shot,17.848
2004-05,2446,Rasual Butler,SF,163,409,106,256,57,153,Center,9,Jump Shot,17.679706601466993
2005-06,2446,Rasual Butler,SF,257,633,165,391,92,242,Center,17,Jump Shot,16.148499210110586
2006-07,2446,Rasual Butler,SF,314,788,180,425,134,363,Center,18,Jump Shot,17.619289340101524
2007-08,2446,Rasual Butler,SF,91,260,47,127,44,133,Right Side Center,11,Jump Shot,18.75
2008-09,2446,Rasual Butler,SF,348,803,208,444,140,359,Center,22,Jump Shot,17.08219178082192
2009-10,2446,Rasual Butler,SF,355,869,211,438,144,431,Right Side Center,15,Jump Shot,18.02301495972382
2010-11,2446,Rasual Butler,SG,78,236,33,101,45,135,Right Side,8,Jump Shot,19.25
2011-12,2446,Rasual Butler,SF,41,133,20,56,21,77,Right Side,2,Jump Shot,19.586466165413533
2013-14,2446,Rasual Butler,SG,51,110,25,48,26,62,Left Side,10,Jump Shot,18.28181818181818
2014-15,2446,Rasual Butler,SF,218,517,127,282,91,235,Center,12,Jump Shot,17.332688588007738
2015-16,2446,Rasual Butler,SF,49,104,34,55,15,49,Center,5,Jump Shot,15.923076923076923
2003-04,2221,Raul Lopez,PG,223,517,198,432,25,85,Center,7,Jump Shot,13.406189555125726
2004-05,2221,Raul Lopez,PG,57,135,37,90,20,45,Center,4,Jump Shot,15.718518518518518
2015-16,203526,Raul Neto,PG,180,418,116,256,64,162,Center,5,Jump Shot,14.11244019138756
2016-17,203526,Raul Neto,PG,41,91,31,60,10,31,Center,8,Jump Shot,13.087912087912088
2017-18,203526,Raul Neto,PG,69,151,50,104,19,47,Center,0,Jump Shot,12.258278145695364
2018-19,203526,Raul Neto,PG,74,161,54,101,20,60,Center,6,Jump Shot,12.459627329192546
2019-20,203526,Raul Neto,PG,101,222,67,134,34,88,Center,6,Jump Shot,13.247747747747749
2020-21,203526,Raul Neto,PG,209,447,145,283,64,164,Center,5,Jump Shot,13.237136465324385
2021-22,203526,Raul Neto,PG,204,441,169,321,35,120,Center,9,Jump Shot,11.569160997732427
2022-23,203526,Raul Neto,PG,57,110,45,68,12,42,Center,7,Jump Shot,12.736363636363636
2018-19,1628959,Rawle Alkins,SG,13,39,10,27,3,12,Center,2,Jump Shot,9.58974358974359
2005-06,101185,Rawle Marshall,SF,24,60,23,57,1,3,Center,5,Jump Shot,7.15
2006-07,101185,Rawle Marshall,SG,32,89,28,71,4,18,Center,3,Jump Shot,11.606741573033707
2003-04,951,Ray Allen,SG,447,1017,299,639,148,378,Center,15,Jump Shot,14.88888888888889
2004-05,951,Ray Allen,SG,640,1494,431,938,209,556,Center,23,Jump Shot,15.392235609103079
2005-06,951,Ray Allen,SG,681,1500,412,847,269,653,Center,29,Jump Shot,16.727333333333334
2006-07,951,Ray Allen,SG,505,1153,340,710,165,443,Center,25,Jump Shot,15.818733738074588
2007-08,951,Ray Allen,SG,439,986,259,534,180,452,Center,18,Jump Shot,16.238336713995942
2008-09,951,Ray Allen,SG,499,1040,300,554,199,486,Center,9,Jump Shot,16.549038461538462
2009-10,951,Ray Allen,SG,464,973,319,574,145,399,Center,17,Jump Shot,15.313463514902363
2010-11,951,Ray Allen,SG,480,978,312,600,168,378,Center,13,Jump Shot,15.764826175869121
2011-12,951,Ray Allen,SG,226,493,120,259,106,234,Center,10,Jump Shot,16.93103448275862
2012-13,951,Ray Allen,SG,292,650,153,319,139,331,Center,11,Jump Shot,16.346153846153847
2013-14,951,Ray Allen,SG,240,543,124,234,116,309,Center,14,Jump Shot,17.720073664825048
2013-14,203492,Ray McCallum,PG,113,300,91,241,22,59,Center,12,Jump Shot,13.256666666666666
2014-15,203492,Ray McCallum,PG,206,470,172,359,34,111,Center,17,Jump Shot,11.448936170212766
2015-16,203492,Ray McCallum,PG,55,146,40,104,15,42,Center,5,Jump Shot,13.89041095890411
2018-19,1629034,Ray Spalding,PF,25,47,25,44,0,3,Center,1,Tip Layup Shot,4.170212765957447
2020-21,1629034,Ray Spalding,C,2,4,2,3,0,1,Center,0,Cutting Layup Shot,7.5
2019-20,1629730,Rayjon Tucker,SG,20,43,17,26,3,17,Center,4,Jump Shot,13.55813953488372
2020-21,1629730,Rayjon Tucker,PG,9,18,7,11,2,7,Center,2,Jump Shot,11.277777777777779
2021-22,1629730,Rayjon Tucker,SG,6,9,2,4,4,5,Center,1,Jump Shot,17.666666666666668
2005-06,101109,Raymond Felton,PG,345,883,248,612,97,271,Center,14,Jump Shot,13.344280860702153
2006-07,101109,Raymond Felton,PG,393,1024,290,712,103,312,Center,13,Jump Shot,13.548828125
2007-08,101109,Raymond Felton,PG,412,997,356,797,56,200,Center,26,Jump Shot,12.716148445336009
2008-09,101109,Raymond Felton,PG,442,1083,383,876,59,207,Center,31,Jump Shot,12.944598337950138
2009-10,101109,Raymond Felton,PG,388,846,328,690,60,156,Center,27,Jump Shot,11.559101654846335
2010-11,101109,Raymond Felton,PG-SG,427,1005,311,676,116,329,Center,21,Jump Shot,14.569154228855721
2011-12,101109,Raymond Felton,PG,261,642,199,439,62,203,Center,6,Jump Shot,14.35202492211838
2012-13,101109,Raymond Felton,PG,377,882,284,624,93,258,Center,12,Jump Shot,13.46938775510204
2013-14,101109,Raymond Felton,PG,240,608,178,413,62,195,Center,9,Jump Shot,14.09703947368421
2014-15,101109,Raymond Felton,PG,43,106,33,72,10,34,Center,8,Jump Shot,14.641509433962264
2015-16,101109,Raymond Felton,PG,277,682,217,469,60,213,Center,7,Jump Shot,13.835777126099707
2016-17,101109,Raymond Felton,PG,221,512,175,370,46,142,Center,9,Jump Shot,13.55078125
2017-18,101109,Raymond Felton,PG,224,552,143,322,81,230,Center,1,Jump Shot,16.931159420289855
2018-19,101109,Raymond Felton,PG,55,135,35,74,20,61,Center,1,Jump Shot,17.607407407407408
2003-04,2558,Reece Gaines,PG,25,86,22,76,3,10,Center,5,Jump Shot,15.232558139534884
2004-05,2558,Reece Gaines,PG,17,50,13,36,4,14,Center,3,Jump Shot,14.46
2005-06,2558,Reece Gaines,PG,6,12,6,10,0,2,Left Side,4,Jump Shot,16.75
2013-14,203493,Reggie Bullock,SF,43,121,21,48,22,73,Center,4,Jump Shot,19.727272727272727
2014-15,203493,Reggie Bullock,SF,23,69,9,24,14,45,Center,2,Jump Shot,19.231884057971016
2015-16,203493,Reggie Bullock,SF,43,98,21,45,22,53,Center,4,Jump Shot,16.591836734693878
2016-17,203493,Reggie Bullock,SF,54,128,26,55,28,73,Center,4,Jump Shot,16.921875
2017-18,203493,Reggie Bullock,SF,267,546,142,265,125,281,Center,11,Jump Shot,16.234432234432234
2018-19,203493,Reggie Bullock,SG,245,594,97,201,148,393,Center,15,Jump Shot,19.535353535353536
2019-20,203493,Reggie Bullock,SG,90,224,53,113,37,111,Center,1,Jump Shot,17.482142857142858
2020-21,203493,Reggie Bullock,SF,248,561,85,163,163,398,Center,7,Jump Shot,20.32263814616756
2021-22,203493,Reggie Bullock,SF,201,501,60,109,141,392,Center,4,Jump Shot,20.4251497005988
2022-23,203493,Reggie Bullock,SF,192,470,41,73,151,397,Right Side,4,Jump Shot,21.185106382978724
2003-04,2501,Reggie Evans,PF,67,165,67,162,0,3,Center,4,Layup Shot,3.496969696969697
2004-05,2501,Reggie Evans,PF,131,275,131,273,0,2,Center,0,Layup Shot,2.429090909090909
2005-06,2501,Reggie Evans,PF,131,268,131,267,0,1,Center,3,Layup Shot,3.4291044776119404
2006-07,2501,Reggie Evans,PF,117,215,117,215,0,0,Center,2,Layup Shot,2.2837209302325583
2007-08,2501,Reggie Evans,PF,152,346,151,345,1,1,Center,1,Layup Shot,2.401734104046243
2008-09,2501,Reggie Evans,PF,79,178,79,177,0,1,Center,1,Layup Shot,1.303370786516854
2009-10,2501,Reggie Evans,PF,34,69,34,69,0,0,Center,1,Layup Shot,2.318840579710145
2010-11,2501,Reggie Evans,PF,42,103,42,102,0,1,Center,0,Layup Shot,3.3009708737864076
2011-12,2501,Reggie Evans,PF,34,72,34,72,0,0,Center,0,Layup Shot,2.625
2012-13,2501,Reggie Evans,PF,125,261,125,261,0,0,Center,0,Layup Shot,2.7203065134099615
2013-14,2501,Reggie Evans,PF,71,150,71,150,0,0,Center,0,Layup Shot,3.06
2014-15,2501,Reggie Evans,PF,58,137,58,135,0,2,Center,1,Layup Shot,3.153284671532847
2017-18,203687,Reggie Hearn,SG,1,2,0,0,1,2,Center,0,Jump Shot,24.0
2011-12,202704,Reggie Jackson,PG,51,159,38,97,13,62,Center,3,Jump Shot,14.50943396226415
2012-13,202704,Reggie Jackson,PG,149,325,125,221,24,104,Center,15,Jump Shot,13.184615384615384
2013-14,202704,Reggie Jackson,PG,403,916,320,671,83,245,Center,14,Jump Shot,12.335152838427948
2014-15,202704,Reggie Jackson,PG,432,996,360,755,72,241,Center,26,Jump Shot,12.068273092369479
2015-16,202704,Reggie Jackson,PG,540,1244,422,910,118,334,Center,36,Jump Shot,11.87379421221865
2016-17,202704,Reggie Jackson,PG,284,676,218,493,66,183,Center,14,Jump Shot,12.894970414201184
2017-18,202704,Reggie Jackson,PG,246,577,194,408,52,169,Center,16,Jump Shot,13.72790294627383
2018-19,202704,Reggie Jackson,PG,441,1047,267,576,174,471,Center,22,Jump Shot,15.997134670487107
2019-20,202704,Reggie Jackson,SG-PG,134,326,77,181,57,145,Center,7,Jump Shot,15.030674846625766
2020-21,202704,Reggie Jackson,SG,263,585,141,303,122,282,Center,10,Jump Shot,15.688888888888888
2021-22,202704,Reggie Jackson,SG,479,1222,312,710,167,512,Center,24,Jump Shot,15.797054009819968
2022-23,202704,Reggie Jackson,PG,263,640,167,352,96,288,Center,4,Jump Shot,15.853125
2003-04,397,Reggie Miller,SG,260,594,126,260,134,334,Left Side,13,Jump Shot,19.675084175084177
2004-05,397,Reggie Miller,SG,314,719,218,421,96,298,Right Side,11,Jump Shot,18.85257301808067
2020-21,1629617,Reggie Perry,PF,32,78,28,57,4,21,Center,3,Jump Shot,8.333333333333334
2021-22,1629617,Reggie Perry,PF,40,79,37,63,3,16,Center,3,Jump Shot,9.987341772151899
2009-10,202130,Reggie Williams,SF,140,283,107,191,33,92,Center,8,Jump Shot,13.279151943462898
2010-11,202130,Reggie Williams,SF,268,572,166,331,102,241,Center,13,Jump Shot,15.297202797202797
2011-12,202130,Reggie Williams,SF,106,255,73,148,33,107,Center,3,Jump Shot,15.678431372549019
2012-13,202130,Reggie Williams,SF,57,132,35,60,22,72,Center,11,Jump Shot,17.46969696969697
2013-14,202130,Reggie Williams,SF,5,9,4,6,1,3,Center,3,Jump Shot,15.222222222222221
2014-15,202130,Reggie Williams,SF,15,38,12,20,3,18,Center,4,Jump Shot,14.657894736842104
2016-17,202130,Reggie Williams,SF,8,23,3,12,5,11,Center,0,Jump Shot,16.17391304347826
2006-07,200764,Renaldo Balkman,SF,139,275,134,248,5,27,Center,2,Layup Shot,4.709090909090909
2007-08,200764,Renaldo Balkman,SF,91,186,90,174,1,12,Center,4,Layup Shot,3.639784946236559
2008-09,200764,Renaldo Balkman,PF,110,197,108,190,2,7,Center,7,Layup Shot,4.411167512690355
2009-10,200764,Renaldo Balkman,SF,6,18,6,11,0,7,Center,0,Jump Shot,12.5
2010-11,200764,Renaldo Balkman,SF,6,13,5,11,1,2,Center,0,Jump Shot,7.923076923076923
2011-12,200764,Renaldo Balkman,SF,16,32,14,23,2,9,Center,3,Jump Shot,10.71875
2006-07,200970,Renaldo Major,PF,2,10,2,10,0,0,Center,0,Jump Shot,8.7
2003-04,1888,Richard Hamilton,SG,530,1166,512,1098,18,68,Center,25,Jump Shot,10.296740994854202
2004-05,1888,Richard Hamilton,SG,510,1160,474,1042,36,118,Center,20,Jump Shot,11.412068965517241
2005-06,1888,Richard Hamilton,SG,649,1322,594,1202,55,120,Center,19,Jump Shot,11.607413010590015
2006-07,1888,Richard Hamilton,SG,547,1170,503,1041,44,129,Center,17,Jump Shot,11.468376068376068
2007-08,1888,Richard Hamilton,SG,499,1030,437,889,62,141,Center,12,Jump Shot,13.553398058252426
2008-09,1888,Richard Hamilton,SG,466,1043,396,853,70,190,Left Side,25,Jump Shot,14.539789069990412
2009-10,1888,Richard Hamilton,SG,293,717,252,579,41,138,Left Side,15,Jump Shot,15.270571827057182
2010-11,1888,Richard Hamilton,SG,288,671,233,527,55,144,Left Side,9,Jump Shot,14.918032786885245
2011-12,1888,Richard Hamilton,SG,140,310,123,264,17,46,Right Side,1,Jump Shot,14.219354838709677
2012-13,1888,Richard Hamilton,SG,204,475,188,423,16,52,Center,1,Jump Shot,13.987368421052631
2003-04,2210,Richard Jefferson,SF,555,1115,507,983,48,132,Center,23,Jump Shot,9.637668161434977
2004-05,2210,Richard Jefferson,SF,238,564,208,475,30,89,Center,12,Jump Shot,12.358156028368795
2005-06,2210,Richard Jefferson,SF,495,1005,435,817,60,188,Center,14,Jump Shot,10.313432835820896
2006-07,2210,Richard Jefferson,SF,303,665,251,520,52,145,Center,14,Jump Shot,11.628571428571428
2007-08,2210,Richard Jefferson,SF,619,1328,542,1115,77,213,Center,20,Jump Shot,11.353915662650602
2008-09,2210,Richard Jefferson,SF,537,1221,421,930,116,291,Center,15,Jump Shot,13.456183456183457
2009-10,2210,Richard Jefferson,SF,362,775,303,588,59,187,Center,5,Jump Shot,11.96516129032258
2010-11,2210,Richard Jefferson,SF,304,642,169,335,135,307,Center,10,Jump Shot,15.680685358255452
2011-12,2210,Richard Jefferson,SF,203,488,90,219,113,269,Center,6,Jump Shot,19.112704918032787
2012-13,2210,Richard Jefferson,SF,62,136,48,91,14,45,Center,5,Jump Shot,12.977941176470589
2013-14,2210,Richard Jefferson,SF,294,654,171,353,123,301,Center,6,Jump Shot,15.709480122324159
2014-15,2210,Richard Jefferson,SF,144,324,78,169,66,155,Center,9,Jump Shot,14.592592592592593
2015-16,2210,Richard Jefferson,SF,143,311,77,139,66,172,Center,3,Jump Shot,16.077170418006432
2016-17,2210,Richard Jefferson,SF,152,342,91,157,61,185,Center,7,Jump Shot,15.12280701754386
2017-18,2210,Richard Jefferson,SF,12,27,10,20,2,7,Center,2,Jump Shot,11.037037037037036
2015-16,1626158,Richaun Holmes,PF,114,222,106,178,8,44,Center,4,Jump Shot,7.7342342342342345
2016-17,1626158,Richaun Holmes,C,230,412,203,335,27,77,Center,12,Jump Shot,8.172330097087379
2017-18,1626158,Richaun Holmes,C,135,241,131,210,4,31,Center,5,Jump Shot,7.062240663900415
2018-19,1626158,Richaun Holmes,C,222,365,222,365,0,0,Center,5,Cutting Dunk Shot,3.0191780821917806
2019-20,1626158,Richaun Holmes,C,223,344,223,344,0,0,Center,8,Floating Jump shot,4.113372093023256
2020-21,1626158,Richaun Holmes,C,366,575,364,564,2,11,Center,12,Floating Jump shot,6.4052173913043475
2021-22,1626158,Richaun Holmes,C,198,300,196,295,2,5,Center,4,Floating Jump shot,5.1033333333333335
2022-23,1626158,Richaun Holmes,C,55,89,50,81,5,8,Center,6,Floating Jump shot,5.910112359550562
2003-04,2499,Richie Frahm,SF,63,139,29,47,34,92,Center,7,Jump Shot,19.057553956834532
2004-05,2499,Richie Frahm,SG,56,140,25,60,31,80,Right Side,9,Jump Shot,18.02857142857143
2005-06,2499,Richie Frahm,SG,39,100,16,30,23,70,Center,3,Jump Shot,19.61
2007-08,2499,Richie Frahm,SG,20,54,13,29,7,25,Center,3,Jump Shot,17.703703703703702
2003-04,1594,Rick Brunson,PG,40,105,29,82,11,23,Center,8,Jump Shot,15.18095238095238
2004-05,1594,Rick Brunson,PG,166,442,118,312,48,130,Center,10,Jump Shot,17.570135746606336
2005-06,1594,Rick Brunson,PG,21,54,16,41,5,13,Center,1,Jump Shot,14.833333333333334
2003-04,296,Rick Fox,SF,73,186,58,125,15,61,Center,1,Jump Shot,12.82258064516129
2003-04,1729,Ricky Davis,SF-SG,446,950,394,810,52,140,Center,21,Jump Shot,12.57157894736842
2004-05,1729,Ricky Davis,SG,481,1041,420,861,61,180,Center,22,Jump Shot,13.253602305475503
2005-06,1729,Ricky Davis,SG-SF,584,1304,511,1062,73,242,Center,17,Jump Shot,13.864263803680982
2006-07,1729,Ricky Davis,SF,506,1089,383,779,123,310,Center,22,Jump Shot,15.901744719926539
2007-08,1729,Ricky Davis,SF,420,971,285,638,135,333,Center,28,Jump Shot,16.231719876416065
2008-09,1729,Ricky Davis,SG,83,245,48,134,35,111,Center,2,Jump Shot,18.83265306122449
2009-10,1729,Ricky Davis,SF,62,143,46,101,16,42,Left Side Center,9,Jump Shot,18.74125874125874
2013-14,203495,Ricky Ledo,SG,6,17,3,9,3,8,Right Side Center,5,Jump Shot,16.058823529411764
2014-15,203495,Ricky Ledo,SG,32,96,22,69,10,27,Center,5,Jump Shot,11.239583333333334
2011-12,201937,Ricky Rubio,PG,139,389,107,295,32,94,Center,7,Jump Shot,13.24935732647815
2012-13,201937,Ricky Rubio,PG,185,514,158,422,27,92,Center,10,Jump Shot,12.439688715953308
2013-14,201937,Ricky Rubio,PG,255,670,211,537,44,133,Center,7,Jump Shot,11.289552238805971
2014-15,201937,Ricky Rubio,PG,78,219,65,168,13,51,Center,4,Jump Shot,16.114155251141554
2015-16,201937,Ricky Rubio,PG,218,585,157,396,61,189,Center,10,Jump Shot,15.781196581196582
2016-17,201937,Ricky Rubio,PG,261,650,201,454,60,196,Center,7,Jump Shot,15.652307692307692
2017-18,201937,Ricky Rubio,PG,346,827,250,554,96,273,Center,10,Jump Shot,15.382103990326481
2018-19,201937,Ricky Rubio,PG,295,730,216,476,79,254,Center,7,Jump Shot,14.076712328767123
2019-20,201937,Ricky Rubio,PG,287,692,209,476,78,216,Center,6,Jump Shot,13.403179190751445
2020-21,201937,Ricky Rubio,PG,193,498,127,284,66,214,Center,3,Jump Shot,14.337349397590362
2021-22,201937,Ricky Rubio,PG,149,411,90,237,59,174,Center,3,Jump Shot,14.907542579075425
2022-23,201937,Ricky Rubio,PG,61,178,40,96,21,82,Center,0,Jump Shot,15.882022471910112
2021-22,1630306,Rob Edwards,SG,1,4,0,0,1,4,Left Side,0,Jump Shot,24.0
2008-09,201633,Rob Kurz,PF,51,131,36,93,15,38,Center,3,Jump Shot,15.465648854961833
2013-14,203133,Robbie Hummel,SF,67,177,35,88,32,89,Center,9,Jump Shot,18.89830508474576
2014-15,203133,Robbie Hummel,SF,79,172,63,121,16,51,Center,9,Jump Shot,16.011627906976745
2003-04,2425,Robert Archibald,C-PF,9,33,9,33,0,0,Center,1,Layup Shot,4.0
2013-14,203496,Robert Covington,SF,6,14,2,3,4,11,Right Side Center,3,Jump Shot,21.071428571428573
2014-15,203496,Robert Covington,SF,299,756,132,310,167,446,Center,15,Jump Shot,17.023809523809526
2015-16,203496,Robert Covington,SF,274,712,104,230,170,482,Center,17,Jump Shot,18.48174157303371
2016-17,203496,Robert Covington,SF,291,729,155,320,136,409,Center,13,Jump Shot,15.622770919067216
2017-18,203496,Robert Covington,SF,345,836,142,286,203,550,Center,12,Jump Shot,18.935406698564595
2018-19,203496,Robert Covington,SF,156,362,71,137,85,225,Center,9,Jump Shot,18.132596685082873
2019-20,203496,Robert Covington,PF-C,305,723,144,243,161,480,Center,14,Jump Shot,18.206085753803595
2020-21,203496,Robert Covington,PF,204,509,69,153,135,356,Center,8,Jump Shot,19.113948919449903
2021-22,203496,Robert Covington,PF,209,498,81,159,128,339,Center,12,Jump Shot,18.343373493975903
2022-23,203496,Robert Covington,PF,102,229,48,93,54,136,Center,7,Jump Shot,16.358078602620086
2020-21,1629606,Robert Franks,PF,13,28,8,13,5,15,Center,2,Jump Shot,15.857142857142858
2006-07,200823,Robert Hite,SG,19,60,14,37,5,23,Center,1,Jump Shot,16.25
2003-04,109,Robert Horry,PF,141,348,100,240,41,108,Center,4,Jump Shot,12.836206896551724
2004-05,109,Robert Horry,PF,157,375,106,237,51,138,Center,5,Jump Shot,13.754666666666667
2005-06,109,Robert Horry,PF,112,292,59,148,53,144,Center,4,Jump Shot,16.58219178082192
2006-07,109,Robert Horry,PF,90,251,40,102,50,149,Center,1,Jump Shot,18.095617529880478
2007-08,109,Robert Horry,PF,38,119,20,49,18,70,Center,0,Jump Shot,17.705882352941178
2003-04,123,Robert Pack,PG,22,52,22,52,0,0,Center,4,Jump Shot,10.846153846153847
2012-13,203135,Robert Sacre,C,18,48,18,48,0,0,Center,4,Jump Shot,6.979166666666667
2013-14,203135,Robert Sacre,C,143,300,143,300,0,0,Center,9,Jump Shot,7.243333333333333
2014-15,203135,Robert Sacre,C,126,306,126,305,0,1,Center,9,Jump Shot,9.908496732026144
2015-16,203135,Robert Sacre,C,31,75,31,75,0,0,Center,2,Jump Shot,7.093333333333334
2004-05,2741,Robert Swift,C,5,11,5,11,0,0,Center,1,Jump Shot,7.7272727272727275
2005-06,2741,Robert Swift,C,124,241,124,241,0,0,Center,3,Jump Shot,3.4356846473029043
2007-08,2741,Robert Swift,C,6,17,6,17,0,0,Center,0,Layup Shot,4.529411764705882
2008-09,2741,Robert Swift,C,37,71,37,71,0,0,Center,5,Jump Shot,5.422535211267606
2003-04,1714,Robert Traylor,C,145,287,143,282,2,5,Center,11,Jump Shot,7.139372822299651
2004-05,1714,Robert Traylor,C,177,399,177,391,0,8,Center,11,Jump Shot,7.839598997493734
2005-06,101156,Robert Whaley,C,23,57,23,57,0,0,Center,0,Layup Shot,6.140350877192983
2018-19,1629057,Robert Williams III,C,36,51,36,51,0,0,Center,6,Alley Oop Dunk Shot,2.0980392156862746
2019-20,1629057,Robert Williams III,C,64,88,64,88,0,0,Center,1,Alley Oop Dunk Shot,2.522727272727273
2020-21,1629057,Robert Williams III,C,186,258,186,256,0,2,Center,2,Alley Oop Dunk Shot,3.647286821705426
2021-22,1629057,Robert Williams III,C,271,368,271,367,0,1,Center,5,Alley Oop Dunk Shot,2.029891304347826
2022-23,1629057,Robert Williams III,C,127,170,127,169,0,1,Center,3,Alley Oop Dunk Shot,2.6058823529411765
2020-21,1630218,Robert Woodard II,SF,8,20,7,14,1,6,Center,5,Jump Shot,14.15
2021-22,1630218,Robert Woodard II,SF,2,16,1,12,1,4,Center,1,Pullup Jump shot,12.3125
2008-09,201577,Robin Lopez,C,71,137,71,136,0,1,Center,5,Layup Shot,3.5328467153284673
2009-10,201577,Robin Lopez,C,171,291,171,291,0,0,Center,2,Layup Shot,3.7216494845360826
2010-11,201577,Robin Lopez,C,179,357,179,357,0,0,Center,2,Jump Shot,5.815126050420168
2011-12,201577,Robin Lopez,C,124,269,124,269,0,0,Center,6,Jump Shot,5.862453531598513
2012-13,201577,Robin Lopez,C,384,719,384,719,0,0,Center,6,Jump Shot,5.0848400556328235
2013-14,201577,Robin Lopez,C,355,644,355,643,0,1,Center,6,Layup Shot,4.3105590062111805
2014-15,201577,Robin Lopez,C,234,437,234,436,0,1,Center,4,Layup Shot,4.517162471395881
2015-16,201577,Robin Lopez,C,357,662,357,661,0,1,Center,5,Hook Shot,4.628398791540786
2016-17,201577,Robin Lopez,C,382,775,382,773,0,2,Center,6,Jump Shot,8.307096774193548
2017-18,201577,Robin Lopez,C,342,645,338,631,4,14,Center,2,Jump Shot,7.573643410852713
2018-19,201577,Robin Lopez,C,304,535,297,504,7,31,Center,5,Turnaround Hook Shot,5.82803738317757
2019-20,201577,Robin Lopez,C,147,299,112,194,35,105,Center,7,Jump Shot,11.284280936454849
2020-21,201577,Robin Lopez,C,269,425,264,407,5,18,Center,2,Hook Shot,4.929411764705883
2021-22,201577,Robin Lopez,C,110,199,108,193,2,6,Center,2,Hook Shot,5.7537688442211055
2022-23,201577,Robin Lopez,C,48,75,46,71,2,4,Center,5,Turnaround Hook Shot,6.08
2003-04,393,Rod Strickland,PG,150,353,140,317,10,36,Center,7,Jump Shot,12.473087818696884
2004-05,393,Rod Strickland,PG,9,43,8,41,1,2,Center,0,Jump Shot,11.720930232558139
2018-19,1629066,Rodions Kurucs,SF,202,449,144,265,58,184,Center,6,Jump Shot,11.971046770601337
2019-20,1629066,Rodions Kurucs,PF,79,177,46,87,33,90,Center,6,Jump Shot,13.819209039548022
2020-21,1629066,Rodions Kurucs,SF-PF,11,32,5,11,6,21,Center,8,Jump Shot,17.4375
2003-04,1934,Rodney Buford,SF,19,56,19,54,0,2,Center,2,Jump Shot,12.196428571428571
2004-05,1934,Rodney Buford,SF,187,489,153,381,34,108,Center,10,Jump Shot,15.865030674846626
2006-07,200760,Rodney Carney,SF,182,392,157,320,25,72,Center,8,Jump Shot,11.714285714285714
2007-08,200760,Rodney Carney,SF,158,392,120,272,38,120,Center,8,Jump Shot,14.127551020408163
2008-09,200760,Rodney Carney,SG,176,423,97,197,79,226,Center,16,Jump Shot,15.72340425531915
2009-10,200760,Rodney Carney,SG,113,282,72,147,41,135,Center,8,Jump Shot,15.24822695035461
2010-11,200760,Rodney Carney,SF,46,110,29,72,17,38,Center,2,Jump Shot,14.809090909090909
2014-15,203918,Rodney Hood,SG,155,374,93,204,62,170,Center,6,Jump Shot,16.41176470588235
2015-16,203918,Rodney Hood,SG,408,972,247,523,161,449,Center,23,Jump Shot,15.951646090534979
2016-17,203918,Rodney Hood,SG,272,666,158,359,114,307,Center,10,Jump Shot,16.38738738738739
2017-18,203918,Rodney Hood,SG,322,751,195,418,127,333,Center,10,Jump Shot,16.896138482023968
2018-19,203918,Rodney Hood,SG,292,671,208,435,84,236,Center,8,Jump Shot,15.523099850968704
2019-20,203918,Rodney Hood,SF,87,172,52,101,35,71,Center,5,Jump Shot,15.726744186046512
2020-21,203918,Rodney Hood,SF,94,260,60,147,34,113,Center,0,Jump Shot,16.48846153846154
2021-22,203918,Rodney Hood,PF-SF,58,157,28,66,30,91,Center,5,Jump Shot,19.089171974522294
2016-17,203585,Rodney McGruder,SG,189,459,117,240,72,219,Center,5,Jump Shot,14.708061002178649
2017-18,203585,Rodney McGruder,SG,36,73,21,38,15,35,Center,3,Jump Shot,14.342465753424657
2018-19,203585,Rodney McGruder,SG,186,461,107,236,79,225,Center,11,Jump Shot,14.652928416485901
2019-20,203585,Rodney McGruder,SG,72,181,48,92,24,89,Center,8,Jump Shot,14.314917127071823
2020-21,203585,Rodney McGruder,SG,37,70,26,46,11,24,Center,2,Jump Shot,11.571428571428571
2021-22,203585,Rodney McGruder,SG,98,225,40,79,58,146,Center,2,Jump Shot,17.657777777777778
2022-23,203585,Rodney McGruder,SG,62,152,21,55,41,97,Center,1,Jump Shot,17.63157894736842
2017-18,1628681,Rodney Purvis,SG,35,107,22,55,13,52,Center,3,Jump Shot,18.626168224299064
2003-04,915,Rodney Rogers,PF,207,505,157,353,50,152,Center,7,Jump Shot,11.237623762376238
2004-05,915,Rodney Rogers,SF-PF,172,450,124,282,48,168,Center,9,Jump Shot,13.886666666666667
2007-08,201155,Rodney Stuckey,PG,153,382,150,366,3,16,Center,12,Jump Shot,9.112565445026178
2008-09,201155,Rodney Stuckey,PG,401,913,378,835,23,78,Center,12,Jump Shot,9.971522453450165
2009-10,201155,Rodney Stuckey,PG,449,1109,431,1030,18,79,Center,23,Jump Shot,9.858431018935978
2010-11,201155,Rodney Stuckey,PG,363,827,337,737,26,90,Center,12,Jump Shot,9.187424425634825
2011-12,201155,Rodney Stuckey,SG,256,597,223,493,33,104,Center,10,Jump Shot,9.829145728643216
2012-13,201155,Rodney Stuckey,SG,304,748,249,566,55,182,Center,12,Jump Shot,11.037433155080214
2013-14,201155,Rodney Stuckey,SG,372,853,348,765,24,88,Center,11,Jump Shot,10.310668229777256
2014-15,201155,Rodney Stuckey,PG,332,754,277,613,55,141,Center,13,Jump Shot,12.079575596816976
2015-16,201155,Rodney Stuckey,PG,182,442,163,360,19,82,Center,4,Jump Shot,12.316742081447964
2016-17,201155,Rodney Stuckey,PG,90,243,72,184,18,59,Center,1,Jump Shot,13.905349794238683
2003-04,2206,Rodney White,SF,215,468,182,381,33,87,Center,26,Jump Shot,13.852564102564102
2004-05,2206,Rodney White,SF,121,289,97,229,24,60,Center,14,Jump Shot,14.730103806228374
2009-10,201958,Rodrigue Beaubois,PG,155,299,110,189,45,110,Center,8,Jump Shot,12.404682274247492
2010-11,201958,Rodrigue Beaubois,PG,94,223,69,140,25,83,Center,6,Jump Shot,13.789237668161435
2011-12,201958,Rodrigue Beaubois,PG,188,445,150,313,38,132,Center,8,Jump Shot,13.285393258426966
2012-13,201958,Rodrigue Beaubois,PG,65,176,44,104,21,72,Center,6,Jump Shot,15.573863636363637
2003-04,2427,Roger Mason Jr.,SG,32,98,19,59,13,39,Center,3,Jump Shot,15.051020408163266
2006-07,2427,Roger Mason Jr.,SG,59,179,26,77,33,102,Center,12,Jump Shot,19.011173184357542
2007-08,2427,Roger Mason Jr.,PG,266,600,136,273,130,327,Center,16,Jump Shot,19.878333333333334
2008-09,2427,Roger Mason Jr.,SG,349,822,183,428,166,394,Center,13,Jump Shot,19.204379562043794
2009-10,2427,Roger Mason Jr.,SG,193,496,105,232,88,264,Center,11,Jump Shot,19.721774193548388
2010-11,2427,Roger Mason Jr.,SG,26,77,10,33,16,44,Right Side Center,4,Jump Shot,20.51948051948052
2011-12,2427,Roger Mason Jr.,SG,103,258,44,104,59,154,Right Side,9,Jump Shot,20.868217054263567
2012-13,2427,Roger Mason Jr.,SG,132,305,66,146,66,159,Center,5,Jump Shot,18.75409836065574
2013-14,2427,Roger Mason Jr.,SG,25,67,8,19,17,48,Right Side,7,Jump Shot,21.71641791044776
2006-07,101232,Roger Powell,SF,0,3,0,2,0,1,Center,0,Layup Shot,8.0
2008-09,101146,Roko Ukic,PG,123,324,112,262,11,62,Center,14,Jump Shot,9.006172839506172
2009-10,101146,Roko Ukic,PG,14,30,11,18,3,12,Center,4,Jump Shot,13.8
2019-20,1629641,Romeo Langford,SG,28,80,23,53,5,27,Center,5,Jump Shot,10.9625
2020-21,1629641,Romeo Langford,SG,21,59,16,41,5,18,Center,1,Jump Shot,11.23728813559322
2021-22,1629641,Romeo Langford,SG,83,191,54,106,29,85,Center,6,Jump Shot,13.979057591623036
2022-23,1629641,Romeo Langford,SG,121,259,105,198,16,61,Center,4,Jump Shot,9.621621621621621
2016-17,1627758,Ron Baker,SG,81,216,59,131,22,85,Center,6,Jump Shot,13.74074074074074
2017-18,1627758,Ron Baker,SG,20,59,9,26,11,33,Center,1,Jump Shot,15.898305084745763
2018-19,1627758,Ron Baker,SG,4,20,3,7,1,13,Center,0,Jump Shot,17.95
2022-23,1631199,Ron Harper Jr.,SF,8,16,5,7,3,9,Center,1,Jump Shot,15.0
2003-04,1500,Ron Mercer,SG,90,211,88,204,2,7,Center,6,Jump Shot,13.739336492890995
2004-05,1500,Ron Mercer,SF,65,158,65,155,0,3,Left Side,2,Jump Shot,15.29746835443038
2003-04,2648,Ronald Dupree,SF,111,282,107,273,4,9,Center,8,Jump Shot,9.602836879432624
2004-05,2648,Ronald Dupree,SF,61,127,60,125,1,2,Center,10,Jump Shot,6.732283464566929
2005-06,2648,Ronald Dupree,SF,33,63,33,62,0,1,Center,8,Jump Shot,7.619047619047619
2006-07,2648,Ronald Dupree,SF,11,31,11,31,0,0,Center,2,Jump Shot,7.903225806451613
2007-08,2648,Ronald Dupree,SF,1,3,1,3,0,0,Left Side,1,Jump Shot,15.0
2010-11,2648,Ronald Dupree,SF,1,4,1,3,0,1,Right Side,0,Jump Shot,11.5
2015-16,1626178,Rondae Hollis-Jefferson,SF,63,138,59,124,4,14,Center,4,Jump Shot,9.173913043478262
2016-17,1626178,Rondae Hollis-Jefferson,SF,235,542,220,475,15,67,Center,6,Jump Shot,7.525830258302583
2017-18,1626178,Rondae Hollis-Jefferson,SF,342,724,329,670,13,54,Center,6,Jump Shot,7.6035911602209945
2018-19,1626178,Rondae Hollis-Jefferson,SF,200,487,191,438,9,49,Center,10,Driving Layup Shot,6.08829568788501
2019-20,1626178,Rondae Hollis-Jefferson,PF,155,329,152,306,3,23,Center,9,Layup Shot,4.300911854103344
2020-21,1626178,Rondae Hollis-Jefferson,PF,9,18,9,17,0,1,Center,1,Layup Shot,4.166666666666667
2006-07,200758,Ronnie Brewer,SG,102,193,102,184,0,9,Center,9,Jump Shot,7.367875647668394
2007-08,200758,Ronnie Brewer,SG,354,634,343,584,11,50,Center,10,Jump Shot,7.728706624605678
2008-09,200758,Ronnie Brewer,SF,421,828,399,743,22,85,Center,7,Jump Shot,9.276570048309178
2009-10,200758,Ronnie Brewer,SG,209,429,201,398,8,31,Center,7,Jump Shot,9.167832167832168
2010-11,200758,Ronnie Brewer,SG,205,427,199,400,6,27,Center,5,Jump Shot,10.250585480093676
2011-12,200758,Ronnie Brewer,SG,190,445,171,376,19,69,Center,2,Jump Shot,11.853932584269662
2012-13,200758,Ronnie Brewer,SF,70,198,47,122,23,76,Center,2,Jump Shot,14.414141414141413
2013-14,200758,Ronnie Brewer,SF,3,15,2,7,1,8,Left Side,1,Jump Shot,16.333333333333332
2005-06,101179,Ronnie Price,PG,21,58,15,31,6,27,Center,10,Jump Shot,16.879310344827587
2006-07,101179,Ronnie Price,PG,67,172,46,107,21,65,Center,11,Jump Shot,14.168604651162791
2007-08,101179,Ronnie Price,PG,88,204,62,129,26,75,Center,11,Jump Shot,14.794117647058824
2008-09,101179,Ronnie Price,PG,77,203,58,142,19,61,Center,5,Jump Shot,13.960591133004925
2009-10,101179,Ronnie Price,PG,98,242,80,179,18,63,Center,6,Jump Shot,12.665289256198347
2010-11,101179,Ronnie Price,SG,74,210,54,141,20,69,Center,4,Jump Shot,14.452380952380953
2011-12,101179,Ronnie Price,PG,49,130,36,86,13,44,Center,8,Jump Shot,14.407692307692308
2012-13,101179,Ronnie Price,PG,39,120,29,81,10,39,Center,0,Jump Shot,14.491666666666667
2013-14,101179,Ronnie Price,SG,28,92,19,49,9,43,Center,3,Jump Shot,17.891304347826086
2014-15,101179,Ronnie Price,PG,77,223,46,114,31,109,Center,1,Jump Shot,16.928251121076233
2015-16,101179,Ronnie Price,PG,115,300,48,106,67,194,Center,7,Jump Shot,19.016666666666666
2016-17,101179,Ronnie Price,PG,4,24,1,7,3,17,Center,1,Jump Shot,20.708333333333332
2005-06,101142,Ronny Turiaf,C,15,30,15,30,0,0,Center,0,Layup Shot,5.166666666666667
2006-07,101142,Ronny Turiaf,C,147,268,147,267,0,1,Center,11,Jump Shot,6.082089552238806
2007-08,101142,Ronny Turiaf,C,188,397,188,396,0,1,Center,5,Jump Shot,8.0
2008-09,101142,Ronny Turiaf,C,186,366,186,363,0,3,Center,2,Jump Shot,9.057377049180328
2009-10,101142,Ronny Turiaf,C,85,146,85,145,0,1,Center,3,Jump Shot,5.541095890410959
2010-11,101142,Ronny Turiaf,C,103,163,103,163,0,0,Center,4,Layup Shot,3.668711656441718
2011-12,101142,Ronny Turiaf,C,19,33,19,32,0,1,Center,0,Layup Shot,6.0606060606060606
2012-13,101142,Ronny Turiaf,C,49,97,49,97,0,0,Center,3,Layup Shot,2.4948453608247423
2013-14,101142,Ronny Turiaf,C,64,107,64,107,0,0,Center,1,Layup Shot,2.2803738317757007
2008-09,201579,Roy Hibbert,C,198,420,198,420,0,0,Center,6,Layup Shot,4.8
2009-10,201579,Roy Hibbert,C,387,782,384,776,3,6,Center,5,Jump Shot,6.445012787723785
2010-11,201579,Roy Hibbert,C,410,890,410,886,0,4,Center,8,Jump Shot,6.9932584269662925
2011-12,201579,Roy Hibbert,C,332,668,332,667,0,1,Center,9,Jump Shot,5.562874251497006
2012-13,201579,Roy Hibbert,C,385,859,384,855,1,4,Center,5,Jump Shot,5.90104772991851
2013-14,201579,Roy Hibbert,C,331,754,329,749,2,5,Center,7,Jump Shot,7.497347480106101
2014-15,201579,Roy Hibbert,C,317,710,317,708,0,2,Center,5,Jump Shot,8.54225352112676
2015-16,201579,Roy Hibbert,C,182,411,182,409,0,2,Center,4,Jump Shot,8.313868613138686
2016-17,201579,Roy Hibbert,C,80,147,80,147,0,0,Center,2,Jump Shot,6.829931972789115
2004-05,2767,Royal Ivey,PG,85,198,82,189,3,9,Center,3,Jump Shot,9.38888888888889
2005-06,2767,Royal Ivey,PG,116,264,112,254,4,10,Center,8,Jump Shot,11.731060606060606
2006-07,2767,Royal Ivey,PG,64,143,59,127,5,16,Center,10,Jump Shot,13.314685314685315
2007-08,2767,Royal Ivey,PG,149,378,114,271,35,107,Center,7,Jump Shot,13.171957671957673
2008-09,2767,Royal Ivey,SG,69,208,30,94,39,114,Center,0,Jump Shot,16.370192307692307
2009-10,2767,Royal Ivey,SG,35,83,21,48,14,35,Center,3,Jump Shot,14.698795180722891
2010-11,2767,Royal Ivey,SG,16,38,9,22,7,16,Center,5,Jump Shot,17.18421052631579
2011-12,2767,Royal Ivey,SG,26,73,8,20,18,53,Right Side,0,Jump Shot,19.027397260273972
2012-13,2767,Royal Ivey,SG,62,144,25,56,37,88,Center,3,Jump Shot,18.270833333333332
2013-14,2767,Royal Ivey,SG,0,2,0,1,0,1,Left Side Center,0,Pullup Jump shot,23.0
2017-18,1626220,Royce O'Neale,SF,120,284,78,166,42,118,Center,12,Jump Shot,12.834507042253522
2018-19,1626220,Royce O'Neale,SF,163,343,95,167,68,176,Center,5,Jump Shot,14.451895043731778
2019-20,1626220,Royce O'Neale,SF,158,365,66,121,92,244,Center,5,Jump Shot,18.04931506849315
2020-21,1626220,Royce O'Neale,SF,175,394,68,116,107,278,Center,4,Jump Shot,18.517766497461928
2021-22,1626220,Royce O'Neale,SF,203,444,84,138,119,306,Center,5,Jump Shot,18.277027027027028
2022-23,1626220,Royce O'Neale,SF,229,593,66,174,163,419,Center,11,Jump Shot,19.13153456998314
2013-14,203091,Royce White,PF,0,1,0,1,0,0,Left Side,0,Jump Shot,14.0
2003-04,2257,Ruben Boumtje-Boumtje,C,1,5,1,5,0,0,Center,0,Jump Shot,4.8
2003-04,1739,Ruben Patterson,SF,200,395,198,383,2,12,Center,5,Layup Shot,4.3164556962025316
2004-05,1739,Ruben Patterson,SF,319,601,317,576,2,25,Center,11,Layup Shot,4.412645590682196
2005-06,1739,Ruben Patterson,SF-SG,327,635,326,622,1,13,Center,3,Layup Shot,3.4929133858267716
2006-07,1739,Ruben Patterson,SF,475,867,472,848,3,19,Center,4,Layup Shot,4.1833910034602075
2007-08,1739,Ruben Patterson,SF,39,86,39,84,0,2,Center,0,Layup Shot,3.511627906976744
2008-09,201164,Rudy Fernandez,SG,268,630,109,232,159,398,Center,10,Jump Shot,18.36031746031746
2009-10,201164,Rudy Fernandez,SG,160,423,62,157,98,266,Center,4,Jump Shot,19.13002364066194
2010-11,201164,Rudy Fernandez,SG,213,575,97,214,116,361,Center,13,Jump Shot,18.4
2011-12,201164,Rudy Fernandez,SG,99,225,59,103,40,122,Center,1,Jump Shot,18.244444444444444
2006-07,200752,Rudy Gay,SF,321,760,269,617,52,143,Center,14,Jump Shot,11.892105263157895
2007-08,200752,Rudy Gay,SF,625,1355,491,968,134,387,Center,28,Jump Shot,13.44280442804428
2008-09,200752,Rudy Gay,SF,572,1262,487,1020,85,242,Center,18,Jump Shot,11.991283676703645
2009-10,200752,Rudy Gay,SF,600,1288,534,1086,66,202,Center,21,Jump Shot,11.168478260869565
2010-11,200752,Rudy Gay,SF,409,869,352,725,57,144,Center,21,Jump Shot,12.463751438434983
2011-12,200752,Rudy Gay,SF,485,1067,431,894,54,173,Center,27,Jump Shot,11.636363636363637
2012-13,200752,Rudy Gay,SF,521,1252,437,993,84,259,Center,21,Jump Shot,12.442492012779553
2013-14,200752,Rudy Gay,SF,537,1179,472,982,65,197,Center,22,Jump Shot,11.247667514843087
2014-15,200752,Rudy Gay,SF,508,1116,429,896,79,220,Center,14,Jump Shot,11.815412186379929
2015-16,200752,Rudy Gay,SF,466,1007,392,792,74,215,Center,21,Jump Shot,11.053624627606753
2016-17,200752,Rudy Gay,SF,201,442,159,329,42,113,Center,5,Jump Shot,12.622171945701357
2017-18,200752,Rudy Gay,PF,253,537,216,419,37,118,Center,4,Jump Shot,11.739292364990689
2018-19,200752,Rudy Gay,PF,376,746,302,562,74,184,Center,6,Jump Shot,12.693029490616622
2019-20,200752,Rudy Gay,PF,266,596,192,376,74,220,Center,12,Jump Shot,14.813758389261745
2020-21,200752,Rudy Gay,PF,264,628,158,350,106,278,Center,5,Jump Shot,16.613057324840764
2021-22,200752,Rudy Gay,PF,157,379,87,176,70,203,Center,5,Jump Shot,16.91029023746702
2022-23,200752,Rudy Gay,PF,109,288,76,157,33,131,Center,0,Jump Shot,16.375
2013-14,203497,Rudy Gobert,C,36,74,36,74,0,0,Center,11,Layup Shot,1.8513513513513513
2014-15,203497,Rudy Gobert,C,258,427,258,425,0,2,Center,12,Layup Shot,1.7166276346604215
2015-16,203497,Rudy Gobert,C,198,354,198,354,0,0,Center,6,Layup Shot,1.7514124293785311
2016-17,203497,Rudy Gobert,C,413,625,413,624,0,1,Center,25,Layup Shot,1.3488
2017-18,203497,Rudy Gobert,C,276,444,276,444,0,0,Center,11,Layup Shot,2.364864864864865
2018-19,203497,Rudy Gobert,C,476,712,476,712,0,0,Center,11,Dunk Shot,1.7429775280898876
2019-20,203497,Rudy Gobert,C,386,557,386,557,0,0,Center,19,Layup Shot,1.5691202872531418
2020-21,203497,Rudy Gobert,C,391,579,391,575,0,4,Center,14,Alley Oop Dunk Shot,2.2487046632124352
2021-22,203497,Rudy Gobert,C,362,508,362,504,0,4,Center,15,Alley Oop Dunk Shot,2.248031496062992
2022-23,203497,Rudy Gobert,C,360,546,360,543,0,3,Center,16,Tip Layup Shot,2.0476190476190474
2019-20,1629060,Rui Hachimura,PF,254,545,229,458,25,87,Center,4,Jump Shot,10.036697247706423
2020-21,1629060,Rui Hachimura,PF,310,648,265,511,45,137,Center,10,Jump Shot,11.830246913580247
2021-22,1629060,Rui Hachimura,PF,187,381,132,258,55,123,Center,5,Jump Shot,14.149606299212598
2022-23,1629060,Rui Hachimura,PF,284,584,233,424,51,160,Center,3,Jump Shot,12.428082191780822
2014-15,203893,Russ Smith,PG,8,25,6,14,2,11,Center,4,Jump Shot,16.72
2015-16,203893,Russ Smith,PG,7,22,6,17,1,5,Center,4,Jump Shot,8.636363636363637
2008-09,201566,Russell Westbrook,PG,436,1094,401,966,35,128,Center,33,Jump Shot,9.151736745886655
2009-10,201566,Russell Westbrook,PG,485,1160,462,1056,23,104,Center,24,Jump Shot,9.183620689655172
2010-11,201566,Russell Westbrook,PG,614,1390,580,1287,34,103,Center,28,Jump Shot,9.107913669064748
2011-12,201566,Russell Westbrook,PG,578,1266,516,1070,62,196,Center,23,Jump Shot,11.324644549763033
2012-13,201566,Russell Westbrook,PG,672,1534,576,1235,96,299,Center,19,Jump Shot,11.272490221642764
2013-14,201566,Russell Westbrook,PG,346,791,278,577,68,214,Center,11,Jump Shot,12.395701643489254
2014-15,201566,Russell Westbrook,PG,627,1471,541,1183,86,288,Center,22,Jump Shot,11.273283480625425
2015-16,201566,Russell Westbrook,PG,656,1444,555,1103,101,341,Center,35,Jump Shot,10.888504155124654
2016-17,201566,Russell Westbrook,PG,824,1941,624,1358,200,583,Center,61,Jump Shot,13.342606903657908
2017-18,201566,Russell Westbrook,PG,757,1687,660,1361,97,326,Center,47,Pullup Jump shot,11.344398340248963
2018-19,201566,Russell Westbrook,PG,630,1473,511,1062,119,411,Center,35,Pullup Jump shot,11.980991174473862
2019-20,201566,Russell Westbrook,PG,604,1281,549,1068,55,213,Center,21,Pullup Jump shot,9.601873536299765
2020-21,201566,Russell Westbrook,PG,544,1238,458,965,86,273,Center,27,Pullup Jump shot,12.690630048465266
2021-22,201566,Russell Westbrook,PG,548,1233,469,968,79,265,Center,20,Driving Layup Shot,10.285482562854826
2022-23,201566,Russell Westbrook,PG,432,991,343,705,89,286,Center,13,Driving Layup Shot,11.25832492431887
2003-04,1601,Rusty LaRue,PG,1,3,0,2,1,1,Left Side,1,Jump Shot,19.0
2008-09,201583,Ryan Anderson,PF,160,407,91,218,69,189,Center,4,Jump Shot,12.997542997542997
2009-10,201583,Ryan Anderson,PF,169,388,91,177,78,211,Center,7,Jump Shot,15.219072164948454
2010-11,201583,Ryan Anderson,PF,226,525,92,184,134,341,Center,5,Jump Shot,17.377142857142857
2011-12,201583,Ryan Anderson,PF,332,757,166,335,166,422,Center,13,Jump Shot,15.676354029062088
2012-13,201583,Ryan Anderson,PF,472,1115,259,558,213,557,Center,23,Jump Shot,16.860089686098654
2013-14,201583,Ryan Anderson,PF,155,354,88,190,67,164,Center,3,Jump Shot,16.285310734463277
2014-15,201583,Ryan Anderson,PF,291,729,169,370,122,359,Center,8,Jump Shot,16.473251028806583
2015-16,201583,Ryan Anderson,PF,397,929,266,571,131,358,Center,12,Jump Shot,15.308934337997847
2016-17,201583,Ryan Anderson,PF,323,773,119,267,204,506,Center,8,Jump Shot,19.42561448900388
2017-18,201583,Ryan Anderson,PF,207,480,76,141,131,339,Center,3,Jump Shot,20.420833333333334
2018-19,201583,Ryan Anderson,PF,21,69,12,29,9,40,Center,1,Jump Shot,18.956521739130434
2019-20,201583,Ryan Anderson,C,2,7,1,2,1,5,Center,0,Jump Shot,20.857142857142858
2017-18,1627853,Ryan Arcidiacono,PG,17,41,8,10,9,31,Center,0,Jump Shot,21.097560975609756
2018-19,1627853,Ryan Arcidiacono,PG,187,418,106,201,81,217,Center,5,Jump Shot,16.251196172248804
2019-20,1627853,Ryan Arcidiacono,PG,90,220,36,82,54,138,Center,5,Jump Shot,17.854545454545455
2020-21,1627853,Ryan Arcidiacono,PG,49,117,24,50,25,67,Center,5,Jump Shot,17.76923076923077
2021-22,1627853,Ryan Arcidiacono,PG,6,12,2,3,4,9,Right Side Center,2,Jump Shot,21.083333333333332
2022-23,1627853,Ryan Arcidiacono,PG,9,37,1,14,8,23,Center,0,Jump Shot,19.81081081081081
2003-04,1763,Ryan Bowen,PF,18,53,18,53,0,0,Center,3,Jump Shot,6.867924528301887
2004-05,1763,Ryan Bowen,SF,47,111,44,105,3,6,Center,6,Jump Shot,11.855855855855856
2005-06,1763,Ryan Bowen,SF,37,124,34,102,3,22,Center,1,Jump Shot,13.193548387096774
2007-08,1763,Ryan Bowen,SF,49,100,49,99,0,1,Center,3,Jump Shot,7.69
2008-09,1763,Ryan Bowen,SF,22,38,22,38,0,0,Center,3,Layup Shot,6.815789473684211
2009-10,1763,Ryan Bowen,SF,1,1,1,1,0,0,Center,0,Putback Layup Shot,0.0
2018-19,1629151,Ryan Broekhoff,SG,57,126,19,33,38,93,Center,2,Jump Shot,19.682539682539684
2019-20,1629151,Ryan Broekhoff,SF,22,59,2,8,20,51,Left Side Center,6,Jump Shot,21.983050847457626
2005-06,101155,Ryan Gomes,PF,173,355,170,346,3,9,Center,4,Jump Shot,7.726760563380282
2006-07,101155,Ryan Gomes,PF,338,723,322,681,16,42,Center,6,Jump Shot,11.944674965421854
2007-08,101155,Ryan Gomes,PF,392,857,333,678,59,179,Center,5,Jump Shot,13.133022170361727
2008-09,101155,Ryan Gomes,SF,420,974,314,689,106,285,Center,12,Jump Shot,14.670431211498974
2009-10,101155,Ryan Gomes,SF,327,732,253,533,74,199,Center,13,Jump Shot,15.095628415300547
2010-11,101155,Ryan Gomes,SF,205,503,135,294,70,209,Center,5,Jump Shot,17.52882703777336
2011-12,101155,Ryan Gomes,SF,31,95,27,66,4,29,Left Side,0,Jump Shot,17.16842105263158
2013-14,101155,Ryan Gomes,SF,3,8,3,6,0,2,Left Side,0,Jump Shot,16.625
2006-07,200797,Ryan Hollins,C,20,36,20,36,0,0,Center,0,Layup Shot,2.5
2007-08,200797,Ryan Hollins,PF,46,94,46,94,0,0,Center,5,Jump Shot,4.329787234042553
2008-09,200797,Ryan Hollins,C,50,94,50,94,0,0,Center,6,Jump Shot,3.1808510638297873
2009-10,200797,Ryan Hollins,C,169,303,169,302,0,1,Center,13,Jump Shot,6.646864686468647
2010-11,200797,Ryan Hollins,C,131,219,131,219,0,0,Center,4,Jump Shot,3.8858447488584473
2011-12,200797,Ryan Hollins,C,46,84,46,84,0,0,Center,4,Jump Shot,3.3095238095238093
2012-13,200797,Ryan Hollins,C,70,114,70,114,0,0,Center,8,Jump Shot,4.385964912280702
2013-14,200797,Ryan Hollins,PF,53,72,53,72,0,0,Center,3,Layup Shot,2.7222222222222223
2014-15,200797,Ryan Hollins,C,53,82,53,82,0,0,Center,14,Jump Shot,4.512195121951219
2015-16,200797,Ryan Hollins,C,49,79,49,79,0,0,Center,2,Hook Shot,2.7848101265822787
2003-04,2415,Ryan Humphrey,PF,1,4,1,3,0,1,Center,1,Jump Shot,14.75
2004-05,2415,Ryan Humphrey,SF,42,103,42,101,0,2,Center,3,Jump Shot,5.58252427184466
2013-14,203527,Ryan Kelly,PF,157,371,109,229,48,142,Center,7,Jump Shot,14.253369272237197
2014-15,203527,Ryan Kelly,PF,104,309,59,175,45,134,Center,3,Jump Shot,15.867313915857606
2015-16,203527,Ryan Kelly,PF,55,149,50,112,5,37,Center,13,Jump Shot,12.87248322147651
2016-17,203527,Ryan Kelly,PF,8,28,4,18,4,10,Center,3,Jump Shot,14.785714285714286
2011-12,202385,Ryan Reid,PF,4,5,4,5,0,0,Center,1,Jump Shot,13.2
2022-23,1631157,Ryan Rollins,PG,7,20,4,11,3,9,Center,3,Jump Shot,12.6
2020-21,1630240,Saben Lee,PG,99,210,91,187,8,23,Center,3,Driving Layup Shot,6.404761904761905
2021-22,1630240,Saben Lee,PG,69,177,55,117,14,60,Center,3,Jump Shot,10.768361581920903
2022-23,1630240,Saben Lee,PG,49,121,38,91,11,30,Center,4,Driving Layup Shot,8.933884297520661
2020-21,1630180,Saddiq Bey,SF,279,691,104,231,175,460,Center,14,Jump Shot,18.54848046309696
2021-22,1630180,Saddiq Bey,SF,450,1136,239,526,211,610,Center,27,Jump Shot,16.912852112676056
2022-23,1630180,Saddiq Bey,SF,353,836,202,418,151,418,Center,13,Jump Shot,15.29066985645933
2015-16,1626257,Salah Mejri,C,49,78,49,77,0,1,Center,2,Dunk Shot,1.705128205128205
2016-17,1626257,Salah Mejri,C,88,137,87,134,1,3,Center,2,Layup Shot,3.5839416058394162
2017-18,1626257,Salah Mejri,C,88,137,88,134,0,3,Center,3,Tip Layup Shot,2.605839416058394
2018-19,1626257,Salah Mejri,C,55,112,44,78,11,34,Center,7,Jump Shot,9.598214285714286
2005-06,101136,Salim Stoudamire,SG,204,492,122,276,82,216,Center,18,Jump Shot,17.567073170731707
2006-07,101136,Salim Stoudamire,SG,177,425,121,270,56,155,Center,10,Jump Shot,18.054117647058824
2007-08,101136,Salim Stoudamire,PG,65,180,36,95,29,85,Left Side Center,10,Jump Shot,19.877777777777776
2003-04,208,Sam Cassell,PG,620,1270,546,1084,74,186,Center,22,Jump Shot,14.806299212598425
2004-05,208,Sam Cassell,PG,319,687,292,584,27,103,Left Side,10,Jump Shot,16.42503639010189
2005-06,208,Sam Cassell,PG,493,1112,423,922,70,190,Center,18,Jump Shot,15.66636690647482
2006-07,208,Sam Cassell,PG,261,625,229,516,32,109,Center,4,Jump Shot,14.7248
2007-08,208,Sam Cassell,PG,233,532,210,456,23,76,Center,9,Jump Shot,15.605263157894736
2016-17,1626155,Sam Dekker,PF,203,429,143,242,60,187,Center,8,Jump Shot,12.195804195804195
2017-18,1626155,Sam Dekker,PF,128,259,118,199,10,60,Center,10,Jump Shot,8.158301158301159
2018-19,1626155,Sam Dekker,PF,120,256,101,194,19,62,Center,5,Jump Shot,9.1171875
2021-22,1630573,Sam Hauser,SF,23,50,4,6,19,44,Center,6,Jump Shot,22.2
2022-23,1630573,Sam Hauser,PF,180,396,40,61,140,335,Center,9,Jump Shot,21.949494949494948
2020-21,1630241,Sam Merrill,SG,32,72,11,25,21,47,Center,7,Jump Shot,19.291666666666668
2021-22,1630241,Sam Merrill,SG,8,24,1,1,7,23,Right Side Center,1,Jump Shot,24.0
2022-23,1630241,Sam Merrill,SG,9,22,4,4,5,18,Left Side Center,0,Jump Shot,21.772727272727273
2009-10,201970,Sam Young,SF,224,497,213,441,11,56,Center,14,Jump Shot,8.788732394366198
2010-11,201970,Sam Young,SF,233,494,216,444,17,50,Center,11,Jump Shot,10.236842105263158
2011-12,201970,Sam Young,SF,45,127,40,110,5,17,Center,7,Jump Shot,11.204724409448819
2012-13,201970,Sam Young,SG,58,148,42,96,16,52,Center,7,Jump Shot,14.364864864864865
2003-04,955,Samaki Walker,PF,38,99,38,97,0,2,Center,0,Jump Shot,7.242424242424242
2004-05,955,Samaki Walker,PF,11,31,11,31,0,0,Center,1,Jump Shot,8.193548387096774
2005-06,955,Samaki Walker,PF,0,2,0,2,0,0,Left Side,0,Jump Shot,10.5
2010-11,202396,Samardo Samuels,PF,110,241,110,238,0,3,Center,8,Jump Shot,5.1078838174273855
2011-12,202396,Samardo Samuels,C,105,231,105,231,0,0,Center,4,Jump Shot,6.471861471861472
2012-13,202396,Samardo Samuels,C,22,60,22,59,0,1,Center,3,Jump Shot,11.333333333333334
2003-04,2223,Samuel Dalembert,C,270,499,270,498,0,1,Center,15,Jump Shot,3.911823647294589
2004-05,2223,Samuel Dalembert,C,250,477,250,477,0,0,Center,6,Jump Shot,5.117400419287212
2005-06,2223,Samuel Dalembert,C,196,369,196,368,0,1,Center,2,Jump Shot,5.102981029810298
2006-07,2223,Samuel Dalembert,C,356,658,356,656,0,2,Center,12,Jump Shot,6.124620060790273
2007-08,2223,Samuel Dalembert,C,339,661,339,660,0,1,Center,16,Jump Shot,5.753403933434191
2008-09,2223,Samuel Dalembert,C,216,434,216,432,0,2,Center,4,Jump Shot,5.509216589861751
2009-10,2223,Samuel Dalembert,C,285,523,285,523,0,0,Center,9,Jump Shot,4.732313575525812
2010-11,2223,Samuel Dalembert,C,268,567,268,565,0,2,Center,6,Jump Shot,7.01058201058201
2011-12,2223,Samuel Dalembert,C,200,395,200,394,0,1,Center,1,Jump Shot,6.367088607594937
2012-13,2223,Samuel Dalembert,C,137,253,136,252,1,1,Center,1,Jump Shot,5.932806324110672
2013-14,2223,Samuel Dalembert,C,214,377,214,376,0,1,Center,6,Layup Shot,3.684350132625995
2014-15,2223,Samuel Dalembert,C,57,130,57,130,0,0,Center,0,Jump Shot,6.753846153846154
2021-22,1630572,Sandro Mamukelashvili,PF,57,115,35,63,22,52,Center,9,Jump Shot,12.834782608695653
2022-23,1630572,Sandro Mamukelashvili,C,97,230,67,131,30,99,Center,13,Jump Shot,12.756521739130434
2021-22,1630583,Santi Aldama,PF,53,132,47,84,6,48,Center,8,Jump Shot,11.492424242424242
2022-23,1630583,Santi Aldama,PF,247,525,153,259,94,266,Center,8,Jump Shot,14.198095238095238
2005-06,101180,Sarunas Jasikevicius,PG,170,429,84,193,86,236,Center,9,Jump Shot,18.144522144522146
2006-07,101180,Sarunas Jasikevicius,SG-PG,128,322,84,192,44,130,Center,6,Jump Shot,16.795031055900623
2015-16,201619,Sasha Kaun,C,9,17,9,17,0,0,Center,5,Layup Shot,2.0588235294117645
2003-04,2562,Sasha Pavlovic,SF,149,376,130,306,19,70,Center,5,Jump Shot,12.074468085106384
2004-05,2562,Sasha Pavlovic,SG,120,276,90,198,30,78,Center,10,Jump Shot,13.681159420289855
2005-06,2562,Sasha Pavlovic,SG,87,212,52,116,35,96,Center,5,Jump Shot,15.50943396226415
2006-07,2562,Sasha Pavlovic,SG,222,490,162,342,60,148,Center,11,Jump Shot,12.142857142857142
2007-08,2562,Sasha Pavlovic,SG,146,403,112,289,34,114,Center,6,Jump Shot,11.985111662531017
2008-09,2562,Sasha Pavlovic,SF,116,275,68,158,48,117,Center,7,Jump Shot,14.96
2009-10,2562,Sasha Pavlovic,SF,109,300,74,182,35,118,Center,9,Jump Shot,16.81
2010-11,2562,Sasha Pavlovic,SF-SG,29,72,17,41,12,31,Center,1,Jump Shot,17.555555555555557
2011-12,2562,Sasha Pavlovic,SF,50,128,33,70,17,58,Center,2,Jump Shot,16.9375
2012-13,2562,Sasha Pavlovic,SG,42,119,24,59,18,60,Center,0,Jump Shot,17.218487394957982
2004-05,2756,Sasha Vujacic,SG,33,117,16,54,17,63,Center,5,Jump Shot,18.136752136752136
2005-06,2756,Sasha Vujacic,PG,108,312,49,140,59,172,Center,3,Jump Shot,19.01923076923077
2006-07,2756,Sasha Vujacic,SG,105,268,45,107,60,161,Left Side Center,3,Jump Shot,20.25
2007-08,2756,Sasha Vujacic,SG,219,482,101,212,118,270,Center,24,Jump Shot,19.653526970954356
2008-09,2756,Sasha Vujacic,SG,153,398,74,178,79,220,Left Side,4,Jump Shot,19.771356783919597
2009-10,2756,Sasha Vujacic,SG,66,164,41,83,25,81,Left Side Center,8,Jump Shot,19.49390243902439
2010-11,2756,Sasha Vujacic,SG,239,595,142,333,97,262,Left Side Center,13,Jump Shot,19.90252100840336
2013-14,2756,Sasha Vujacic,SG,2,5,1,3,1,2,Left Side Center,1,Jump Shot,18.0
2015-16,2756,Sasha Vujacic,SG,106,277,54,134,52,143,Left Side Center,6,Jump Shot,19.169675090252706
2016-17,2756,Sasha Vujacic,SG,42,136,19,62,23,74,Left Side Center,6,Jump Shot,20.220588235294116
2003-04,1513,Scot Pollard,C,47,114,47,114,0,0,Center,1,Layup Shot,3.9210526315789473
2004-05,1513,Scot Pollard,C,79,167,79,167,0,0,Center,4,Jump Shot,6.2395209580838324
2005-06,1513,Scot Pollard,C,70,154,70,154,0,0,Center,1,Jump Shot,6.9935064935064934
2006-07,1513,Scot Pollard,C,11,26,11,26,0,0,Center,1,Jump Shot,6.8076923076923075
2007-08,1513,Scot Pollard,C,12,23,12,23,0,0,Center,0,Layup Shot,4.913043478260869
2012-13,203159,Scott Machado,PG,3,6,3,5,0,1,Center,2,Layup Shot,7.833333333333333
2018-19,203159,Scott Machado,PG,4,6,3,5,1,1,Center,3,Running Layup Shot,7.833333333333333
2003-04,1909,Scott Padgett,PF,74,167,46,102,28,65,Center,14,Jump Shot,14.353293413173652
2004-05,1909,Scott Padgett,PF,98,233,48,107,50,126,Center,9,Jump Shot,17.72532188841202
2005-06,1909,Scott Padgett,PF,71,201,29,80,42,121,Center,7,Jump Shot,17.845771144278608
2006-07,1909,Scott Padgett,PF,16,56,8,23,8,33,Center,2,Jump Shot,16.410714285714285
2003-04,281,Scott Williams,C,90,186,88,183,2,3,Center,3,Jump Shot,11.60752688172043
2004-05,281,Scott Williams,C,12,41,12,40,0,1,Center,0,Jump Shot,9.024390243902438
2021-22,1630567,Scottie Barnes,PF,459,932,401,739,58,193,Center,18,Jump Shot,10.394849785407725
2022-23,1630567,Scottie Barnes,PF,463,1016,400,792,63,224,Center,31,Jump Shot,10.366141732283465
2003-04,937,Scottie Pippen,SF,53,140,40,92,13,48,Center,2,Jump Shot,15.071428571428571
2013-14,203816,Scotty Hopson,SG,0,4,0,2,0,2,Left Side Center,0,Jump Shot,19.0
2017-18,203816,Scotty Hopson,SG,0,1,0,1,0,0,Center,0,Driving Layup Shot,2.0
2021-22,203816,Scotty Hopson,SG,2,4,2,3,0,1,Right Side Center,0,Pullup Jump shot,17.0
2022-23,1630590,Scotty Pippen Jr.,PG,4,12,3,9,1,3,Center,3,Jump Shot,11.25
2014-15,203930,Sean Kilpatrick,SG,7,20,3,7,4,13,Right Side Center,0,Jump Shot,17.55
2015-16,203930,Sean Kilpatrick,SG,123,270,84,156,39,114,Center,12,Jump Shot,14.222222222222221
2016-17,203930,Sean Kilpatrick,SG,305,735,200,427,105,308,Center,13,Jump Shot,14.336054421768708
2017-18,203930,Sean Kilpatrick,SG,110,294,64,150,46,144,Center,10,Jump Shot,15.850340136054422
2003-04,2253,Sean Lampley,SF,13,20,13,20,0,0,Center,0,Jump Shot,4.6
2004-05,1752,Sean Marks,PF,27,80,27,77,0,3,Center,2,Jump Shot,11.2
2005-06,1752,Sean Marks,PF,37,71,37,68,0,3,Center,6,Jump Shot,16.028169014084508
2006-07,1752,Sean Marks,PF,2,6,2,5,0,1,Right Side,2,Jump Shot,13.666666666666666
2007-08,1752,Sean Marks,C,23,43,22,39,1,4,Center,5,Jump Shot,15.255813953488373
2008-09,1752,Sean Marks,C,80,165,78,155,2,10,Center,2,Jump Shot,9.145454545454545
2009-10,1752,Sean Marks,C,4,8,4,8,0,0,Center,1,Jump Shot,7.375
2010-11,1752,Sean Marks,C,19,44,17,42,2,2,Center,2,Jump Shot,14.363636363636363
2005-06,101118,Sean May,PF,70,171,70,166,0,5,Center,7,Jump Shot,10.105263157894736
2006-07,101118,Sean May,PF,164,328,162,325,2,3,Center,4,Jump Shot,8.692073170731707
2008-09,101118,Sean May,PF,39,98,38,97,1,1,Center,6,Jump Shot,12.561224489795919
2009-10,101118,Sean May,C,51,111,51,107,0,4,Center,2,Jump Shot,13.91891891891892
2020-21,1630253,Sean McDermott,SF,13,33,8,11,5,22,Center,3,Jump Shot,17.333333333333332
2003-04,399,Sean Rooks,C,54,151,54,150,0,1,Center,3,Jump Shot,14.66225165562914
2008-09,201606,Sean Singletary,PG,31,85,21,60,10,25,Center,0,Jump Shot,16.04705882352941
2007-08,201157,Sean Williams,C,164,305,164,305,0,0,Center,6,Layup Shot,3.8262295081967213
2008-09,201157,Sean Williams,PF,30,72,30,72,0,0,Center,2,Jump Shot,5.138888888888889
2009-10,201157,Sean Williams,PF,21,49,21,48,0,1,Center,6,Jump Shot,6.346938775510204
2011-12,201157,Sean Williams,C,14,22,14,22,0,0,Center,1,Layup Shot,4.136363636363637
2004-05,2742,Sebastian Telfair,PG,169,430,152,361,17,69,Center,11,Jump Shot,12.45813953488372
2005-06,2742,Sebastian Telfair,PG,228,578,171,416,57,162,Center,10,Jump Shot,13.01038062283737
2006-07,2742,Sebastian Telfair,PG,176,474,139,346,37,128,Center,13,Jump Shot,13.29746835443038
2007-08,2742,Sebastian Telfair,PG,223,556,191,442,32,114,Center,12,Jump Shot,12.946043165467627
2008-09,2742,Sebastian Telfair,PG,267,697,194,486,73,211,Center,21,Jump Shot,14.519368723098996
2009-10,2742,Sebastian Telfair,PG,83,201,70,145,13,56,Center,6,Jump Shot,15.049751243781095
2010-11,2742,Sebastian Telfair,PG,97,241,69,163,28,78,Center,5,Jump Shot,15.178423236514522
2011-12,2742,Sebastian Telfair,PG,141,342,108,237,33,105,Center,12,Jump Shot,16.20175438596491
2012-13,2742,Sebastian Telfair,PG,112,309,59,159,53,150,Center,3,Jump Shot,17.48220064724919
2014-15,2742,Sebastian Telfair,PG,46,125,28,65,18,60,Center,2,Jump Shot,15.528
2019-20,1629635,Sekou Doumbouya,PF,92,236,64,138,28,98,Center,6,Jump Shot,12.377118644067796
2020-21,1629635,Sekou Doumbouya,PF,107,282,81,167,26,115,Center,4,Jump Shot,11.833333333333334
2021-22,1629635,Sekou Doumbouya,PF,5,8,4,6,1,2,Center,1,Running Layup Shot,8.375
2016-17,203902,Semaj Christon,PG,77,223,65,160,12,63,Center,1,Jump Shot,13.560538116591928
2017-18,1628400,Semi Ojeleye,PF,65,188,25,63,40,125,Center,3,Jump Shot,17.79255319148936
2018-19,1628400,Semi Ojeleye,PF,67,158,39,69,28,89,Center,4,Jump Shot,16.170886075949365
2019-20,1628400,Semi Ojeleye,PF,80,196,32,69,48,127,Center,6,Jump Shot,17.877551020408163
2020-21,1628400,Semi Ojeleye,PF,89,221,31,63,58,158,Center,5,Jump Shot,19.194570135746606
2021-22,1628400,Semi Ojeleye,PF,30,99,15,49,15,50,Center,4,Jump Shot,16.050505050505052
2010-11,201623,Semih Erden,C,62,111,62,111,0,0,Center,3,Layup Shot,2.09009009009009
2011-12,201623,Semih Erden,C,39,74,39,74,0,0,Center,2,Layup Shot,2.364864864864865
2009-10,201586,Serge Ibaka,PF,201,370,200,368,1,2,Center,9,Jump Shot,6.062162162162162
2010-11,201586,Serge Ibaka,PF,335,617,335,616,0,1,Center,12,Jump Shot,7.748784440842788
2011-12,201586,Serge Ibaka,PF,262,490,261,487,1,3,Center,3,Jump Shot,8.251020408163265
2012-13,201586,Serge Ibaka,PF,446,778,426,721,20,57,Center,9,Jump Shot,10.015424164524422
2013-14,201586,Serge Ibaka,PF,524,978,501,918,23,60,Center,14,Jump Shot,10.102249488752555
2014-15,201586,Serge Ibaka,PF,374,786,297,581,77,205,Center,7,Jump Shot,13.914758269720101
2015-16,201586,Serge Ibaka,PF,416,869,356,685,60,184,Center,7,Jump Shot,13.637514384349828
2016-17,201586,Serge Ibaka,PF,471,982,347,665,124,317,Center,16,Jump Shot,14.575356415478614
2017-18,201586,Serge Ibaka,PF,379,784,272,487,107,297,Center,7,Jump Shot,15.099489795918368
2018-19,201586,Serge Ibaka,C,464,877,415,708,49,169,Center,8,Jump Shot,11.322690992018243
2019-20,201586,Serge Ibaka,C,343,670,273,488,70,182,Center,5,Jump Shot,11.943283582089553
2020-21,201586,Serge Ibaka,C,186,365,147,250,39,115,Center,3,Jump Shot,12.446575342465753
2021-22,201586,Serge Ibaka,C,148,296,111,197,37,99,Center,3,Jump Shot,13.31081081081081
2022-23,201586,Serge Ibaka,C,26,54,20,36,6,18,Center,2,Jump Shot,12.296296296296296
2005-06,2752,Sergei Monia,SF,29,87,20,53,9,34,Center,2,Jump Shot,13.10344827586207
2013-14,203508,Sergey Karasev,SF,12,35,8,16,4,19,Left Side Center,1,Jump Shot,18.62857142857143
2014-15,203508,Sergey Karasev,SG,54,134,38,80,16,54,Center,0,Jump Shot,13.843283582089553
2015-16,203508,Sergey Karasev,SF,30,74,19,37,11,37,Center,3,Jump Shot,17.216216216216218
2006-07,200771,Sergio Rodriguez,PG,101,239,77,154,24,85,Center,4,Jump Shot,15.778242677824268
2007-08,200771,Sergio Rodriguez,PG,69,196,52,138,17,58,Center,1,Jump Shot,13.903061224489797
2008-09,200771,Sergio Rodriguez,PG,129,329,92,215,37,114,Center,3,Jump Shot,13.382978723404255
2009-10,200771,Sergio Rodriguez,PG,167,351,135,260,32,91,Center,13,Jump Shot,10.623931623931623
2016-17,200771,Sergio Rodriguez,PG,209,535,118,284,91,251,Center,10,Jump Shot,17.093457943925234
2013-14,203552,Seth Curry,PG,1,3,0,2,1,1,Left Side,0,Jump Shot,16.666666666666668
2014-15,203552,Seth Curry,PG,0,3,0,2,0,1,Right Side Center,0,Jump Shot,22.333333333333332
2015-16,203552,Seth Curry,PG,102,224,52,113,50,111,Center,16,Jump Shot,17.683035714285715
2016-17,203552,Seth Curry,PG,338,703,201,381,137,322,Center,19,Jump Shot,16.871977240398294
2018-19,203552,Seth Curry,SG,212,465,99,214,113,251,Center,5,Jump Shot,18.53548387096774
2019-20,203552,Seth Curry,SG,284,574,139,253,145,321,Center,12,Jump Shot,18.362369337979093
2020-21,203552,Seth Curry,SG,258,552,132,272,126,280,Center,3,Jump Shot,18.76086956521739
2021-22,203552,Seth Curry,SG,360,739,202,365,158,374,Center,13,Jump Shot,18.887686062246278
2022-23,203552,Seth Curry,SG,208,449,114,217,94,232,Center,7,Jump Shot,19.29175946547884
2013-14,203498,Shabazz Muhammad,SG,57,124,54,113,3,11,Center,11,Jump Shot,8.411290322580646
2014-15,203498,Shabazz Muhammad,SG,194,397,174,346,20,51,Center,5,Jump Shot,8.642317380352646
2015-16,203498,Shabazz Muhammad,SF,317,681,273,529,44,152,Center,9,Jump Shot,9.651982378854626
2016-17,203498,Shabazz Muhammad,SF,288,598,239,453,49,145,Center,12,Jump Shot,9.76086956521739
2017-18,203498,Shabazz Muhammad,SF-SG,84,188,77,161,7,27,Center,6,Jump Shot,7.675531914893617
2014-15,203894,Shabazz Napier,PG,87,228,44,110,43,118,Center,5,Jump Shot,18.092105263157894
2015-16,203894,Shabazz Napier,PG,68,201,34,97,34,104,Center,9,Jump Shot,18.134328358208954
2016-17,203894,Shabazz Napier,PG,73,183,39,91,34,92,Center,5,Jump Shot,17.540983606557376
2017-18,203894,Shabazz Napier,PG,223,531,141,313,82,218,Center,10,Jump Shot,16.152542372881356
2018-19,203894,Shabazz Napier,PG,169,435,93,207,76,228,Center,10,Jump Shot,16.68505747126437
2019-20,203894,Shabazz Napier,PG,188,456,112,216,76,240,Center,3,Jump Shot,16.67543859649123
2022-23,1631101,Shaedon Sharpe,SG,306,648,204,365,102,283,Center,10,Jump Shot,14.49074074074074
2018-19,1628983,Shai Gilgeous-Alexander,PG,341,716,290,577,51,139,Center,8,Jump Shot,10.712290502793296
2019-20,1628983,Shai Gilgeous-Alexander,SG,478,1015,391,764,87,251,Center,19,Driving Layup Shot,10.917241379310346
2020-21,1628983,Shai Gilgeous-Alexander,SG,287,565,216,395,71,170,Center,10,Driving Layup Shot,11.07787610619469
2021-22,1628983,Shai Gilgeous-Alexander,PG,477,1052,388,755,89,297,Center,28,Driving Layup Shot,11.651140684410647
2022-23,1628983,Shai Gilgeous-Alexander,PG,704,1381,646,1213,58,168,Center,25,Pullup Jump shot,9.26937002172339
2018-19,1629003,Shake Milton,SG,34,87,20,43,14,44,Center,3,Jump Shot,15.850574712643677
2019-20,1629003,Shake Milton,SG,134,277,76,142,58,135,Center,8,Jump Shot,15.259927797833935
2020-21,1629003,Shake Milton,SG,300,667,229,464,71,203,Center,3,Jump Shot,13.458770614692654
2021-22,1629003,Shake Milton,SG,173,403,130,270,43,133,Center,1,Jump Shot,12.945409429280398
2022-23,1629003,Shake Milton,SG,241,503,185,355,56,148,Center,8,Jump Shot,11.479125248508947
2003-04,1742,Shammond Williams,SG-PG,87,232,57,132,30,100,Center,14,Jump Shot,16.04741379310345
2006-07,1742,Shammond Williams,PG,35,86,15,36,20,50,Right Side Center,0,Jump Shot,20.046511627906977
2019-20,1629044,Shamorie Ponds,PG,3,5,2,3,1,2,Center,1,Jump Shot,10.8
2003-04,1000,Shandon Anderson,SG,238,564,202,436,36,128,Center,7,Jump Shot,10.833333333333334
2004-05,1000,Shandon Anderson,SF-SG,98,217,93,188,5,29,Center,2,Jump Shot,9.170506912442397
2005-06,1000,Shandon Anderson,SF,54,126,49,107,5,19,Center,0,Jump Shot,12.865079365079366
2003-04,2203,Shane Battier,SF,242,543,177,357,65,186,Center,15,Jump Shot,14.040515653775323
2004-05,2203,Shane Battier,SG,271,613,201,436,70,177,Center,13,Jump Shot,10.66721044045677
2005-06,2203,Shane Battier,SF,303,621,238,456,65,165,Center,11,Jump Shot,10.312399355877616
2006-07,2203,Shane Battier,SF,292,654,135,281,157,373,Center,5,Jump Shot,16.285932721712538
2007-08,2203,Shane Battier,SF,265,619,126,250,139,369,Center,7,Jump Shot,17.418416801292405
2008-09,2203,Shane Battier,SG,145,354,54,117,91,237,Center,7,Jump Shot,18.259887005649716
2009-10,2203,Shane Battier,SG,178,447,77,168,101,279,Center,1,Jump Shot,16.86800894854586
2010-11,2203,Shane Battier,SF,229,509,127,242,102,267,Center,8,Jump Shot,15.210216110019646
2011-12,2203,Shane Battier,SF,113,292,51,109,62,183,Center,1,Jump Shot,17.147260273972602
2012-13,2203,Shane Battier,SF,152,362,16,46,136,316,Right Side,4,Jump Shot,21.593922651933703
2013-14,2203,Shane Battier,SF,105,275,32,65,73,210,Center,1,Jump Shot,19.52
2013-14,202197,Shane Edwards,SF,1,3,1,3,0,0,Center,0,Jump Shot,5.0
2003-04,1049,Shane Heal,PG,7,24,3,6,4,18,Right Side Center,1,Jump Shot,23.541666666666668
2013-14,203499,Shane Larkin,PG,52,137,40,99,12,38,Center,6,Jump Shot,13.744525547445255
2014-15,203499,Shane Larkin,PG,187,432,152,316,35,116,Center,7,Jump Shot,12.92824074074074
2015-16,203499,Shane Larkin,PG,222,502,183,394,39,108,Center,6,Jump Shot,11.868525896414342
2017-18,203499,Shane Larkin,PG,84,219,53,133,31,86,Center,1,Jump Shot,15.296803652968036
2006-07,200769,Shannon Brown,SG,28,74,21,49,7,25,Center,5,Jump Shot,14.716216216216216
2007-08,200769,Shannon Brown,SG,44,126,35,96,9,30,Center,9,Jump Shot,12.198412698412698
2008-09,200769,Shannon Brown,SG,78,165,64,128,14,37,Center,15,Jump Shot,10.884848484848485
2009-10,200769,Shannon Brown,SG,253,592,191,403,62,189,Center,18,Jump Shot,15.050675675675675
2010-11,200769,Shannon Brown,SG,272,642,199,431,73,211,Center,11,Jump Shot,15.559190031152648
2011-12,200769,Shannon Brown,SG,251,598,183,410,68,188,Center,7,Jump Shot,15.219063545150501
2012-13,200769,Shannon Brown,SG,240,571,201,430,39,141,Center,13,Jump Shot,13.821366024518388
2013-14,200769,Shannon Brown,SG,24,66,24,64,0,2,Center,4,Jump Shot,9.772727272727273
2014-15,200769,Shannon Brown,SG,7,19,4,12,3,7,Center,0,Jump Shot,12.842105263157896
2021-22,1629783,Shaq Buchanan,SG,1,4,1,2,0,2,Center,0,Running Finger Roll Layup Shot,13.25
2017-18,1627885,Shaquille Harrison,PG,59,124,53,98,6,26,Center,9,Driving Layup Shot,6.491935483870968
2018-19,1627885,Shaquille Harrison,SG,184,426,160,337,24,89,Center,17,Driving Layup Shot,7.882629107981221
2019-20,1627885,Shaquille Harrison,SG,77,165,61,123,16,42,Center,7,Driving Layup Shot,8.6
2020-21,1627885,Shaquille Harrison,SG,26,78,23,62,3,16,Center,3,Jump Shot,8.846153846153847
2021-22,1627885,Shaquille Harrison,SG,2,6,2,4,0,2,Center,0,Jump Shot,9.333333333333334
2022-23,1627885,Shaquille Harrison,SG,15,36,12,26,3,10,Center,1,Driving Layup Shot,10.38888888888889
2003-04,406,Shaquille O'Neal,C,554,948,554,948,0,0,Center,11,Layup Shot,2.94831223628692
2004-05,406,Shaquille O'Neal,C,658,1095,658,1095,0,0,Center,12,Layup Shot,3.0191780821917806
2005-06,406,Shaquille O'Neal,C,480,800,480,800,0,0,Center,8,Layup Shot,2.8675
2006-07,406,Shaquille O'Neal,C,283,479,283,479,0,0,Center,4,Layup Shot,3.325678496868476
2007-08,406,Shaquille O'Neal,C,331,558,331,558,0,0,Center,3,Layup Shot,3.118279569892473
2008-09,406,Shaquille O'Neal,C,512,841,512,840,0,1,Center,5,Layup Shot,3.149821640903686
2009-10,406,Shaquille O'Neal,C,262,463,262,462,0,1,Center,2,Layup Shot,3.064794816414687
2010-11,406,Shaquille O'Neal,C,134,201,134,201,0,0,Center,0,Layup Shot,1.318407960199005
2003-04,949,Shareef Abdur-Rahim,PF,501,1054,492,1020,9,34,Center,17,Jump Shot,7.425047438330171
2004-05,949,Shareef Abdur-Rahim,PF,337,670,322,631,15,39,Center,6,Jump Shot,7.768656716417911
2005-06,949,Shareef Abdur-Rahim,PF,332,632,327,610,5,22,Center,7,Jump Shot,7.5363924050632916
2006-07,949,Shareef Abdur-Rahim,C,310,654,307,634,3,20,Center,5,Jump Shot,7.48776758409786
2007-08,949,Shareef Abdur-Rahim,PF,3,14,3,14,0,0,Center,1,Jump Shot,8.5
2021-22,1630536,Sharife Cooper,PG,3,14,2,8,1,6,Center,3,Driving Layup Shot,11.071428571428571
2005-06,101213,Sharrod Ford,PF,2,3,2,3,0,0,Center,1,Layup Shot,5.333333333333333
2004-05,2733,Shaun Livingston,PG,89,215,89,213,0,2,Center,1,Jump Shot,9.209302325581396
2005-06,2733,Shaun Livingston,PG,149,349,148,341,1,8,Center,3,Jump Shot,9.882521489971346
2006-07,2733,Shaun Livingston,PG,208,449,203,433,5,16,Center,6,Jump Shot,10.483296213808464
2008-09,2733,Shaun Livingston,PG,31,60,31,60,0,0,Center,3,Jump Shot,10.033333333333333
2009-10,2733,Shaun Livingston,PG,104,201,104,195,0,6,Center,4,Jump Shot,11.25870646766169
2010-11,2733,Shaun Livingston,PG,185,397,184,393,1,4,Center,6,Jump Shot,9.448362720403022
2011-12,2733,Shaun Livingston,SG,127,271,125,268,2,3,Center,7,Jump Shot,9.350553505535055
2012-13,2733,Shaun Livingston,PG,166,346,166,342,0,4,Center,6,Jump Shot,9.346820809248555
2013-14,2733,Shaun Livingston,PG,235,487,234,481,1,6,Center,3,Jump Shot,7.0513347022587265
2014-15,2733,Shaun Livingston,PG,198,396,198,394,0,2,Center,6,Jump Shot,8.315656565656566
2015-16,2733,Shaun Livingston,PG,203,379,201,367,2,12,Center,4,Jump Shot,9.237467018469657
2016-17,2733,Shaun Livingston,PG,173,316,172,313,1,3,Center,4,Jump Shot,10.177215189873417
2017-18,2733,Shaun Livingston,PG,172,343,172,338,0,5,Center,1,Jump Shot,9.317784256559767
2018-19,2733,Shaun Livingston,PG,109,210,109,208,0,2,Center,0,Pullup Jump shot,8.304761904761905
2005-06,101183,Shavlik Randolph,PF,44,97,44,97,0,0,Center,7,Layup Shot,2.2061855670103094
2006-07,101183,Shavlik Randolph,PF,23,48,23,48,0,0,Center,0,Layup Shot,2.9791666666666665
2007-08,101183,Shavlik Randolph,PF,4,14,4,14,0,0,Center,2,Jump Shot,3.5
2008-09,101183,Shavlik Randolph,PF,8,13,7,12,1,1,Center,5,Layup Shot,2.0
2009-10,101183,Shavlik Randolph,PF,6,18,6,18,0,0,Center,1,Layup Shot,2.6666666666666665
2012-13,101183,Shavlik Randolph,PF,28,48,28,48,0,0,Center,3,Layup Shot,2.5625
2013-14,101183,Shavlik Randolph,PF,7,14,7,14,0,0,Center,1,Layup Shot,2.2857142857142856
2014-15,101183,Shavlik Randolph,PF,9,35,9,30,0,5,Center,4,Jump Shot,7.8
2003-04,762,Shawn Bradley,C,89,188,89,187,0,1,Center,6,Jump Shot,8.914893617021276
2004-05,762,Shawn Bradley,C,84,186,84,186,0,0,Center,1,Jump Shot,7.080645161290323
2016-17,1627848,Shawn Long,C,61,109,54,90,7,19,Center,2,Jump Shot,6.862385321100917
2003-04,1890,Shawn Marion,SF,590,1341,500,1076,90,265,Center,22,Jump Shot,11.342281879194632
2004-05,1890,Shawn Marion,PF,613,1289,499,948,114,341,Center,22,Jump Shot,11.096198603568658
2005-06,1890,Shawn Marion,PF,716,1365,620,1075,96,290,Center,32,Jump Shot,9.82930402930403
2006-07,1890,Shawn Marion,SF,561,1071,481,819,80,252,Center,19,Jump Shot,9.514472455648926
2007-08,1890,Shawn Marion,PF,400,787,334,589,66,198,Center,16,Jump Shot,8.96823379923761
2008-09,1890,Shawn Marion,SF,382,788,372,735,10,53,Center,18,Jump Shot,6.616751269035533
2009-10,1890,Shawn Marion,SF,395,778,392,759,3,19,Center,8,Layup Shot,4.876606683804627
2010-11,1890,Shawn Marion,SF,434,834,429,801,5,33,Center,14,Jump Shot,6.280575539568345
2011-12,1890,Shawn Marion,SF,288,646,268,578,20,68,Center,10,Jump Shot,7.718266253869969
2012-13,1890,Shawn Marion,PF,355,690,332,617,23,73,Center,3,Jump Shot,7.214492753623189
2013-14,1890,Shawn Marion,SF,340,707,283,546,57,161,Center,7,Jump Shot,9.462517680339463
2014-15,1890,Shawn Marion,SF,119,267,107,221,12,46,Center,5,Jump Shot,7.595505617977528
2006-07,200761,Shawne Williams,SG,75,160,56,108,19,52,Center,14,Jump Shot,13.53125
2007-08,200761,Shawne Williams,SF,159,372,116,235,43,137,Center,10,Jump Shot,14.60483870967742
2008-09,200761,Shawne Williams,SF,16,56,15,39,1,17,Center,5,Jump Shot,12.821428571428571
2010-11,200761,Shawne Williams,PF,164,385,79,173,85,212,Center,5,Jump Shot,16.727272727272727
2011-12,200761,Shawne Williams,SF,42,147,21,60,21,87,Center,3,Jump Shot,18.707482993197278
2013-14,200761,Shawne Williams,PF,73,190,31,63,42,127,Center,0,Jump Shot,19.189473684210526
2014-15,200761,Shawne Williams,SF,121,300,57,122,64,178,Right Side,6,Jump Shot,18.3
2014-15,203963,Shayne Whittington,PF,19,42,18,36,1,6,Center,4,Jump Shot,9.30952380952381
2015-16,203963,Shayne Whittington,PF,5,11,5,9,0,2,Center,1,Layup Shot,7.090909090909091
2006-07,200749,Shelden Williams,PF,166,365,164,361,2,4,Center,7,Jump Shot,8.104109589041096
2007-08,200749,Shelden Williams,PF,92,212,92,210,0,2,Center,6,Jump Shot,6.830188679245283
2008-09,200749,Shelden Williams,PF,70,157,70,155,0,2,Center,6,Jump Shot,5.6050955414012735
2009-10,200749,Shelden Williams,PF,63,121,63,120,0,1,Center,2,Layup Shot,5.016528925619835
2010-11,200749,Shelden Williams,PF,103,220,103,220,0,0,Center,3,Jump Shot,6.795454545454546
2011-12,200749,Shelden Williams,C,96,201,96,201,0,0,Center,2,Layup Shot,3.855721393034826
2016-17,1627815,Sheldon Mac,SG,30,74,23,45,7,29,Center,4,Jump Shot,14.91891891891892
2011-12,202714,Shelvin Mack,PG,88,220,76,178,12,42,Center,9,Jump Shot,11.845454545454546
2012-13,202714,Shelvin Mack,PG-SG,58,126,40,77,18,49,Center,2,Jump Shot,16.484126984126984
2013-14,202714,Shelvin Mack,PG,209,501,147,317,62,184,Center,4,Jump Shot,13.788423153692614
2014-15,202714,Shelvin Mack,PG,117,292,77,165,40,127,Center,11,Jump Shot,15.383561643835616
2015-16,202714,Shelvin Mack,PG,182,415,143,290,39,125,Center,13,Jump Shot,12.296385542168675
2016-17,202714,Shelvin Mack,PG,170,381,133,261,37,120,Center,11,Jump Shot,12.769028871391075
2017-18,202714,Shelvin Mack,PG,178,414,130,275,48,139,Center,13,Jump Shot,13.057971014492754
2018-19,202714,Shelvin Mack,PG,163,403,117,273,46,130,Center,7,Jump Shot,12.665012406947891
2010-11,202395,Sherron Collins,PG,7,25,5,15,2,10,Center,2,Jump Shot,16.92
2014-15,204021,Sim Bhullar,C,1,2,1,2,0,0,Center,1,Hook Shot,10.0
2022-23,1631323,Simone Fontecchio,SF,115,312,52,121,63,191,Center,4,Jump Shot,18.03205128205128
2017-18,1628414,Sindarius Thornwell,SG,100,233,77,172,23,61,Center,6,Jump Shot,10.184549356223176
2018-19,1628414,Sindarius Thornwell,SG,17,49,14,34,3,15,Center,2,Jump Shot,9.693877551020408
2019-20,1628414,Sindarius Thornwell,SF,6,11,4,7,2,4,Center,0,Jump Shot,13.272727272727273
2020-21,1628414,Sindarius Thornwell,SG,15,46,8,23,7,23,Center,4,Jump Shot,14.978260869565217
2016-17,1627746,Skal Labissiere,PF,117,218,114,210,3,8,Center,8,Jump Shot,8.51834862385321
2017-18,1627746,Skal Labissiere,PF,205,458,187,407,18,51,Center,9,Jump Shot,9.884279475982533
2018-19,1627746,Skal Labissiere,PF,26,49,20,36,6,13,Center,1,Jump Shot,10.448979591836734
2019-20,1627746,Skal Labissiere,C,81,147,78,134,3,13,Center,3,Jump Shot,7.761904761904762
2020-21,1630219,Skylar Mays,SG,44,98,30,58,14,40,Center,8,Jump Shot,12.846938775510203
2021-22,1630219,Skylar Mays,SG,32,64,24,39,8,25,Center,5,Jump Shot,11.5625
2022-23,1630219,Skylar Mays,SG,34,68,22,42,12,26,Center,2,Jump Shot,14.382352941176471
2003-04,2098,Slava Medvedenko,PF,237,537,237,534,0,3,Center,1,Jump Shot,10.094972067039107
2004-05,2098,Slava Medvedenko,PF,71,156,71,155,0,1,Center,10,Jump Shot,11.237179487179487
2005-06,2098,Slava Medvedenko,PF,1,2,1,2,0,0,Center,0,Hook Shot,2.5
2006-07,2098,Slava Medvedenko,C,12,29,11,27,1,2,Center,3,Jump Shot,12.517241379310345
2003-04,2582,Slavko Vranes,C,0,1,0,1,0,0,Left Side,0,Jump Shot,15.0
2004-05,2470,Smush Parker,PG,18,43,15,30,3,13,Center,2,Jump Shot,13.186046511627907
2005-06,2470,Smush Parker,PG,348,779,228,451,120,328,Center,13,Jump Shot,13.700898587933247
2006-07,2470,Smush Parker,PG,342,785,232,484,110,301,Center,12,Jump Shot,14.035668789808918
2007-08,2470,Smush Parker,PG,64,184,46,106,18,78,Center,7,Jump Shot,17.347826086956523
2010-11,202374,Solomon Alabi,C,3,15,3,15,0,0,Center,1,Jump Shot,8.666666666666666
2011-12,202374,Solomon Alabi,C,13,36,13,36,0,0,Center,5,Jump Shot,6.222222222222222
2013-14,203524,Solomon Hill,SF,17,40,10,17,7,23,Center,4,Jump Shot,16.6
2014-15,203524,Solomon Hill,SF,251,634,183,426,68,208,Center,9,Jump Shot,11.95583596214511
2015-16,203524,Solomon Hill,SF,93,208,69,134,24,74,Center,11,Jump Shot,12.221153846153847
2016-17,203524,Solomon Hill,SF,183,476,89,208,94,268,Center,2,Jump Shot,15.829831932773109
2017-18,203524,Solomon Hill,SF,11,41,7,20,4,21,Center,1,Jump Shot,16.365853658536587
2018-19,203524,Solomon Hill,SF,68,178,36,77,32,101,Center,1,Jump Shot,16.269662921348313
2019-20,203524,Solomon Hill,PF,110,278,47,107,63,171,Center,5,Jump Shot,17.705035971223023
2020-21,203524,Solomon Hill,PF,107,298,39,86,68,212,Center,1,Jump Shot,18.583892617449663
2021-22,203524,Solomon Hill,SF,3,20,1,7,2,13,Center,0,Jump Shot,17.45
2006-07,200780,Solomon Jones,PF,65,128,65,127,0,1,Center,4,Layup Shot,3.5234375
2007-08,200780,Solomon Jones,PF,12,30,12,28,0,2,Center,3,Layup Shot,5.4
2008-09,200780,Solomon Jones,C,67,111,66,109,1,2,Center,8,Jump Shot,4.675675675675675
2009-10,200780,Solomon Jones,C,78,176,78,173,0,3,Center,2,Jump Shot,9.153409090909092
2010-11,200780,Solomon Jones,C,49,121,49,120,0,1,Center,2,Jump Shot,8.446280991735538
2011-12,200780,Solomon Jones,C-PF,24,61,24,61,0,0,Center,0,Jump Shot,7.852459016393443
2012-13,200780,Solomon Jones,PF,0,1,0,1,0,0,Center,0,Jump Shot,5.0
2013-14,200780,Solomon Jones,PF,6,17,6,17,0,0,Center,1,Jump Shot,10.941176470588236
2008-09,201603,Sonny Weems,SG,8,25,8,22,0,3,Center,4,Jump Shot,12.8
2009-10,201603,Sonny Weems,SG,236,458,234,443,2,15,Center,9,Jump Shot,11.277292576419214
2010-11,201603,Sonny Weems,SF,228,513,211,452,17,61,Center,13,Jump Shot,12.265107212475634
2015-16,201603,Sonny Weems,SG-SF,42,109,27,69,15,40,Center,5,Jump Shot,13.990825688073395
2003-04,2049,Speedy Claxton,PG,224,524,220,502,4,22,Center,9,Jump Shot,10.036259541984732
2004-05,2049,Speedy Claxton,PG,257,611,246,550,11,61,Center,3,Jump Shot,10.824877250409166
2005-06,2049,Speedy Claxton,PG,304,736,287,673,17,63,Center,15,Jump Shot,10.581521739130435
2006-07,2049,Speedy Claxton,PG,91,278,85,250,6,28,Center,1,Jump Shot,12.83453237410072
2008-09,2049,Speedy Claxton,PG,2,7,2,7,0,0,Center,0,Jump Shot,10.714285714285714
2014-15,203915,Spencer Dinwiddie,PG,51,169,39,104,12,65,Center,4,Jump Shot,14.881656804733728
2015-16,203915,Spencer Dinwiddie,PG,19,54,18,44,1,10,Center,3,Jump Shot,10.24074074074074
2016-17,203915,Spencer Dinwiddie,PG,134,302,96,201,38,101,Center,6,Jump Shot,13.099337748344372
2017-18,203915,Spencer Dinwiddie,PG,324,838,183,405,141,433,Center,24,Jump Shot,16.112171837708832
2018-19,203915,Spencer Dinwiddie,PG,366,828,242,458,124,370,Center,15,Jump Shot,13.893719806763285
2019-20,203915,Spencer Dinwiddie,PG,424,1021,301,621,123,400,Center,16,Driving Layup Shot,12.809990205680705
2020-21,203915,Spencer Dinwiddie,SG,6,16,4,9,2,7,Center,0,Jump Shot,11.8125
2021-22,203915,Spencer Dinwiddie,PG-SG,306,735,194,405,112,330,Center,16,Jump Shot,15.082993197278912
2022-23,203915,Spencer Dinwiddie,PG,460,1050,279,560,181,490,Center,19,Jump Shot,15.164761904761905
2007-08,201150,Spencer Hawes,C,146,318,142,297,4,21,Center,11,Jump Shot,9.525157232704403
2008-09,201150,Spencer Hawes,C,373,800,333,685,40,115,Center,15,Jump Shot,9.58375
2009-10,201150,Spencer Hawes,C,312,666,286,579,26,87,Center,9,Jump Shot,9.123123123123124
2010-11,201150,Spencer Hawes,C,264,568,255,531,9,37,Center,1,Jump Shot,9.57218309859155
2011-12,201150,Spencer Hawes,C,156,319,153,307,3,12,Center,1,Jump Shot,9.589341692789969
2012-13,201150,Spencer Hawes,C,376,811,345,724,31,87,Center,11,Jump Shot,10.678175092478421
2013-14,201150,Spencer Hawes,C,403,883,275,575,128,308,Center,12,Jump Shot,12.582106455266139
2014-15,201150,Spencer Hawes,PF,163,415,108,239,55,176,Center,3,Jump Shot,14.828915662650603
2015-16,201150,Spencer Hawes,PF,124,306,86,204,38,102,Center,4,Jump Shot,12.607843137254902
2016-17,201150,Spencer Hawes,PF,134,276,109,196,25,80,Center,7,Jump Shot,11.467391304347826
2003-04,278,Stacey Augmon,SF,143,347,142,340,1,7,Center,1,Jump Shot,8.36599423631124
2004-05,278,Stacey Augmon,SF,68,167,68,167,0,0,Center,4,Jump Shot,7.850299401197605
2005-06,278,Stacey Augmon,SF,25,73,25,73,0,0,Center,0,Jump Shot,6.52054794520548
2015-16,1626169,Stanley Johnson,SF,225,598,162,395,63,203,Center,9,Jump Shot,13.15551839464883
2016-17,1626169,Stanley Johnson,SF,128,364,84,211,44,153,Center,4,Jump Shot,16.541208791208792
2017-18,1626169,Stanley Johnson,SF,210,560,143,326,67,234,Center,4,Jump Shot,14.825
2018-19,1626169,Stanley Johnson,SF,171,440,109,225,62,215,Center,6,Jump Shot,14.879545454545454
2019-20,1626169,Stanley Johnson,PF,22,59,15,35,7,24,Center,5,Jump Shot,13.661016949152541
2020-21,1626169,Stanley Johnson,PF,89,233,44,96,45,137,Center,8,Jump Shot,16.600858369098713
2021-22,1626169,Stanley Johnson,PF,117,251,84,146,33,105,Center,2,Jump Shot,13.235059760956176
2022-23,1626169,Stanley Johnson,SF,65,122,47,82,18,40,Center,3,Jump Shot,11.688524590163935
2022-23,1630649,Stanley Umude,SG,0,1,0,0,0,1,Right Side,0,Jump Shot,24.0
2019-20,1629742,Stanton Kidd,SG,0,3,0,2,0,1,Center,0,Driving Layup Shot,11.0
2007-08,201186,Stephane Lasme,PF-SF,32,71,32,71,0,0,Center,0,Jump Shot,6.47887323943662
2009-10,201939,Stephen Curry,PG,528,1143,362,763,166,380,Center,36,Jump Shot,16.019247594050743
2010-11,201939,Stephen Curry,PG,505,1053,354,711,151,342,Center,23,Jump Shot,15.72269705603039
2011-12,201939,Stephen Curry,PG,145,296,90,175,55,121,Center,2,Jump Shot,17.554054054054053
2012-13,201939,Stephen Curry,PG,626,1388,354,788,272,600,Center,19,Jump Shot,18.020893371757925
2013-14,201939,Stephen Curry,PG,652,1383,391,768,261,615,Center,30,Jump Shot,17.613882863340564
2014-15,201939,Stephen Curry,PG,653,1341,367,695,286,646,Center,27,Jump Shot,17.108873974645785
2015-16,201939,Stephen Curry,PG,804,1596,403,712,401,884,Center,34,Jump Shot,17.36340852130326
2016-17,201939,Stephen Curry,PG,674,1442,351,654,323,788,Center,22,Jump Shot,17.87864077669903
2017-18,201939,Stephen Curry,PG,428,864,216,363,212,501,Center,15,Jump Shot,18.449074074074073
2018-19,201939,Stephen Curry,PG,632,1340,278,530,354,810,Center,20,Jump Shot,19.258208955223882
2019-20,201939,Stephen Curry,PG,33,82,21,33,12,49,Center,0,Jump Shot,19.304878048780488
2020-21,201939,Stephen Curry,PG,658,1365,321,564,337,801,Center,29,Jump Shot,18.813919413919415
2021-22,201939,Stephen Curry,PG,535,1224,250,474,285,750,Center,23,Jump Shot,19.313725490196077
2022-23,201939,Stephen Curry,PG,559,1133,286,494,273,639,Center,23,Jump Shot,18.33362753751103
2005-06,101211,Stephen Graham,SG,21,54,19,44,2,10,Center,6,Jump Shot,11.981481481481481
2006-07,101211,Stephen Graham,SG,17,40,14,29,3,11,Center,1,Jump Shot,12.6
2007-08,101211,Stephen Graham,SF,34,58,27,44,7,14,Center,6,Jump Shot,14.068965517241379
2008-09,101211,Stephen Graham,SG,106,256,86,190,20,66,Center,5,Jump Shot,14.16015625
2009-10,101211,Stephen Graham,SG,119,240,103,190,16,50,Center,5,Jump Shot,12.179166666666667
2010-11,101211,Stephen Graham,SG,81,200,76,179,5,21,Center,3,Jump Shot,14.37
2003-04,1536,Stephen Jackson,SF,536,1261,391,834,145,427,Center,19,Jump Shot,13.613798572561459
2004-05,1536,Stephen Jackson,SF,330,819,227,533,103,286,Center,10,Jump Shot,14.619047619047619
2005-06,1536,Stephen Jackson,SG,472,1148,355,809,117,339,Center,15,Jump Shot,13.817944250871081
2006-07,1536,Stephen Jackson,SF-SG,409,944,309,633,100,311,Center,10,Jump Shot,13.54978813559322
2007-08,1536,Stephen Jackson,SF,488,1204,306,703,182,501,Center,13,Jump Shot,15.705980066445182
2008-09,1536,Stephen Jackson,SF,413,997,310,692,103,305,Center,16,Jump Shot,14.035105315947844
2009-10,1536,Stephen Jackson,SG-PF,600,1418,471,1025,129,393,Center,13,Jump Shot,12.93018335684062
2010-11,1536,Stephen Jackson,SG,435,1059,314,700,121,359,Center,20,Jump Shot,14.612842304060434
2011-12,1536,Stephen Jackson,SF,159,425,110,255,49,170,Center,4,Jump Shot,15.185882352941176
2012-13,1536,Stephen Jackson,SF,123,330,77,160,46,170,Center,2,Jump Shot,15.60909090909091
2013-14,1536,Stephen Jackson,SF,6,26,5,12,1,14,Center,0,Jump Shot,16.346153846153847
2016-17,1627757,Stephen Zimmerman,C,10,31,10,31,0,0,Center,3,Jump Shot,7.645161290322581
2003-04,950,Stephon Marbury,PG,598,1386,511,1112,87,274,Center,30,Jump Shot,12.958874458874458
2004-05,950,Stephon Marbury,PG,604,1308,489,983,115,325,Center,30,Jump Shot,11.788990825688073
2005-06,950,Stephon Marbury,PG,349,774,316,670,33,104,Center,15,Jump Shot,10.188630490956072
2006-07,950,Stephon Marbury,PG,395,952,272,607,123,345,Center,19,Jump Shot,13.065126050420169
2007-08,950,Stephon Marbury,PG,111,265,83,191,28,74,Center,5,Jump Shot,12.249056603773585
2008-09,950,Stephon Marbury,PG,38,111,32,86,6,25,Center,1,Jump Shot,14.594594594594595
2017-18,1628425,Sterling Brown,SG,82,205,50,114,32,91,Center,5,Jump Shot,14.24390243902439
2018-19,1628425,Sterling Brown,SG,145,312,92,165,53,147,Center,13,Jump Shot,13.48397435897436
2019-20,1628425,Sterling Brown,SF,95,256,51,120,44,136,Center,11,Jump Shot,15.89453125
2020-21,1628425,Sterling Brown,SG,150,335,59,120,91,215,Center,8,Jump Shot,17.367164179104478
2021-22,1628425,Sterling Brown,SG,59,155,31,63,28,92,Center,5,Jump Shot,16.612903225806452
2022-23,1628425,Sterling Brown,SG,0,4,0,2,0,2,Center,0,Jump Shot,13.0
2003-04,2581,Steve Blake,PG,157,407,82,205,75,202,Center,13,Jump Shot,19.029484029484028
2004-05,2581,Steve Blake,PG,61,186,25,93,36,93,Center,1,Jump Shot,19.349462365591396
2005-06,2581,Steve Blake,PG,206,470,130,286,76,184,Center,14,Jump Shot,18.617021276595743
2006-07,2581,Steve Blake,PG,209,509,142,301,67,208,Center,11,Jump Shot,18.461689587426328
2007-08,2581,Steve Blake,PG,261,640,140,342,121,298,Center,9,Jump Shot,19.2953125
2008-09,2581,Steve Blake,PG,277,647,137,319,140,328,Center,9,Jump Shot,18.531684698608963
2009-10,2581,Steve Blake,PG,217,522,101,228,116,294,Center,12,Jump Shot,19.720306513409962
2010-11,2581,Steve Blake,PG,110,306,37,113,73,193,Left Side,2,Jump Shot,21.405228758169933
2011-12,2581,Steve Blake,PG,101,268,48,110,53,158,Left Side,3,Jump Shot,20.69776119402985
2012-13,2581,Steve Blake,PG,114,270,42,99,72,171,Center,4,Jump Shot,20.503703703703703
2013-14,2581,Steve Blake,PG,133,353,54,143,79,210,Center,10,Jump Shot,20.379603399433428
2014-15,2581,Steve Blake,PG,121,326,45,108,76,218,Left Side Center,0,Jump Shot,21.687116564417177
2015-16,2581,Steve Blake,PG,93,240,41,89,52,151,Center,1,Jump Shot,20.970833333333335
2003-04,1883,Steve Francis,PG,450,1117,377,867,73,250,Center,22,Jump Shot,13.548791405550581
2004-05,1883,Steve Francis,PG,563,1330,525,1203,38,127,Center,27,Jump Shot,11.556390977443609
2005-06,1883,Steve Francis,PG-SG,333,765,308,682,25,83,Center,25,Jump Shot,10.66797385620915
2006-07,1883,Steve Francis,SG,140,343,98,232,42,111,Center,6,Jump Shot,13.860058309037901
2007-08,1883,Steve Francis,PG,19,57,15,40,4,17,Center,1,Jump Shot,13.649122807017545
2003-04,959,Steve Nash,PG,397,845,293,588,104,257,Center,23,Jump Shot,13.964497041420119
2004-05,959,Steve Nash,PG,430,857,336,639,94,218,Center,16,Jump Shot,14.198366394399066
2005-06,959,Steve Nash,PG,541,1056,391,714,150,342,Center,29,Jump Shot,14.639204545454545
2006-07,959,Steve Nash,PG,517,971,361,628,156,343,Center,24,Jump Shot,14.753861997940268
2007-08,959,Steve Nash,PG,485,962,306,581,179,381,Center,23,Jump Shot,16.72141372141372
2008-09,959,Steve Nash,PG,428,851,320,605,108,246,Center,31,Jump Shot,14.788484136310224
2009-10,959,Steve Nash,PG,499,985,375,694,124,291,Center,32,Jump Shot,15.494416243654822
2010-11,959,Steve Nash,PG,399,811,318,606,81,205,Center,29,Jump Shot,14.272503082614056
2011-12,959,Steve Nash,PG,295,555,240,414,55,141,Center,15,Jump Shot,14.571171171171171
2012-13,959,Steve Nash,PG,236,475,179,345,57,130,Center,10,Jump Shot,14.656842105263157
2013-14,959,Steve Nash,PG,36,94,28,70,8,24,Center,0,Jump Shot,15.170212765957446
2006-07,200779,Steve Novak,SF,18,50,5,11,13,39,Right Side Center,6,Jump Shot,22.14
2007-08,200779,Steve Novak,SF,49,102,15,31,34,71,Right Side Center,8,Jump Shot,22.598039215686274
2008-09,200779,Steve Novak,PF,176,395,57,110,119,285,Left Side Center,16,Jump Shot,22.962025316455698
2009-10,200779,Steve Novak,SF,42,108,20,37,22,71,Left Side Center,9,Jump Shot,22.87962962962963
2010-11,200779,Steve Novak,SF,35,67,9,21,26,46,Right Side Center,9,Jump Shot,22.253731343283583
2011-12,200779,Steve Novak,PF,161,337,28,55,133,282,Right Side Center,8,Jump Shot,23.258160237388726
2012-13,200779,Steve Novak,SF,178,430,29,79,149,351,Right Side Center,5,Jump Shot,23.227906976744187
2013-14,200779,Steve Novak,PF,60,146,8,24,52,122,Right Side Center,0,Jump Shot,23.376712328767123
2014-15,200779,Steve Novak,SF-PF,22,56,3,8,19,48,Right Side Center,4,Jump Shot,23.964285714285715
2015-16,200779,Steve Novak,PF,8,18,1,3,7,15,Left Side,6,Jump Shot,23.166666666666668
2016-17,200779,Steve Novak,PF,2,7,1,1,1,6,Left Side Center,2,Jump Shot,22.857142857142858
2013-14,203500,Steven Adams,C,93,185,93,185,0,0,Center,4,Layup Shot,2.6972972972972973
2014-15,203500,Steven Adams,C,217,399,217,397,0,2,Center,5,Layup Shot,2.917293233082707
2015-16,203500,Steven Adams,C,261,426,261,426,0,0,Center,6,Layup Shot,2.1572769953051645
2016-17,203500,Steven Adams,C,374,655,374,654,0,1,Center,9,Layup Shot,3.2961832061068703
2017-18,203500,Steven Adams,C,448,712,448,710,0,2,Center,13,Layup Shot,2.6474719101123596
2018-19,203500,Steven Adams,C,481,809,481,807,0,2,Center,8,Layup Shot,3.042027194066749
2019-20,203500,Steven Adams,C,283,478,282,475,1,3,Center,9,Hook Shot,3.8870292887029287
2020-21,203500,Steven Adams,C,189,308,189,305,0,3,Center,5,Layup Shot,3.4642857142857144
2021-22,203500,Steven Adams,C,210,384,210,383,0,1,Center,1,Tip Layup Shot,2.5026041666666665
2022-23,203500,Steven Adams,C,157,263,157,262,0,1,Center,5,Tip Layup Shot,2.1901140684410647
2008-09,201631,Steven Hill,PF,1,1,1,1,0,0,Center,1,Tip Shot,0.0
2003-04,2212,Steven Hunter,C,82,155,82,155,0,0,Center,5,Layup Shot,2.0838709677419356
2004-05,2212,Steven Hunter,C,135,220,135,219,0,1,Center,6,Layup Shot,2.0681818181818183
2005-06,2212,Steven Hunter,C,175,291,175,291,0,0,Center,3,Layup Shot,1.9484536082474226
2006-07,2212,Steven Hunter,PF,188,326,188,326,0,0,Center,2,Layup Shot,3.374233128834356
2007-08,2212,Steven Hunter,C,15,28,15,28,0,0,Center,4,Layup Shot,2.2142857142857144
2009-10,2212,Steven Hunter,C,17,43,17,43,0,0,Center,3,Layup Shot,3.046511627906977
2003-04,120,Steven Smith,SG,119,293,76,186,43,107,Center,9,Jump Shot,14.30716723549488
2004-05,120,Steven Smith,SG,102,248,61,143,41,105,Left Side,2,Jump Shot,16.911290322580644
2006-07,200848,Steven Smith,PF,2,8,2,8,0,0,Right Side,0,Jump Shot,10.25
2003-04,2031,Stromile Swift,PF,268,571,267,567,1,4,Center,15,Jump Shot,6.861646234676007
2004-05,2031,Stromile Swift,PF,219,488,219,484,0,4,Center,9,Jump Shot,5.897540983606557
2005-06,2031,Stromile Swift,C,225,458,225,456,0,2,Center,10,Jump Shot,5.283842794759825
2006-07,2031,Stromile Swift,C,161,346,161,341,0,5,Center,8,Jump Shot,6.023121387283237
2007-08,2031,Stromile Swift,PF,135,265,135,263,0,2,Center,8,Jump Shot,6.026415094339622
2008-09,2031,Stromile Swift,PF,24,56,23,55,1,1,Center,1,Jump Shot,6.053571428571429
2008-09,201180,Sun Sun,SG,3,11,3,5,0,6,Right Side Center,3,Jump Shot,19.727272727272727
2009-10,202178,Sundiata Gaines,PG,38,82,31,56,7,26,Center,12,Jump Shot,14.378048780487806
2010-11,202178,Sundiata Gaines,PG,42,105,33,67,9,38,Center,1,Jump Shot,15.095238095238095
2011-12,202178,Sundiata Gaines,SG,102,271,74,189,28,82,Center,21,Jump Shot,13.874538745387454
2018-19,1629004,Svi Mykhailiuk,SF,46,140,17,51,29,89,Center,7,Jump Shot,18.814285714285713
2019-20,1629004,Svi Mykhailiuk,SF,166,405,51,120,115,285,Center,11,Jump Shot,18.97530864197531
2020-21,1629004,Svi Mykhailiuk,SF-SG,208,506,103,192,105,314,Center,6,Jump Shot,17.14426877470356
2021-22,1629004,Svi Mykhailiuk,SF,91,234,50,100,41,134,Center,8,Jump Shot,16.521367521367523
2022-23,1629004,Svi Mykhailiuk,SF,77,173,35,74,42,99,Center,3,Jump Shot,16.728323699421967
2003-04,2551,T.J. Ford,PG,153,398,148,377,5,21,Center,3,Jump Shot,9.155778894472363
2005-06,2551,T.J. Ford,PG,328,789,293,685,35,104,Center,14,Jump Shot,9.967046894803548
2006-07,2551,T.J. Ford,PG,393,902,372,833,21,69,Center,22,Jump Shot,10.83370288248337
2007-08,2551,T.J. Ford,PG,246,524,231,473,15,51,Center,11,Jump Shot,10.853053435114504
2008-09,2551,T.J. Ford,PG,413,913,378,809,35,104,Center,28,Jump Shot,10.29353778751369
2009-10,2551,T.J. Ford,PG,186,418,178,368,8,50,Center,7,Jump Shot,11.15311004784689
2010-11,2551,T.J. Ford,PG,91,236,85,204,6,32,Center,4,Jump Shot,12.75
2011-12,2551,T.J. Ford,PG,19,43,17,35,2,8,Center,2,Jump Shot,14.976744186046512
2017-18,1628388,T.J. Leaf,,64,136,46,94,18,42,Center,7,Jump Shot,11.316176470588236
2018-19,1628388,T.J. Leaf,,99,183,91,152,8,31,Center,13,Jump Shot,7.612021857923497
2019-20,1628388,T.J. Leaf,,36,86,31,68,5,18,Center,4,Jump Shot,8.081395348837209
2020-21,1628388,T.J. Leaf,,5,10,5,10,0,0,Center,2,Turnaround Hook Shot,2.3
2015-16,204456,T.J. McConnell,PG,218,464,187,375,31,89,Center,9,Jump Shot,12.359913793103448
2016-17,204456,T.J. McConnell,PG,235,510,225,457,10,53,Center,14,Jump Shot,8.66470588235294
2017-18,204456,T.J. McConnell,PG,210,421,183,359,27,62,Center,6,Pullup Jump shot,10.783847980997624
2018-19,204456,T.J. McConnell,PG,220,419,206,377,14,42,Center,6,Pullup Jump shot,10.446300715990454
2019-20,204456,T.J. McConnell,PG,212,411,207,394,5,17,Center,0,Pullup Jump shot,8.211678832116789
2020-21,204456,T.J. McConnell,PG,274,490,259,442,15,48,Center,7,Pullup Jump shot,7.9346938775510205
2021-22,204456,T.J. McConnell,PG,100,208,90,175,10,33,Center,6,Pullup Jump shot,9.567307692307692
2022-23,204456,T.J. McConnell,PG,283,521,257,462,26,59,Center,5,Pullup Jump shot,8.06333973128599
2014-15,203933,T.J. Warren,SF,113,214,108,193,5,21,Center,10,Jump Shot,7.607476635514018
2015-16,203933,T.J. Warren,SF,221,441,193,371,28,70,Center,6,Jump Shot,10.852607709750567
2016-17,203933,T.J. Warren,SF,403,814,377,716,26,98,Center,12,Jump Shot,10.217444717444717
2017-18,203933,T.J. Warren,SF,529,1063,509,973,20,90,Center,12,Jump Shot,8.754468485418627
2018-19,203933,T.J. Warren,SF,297,611,220,431,77,180,Center,12,Jump Shot,11.567921440261866
2019-20,203933,T.J. Warren,SF,534,997,443,771,91,226,Center,19,Jump Shot,11.542627883650953
2020-21,203933,T.J. Warren,SF,27,51,27,44,0,7,Center,0,Pullup Jump shot,10.27450980392157
2022-23,203933,T.J. Warren,PF-SF,132,270,110,203,22,67,Center,1,Jump Shot,12.5
2019-20,1629605,Tacko Fall,C,11,14,11,14,0,0,Center,6,Dunk Shot,2.2142857142857144
2020-21,1629605,Tacko Fall,C,21,29,21,29,0,0,Center,10,Layup Shot,2.9310344827586206
2021-22,1629605,Tacko Fall,C,5,12,5,12,0,0,Center,0,Alley Oop Dunk Shot,2.75
2018-19,1628769,Tahjere McCall,SG,2,3,2,2,0,1,Center,0,Driving Layup Shot,8.0
2009-10,201959,Taj Gibson,PF,311,629,311,629,0,0,Center,4,Jump Shot,6.969793322734499
2010-11,201959,Taj Gibson,PF,234,502,233,494,1,8,Center,5,Jump Shot,8.645418326693227
2011-12,201959,Taj Gibson,PF,200,404,200,404,0,0,Center,6,Jump Shot,7.292079207920792
2012-13,201959,Taj Gibson,PF,214,441,214,437,0,4,Center,7,Jump Shot,7.387755102040816
2013-14,201959,Taj Gibson,PF,429,896,429,889,0,7,Center,15,Jump Shot,8.016741071428571
2014-15,201959,Taj Gibson,PF,254,506,254,506,0,0,Center,8,Jump Shot,5.100790513833992
2015-16,201959,Taj Gibson,PF,263,500,263,497,0,3,Center,6,Jump Shot,5.744
2016-17,201959,Taj Gibson,PF,365,709,362,696,3,13,Center,3,Jump Shot,6.485190409026798
2017-18,201959,Taj Gibson,PF,425,737,418,702,7,35,Center,16,Jump Shot,6.455902306648575
2018-19,201959,Taj Gibson,PF,304,537,293,503,11,34,Center,9,Layup Shot,5.4487895716946
2019-20,201959,Taj Gibson,C,167,286,163,272,4,14,Center,1,Jump Shot,6.244755244755245
2020-21,201959,Taj Gibson,C,99,158,96,143,3,15,Center,2,Jump Shot,5.3924050632911396
2021-22,201959,Taj Gibson,C,86,166,71,128,15,38,Center,2,Jump Shot,9.493975903614459
2022-23,201959,Taj Gibson,C,65,125,57,101,8,24,Center,3,Jump Shot,9.736
2019-20,1629659,Talen Horton-Tucker,SG,14,30,10,17,4,13,Center,0,Jump Shot,12.633333333333333
2020-21,1629659,Talen Horton-Tucker,SG,224,489,187,358,37,131,Center,12,Driving Layup Shot,9.830265848670757
2021-22,1629659,Talen Horton-Tucker,SG,224,538,175,356,49,182,Center,12,Jump Shot,12.297397769516728
2022-23,1629659,Talen Horton-Tucker,SG,257,613,199,410,58,203,Center,14,Driving Layup Shot,12.241435562805872
2003-04,2447,Tamar Slay,SG,21,60,17,48,4,12,Center,2,Jump Shot,13.65
2004-05,2447,Tamar Slay,SG,13,39,11,27,2,12,Center,1,Jump Shot,14.692307692307692
2006-07,200814,Tarence Kinsey,SG,139,304,126,258,13,46,Center,15,Jump Shot,12.453947368421053
2007-08,200814,Tarence Kinsey,SG,16,38,13,31,3,7,Center,6,Jump Shot,14.105263157894736
2008-09,200814,Tarence Kinsey,SG,31,69,24,51,7,18,Center,3,Jump Shot,13.057971014492754
2022-23,1631106,Tari Eason,PF,296,660,237,488,59,172,Center,14,Jump Shot,8.724242424242425
2014-15,204028,Tarik Black,C,157,273,157,272,0,1,Center,6,Layup Shot,2.989010989010989
2015-16,204028,Tarik Black,C,57,104,57,104,0,0,Center,3,Layup Shot,2.6346153846153846
2016-17,204028,Tarik Black,C,150,294,149,292,1,2,Center,3,Layup Shot,2.9285714285714284
2017-18,204028,Tarik Black,C,75,127,74,116,1,11,Center,6,Cutting Layup Shot,4.251968503937008
2019-20,1629745,Tariq Owens,PF,1,5,1,3,0,2,Center,0,Jump Shot,14.2
2007-08,201192,Taurean Green,SG-PG,7,25,5,14,2,11,Center,5,Jump Shot,18.84
2016-17,1627752,Taurean Prince,SF,114,285,81,183,33,102,Center,10,Jump Shot,11.887719298245614
2017-18,1627752,Taurean Prince,SF,415,975,239,518,176,457,Center,22,Jump Shot,14.910769230769231
2018-19,1627752,Taurean Prince,SF,262,594,139,279,123,315,Center,10,Jump Shot,16.468013468013467
2019-20,1627752,Taurean Prince,PF,278,739,132,308,146,431,Center,7,Jump Shot,16.956698240866036
2020-21,1627752,Taurean Prince,PF,131,327,69,172,62,155,Center,2,Jump Shot,15.388379204892967
2021-22,1627752,Taurean Prince,PF,177,390,91,161,86,229,Center,0,Jump Shot,16.66923076923077
2022-23,1627752,Taurean Prince,SF,177,379,103,185,74,194,Center,3,Jump Shot,15.147757255936675
2009-10,201981,Taylor Griffin,SF,4,10,4,8,0,2,Right Side,2,Jump Shot,11.4
2003-04,2419,Tayshaun Prince,SF,338,723,281,566,57,157,Center,8,Jump Shot,11.312586445366529
2004-05,2419,Tayshaun Prince,SF,469,963,422,825,47,138,Center,12,Jump Shot,10.28245067497404
2005-06,2419,Tayshaun Prince,SF,455,999,391,816,64,183,Center,14,Jump Shot,11.944944944944945
2006-07,2419,Tayshaun Prince,SF,459,997,378,787,81,210,Center,17,Jump Shot,11.29087261785356
2007-08,2419,Tayshaun Prince,SF,421,940,368,794,53,146,Center,11,Jump Shot,11.903191489361703
2008-09,2419,Tayshaun Prince,SF,459,1020,403,879,56,141,Center,11,Jump Shot,12.003921568627451
2009-10,2419,Tayshaun Prince,SF,282,580,255,507,27,73,Center,13,Jump Shot,12.079310344827586
2010-11,2419,Tayshaun Prince,SF,473,1001,439,903,34,98,Center,14,Jump Shot,11.71928071928072
2011-12,2419,Tayshaun Prince,SF,336,798,299,694,37,104,Center,7,Jump Shot,12.580200501253133
2012-13,2419,Tayshaun Prince,SF,359,820,321,726,38,94,Center,9,Jump Shot,11.951219512195122
2013-14,2419,Tayshaun Prince,SF,200,492,180,423,20,69,Center,6,Jump Shot,13.300813008130081
2014-15,2419,Tayshaun Prince,SF,177,402,146,335,31,67,Center,11,Jump Shot,13.624378109452737
2015-16,2419,Tayshaun Prince,SF,102,229,98,206,4,23,Center,5,Jump Shot,14.449781659388647
2019-20,1629611,Terance Mann,SF,37,79,30,59,7,20,Center,5,Jump Shot,9.544303797468354
2020-21,1629611,Terance Mann,SG,178,350,140,259,38,91,Center,16,Jump Shot,9.957142857142857
2021-22,1629611,Terance Mann,SF,334,690,258,482,76,208,Center,15,Jump Shot,11.797101449275363
2022-23,1629611,Terance Mann,SG,272,524,195,326,77,198,Center,15,Jump Shot,11.979007633587786
2019-20,1629056,Terence Davis,SG,199,436,105,194,94,242,Center,9,Jump Shot,15.311926605504587
2020-21,1629056,Terence Davis,SG,195,456,97,189,98,267,Center,13,Jump Shot,16.12719298245614
2021-22,1629056,Terence Davis,SG,113,267,64,118,49,149,Center,5,Jump Shot,15.816479400749063
2022-23,1629056,Terence Davis,SG,154,364,65,121,89,243,Center,10,Jump Shot,18.335164835164836
2005-06,2242,Terence Morris,SF,16,49,16,47,0,2,Center,5,Jump Shot,14.183673469387756
2017-18,1628390,Terrance Ferguson,SG,70,169,30,49,40,120,Center,9,Jump Shot,19.02958579881657
2018-19,1628390,Terrance Ferguson,SG,185,431,79,141,106,290,Center,9,Jump Shot,17.707656612529004
2019-20,1628390,Terrance Ferguson,SF,78,220,29,52,49,168,Center,1,Jump Shot,19.913636363636364
2020-21,1628390,Terrance Ferguson,SG,1,7,1,2,0,5,Right Side Center,1,Jump Shot,19.428571428571427
2011-12,202227,Terrel Harris,SG,29,83,21,44,8,39,Center,3,Jump Shot,13.180722891566266
2012-13,202227,Terrel Harris,SG,4,27,4,19,0,8,Center,0,Jump Shot,12.851851851851851
2012-13,203093,Terrence Jones,PF,43,94,38,75,5,19,Center,3,Jump Shot,8.76595744680851
2013-14,203093,Terrence Jones,PF,386,712,355,611,31,101,Center,8,Jump Shot,6.59691011235955
2014-15,203093,Terrence Jones,PF,158,299,145,262,13,37,Center,6,Jump Shot,6.294314381270903
2015-16,203093,Terrence Jones,PF,165,366,141,288,24,78,Center,7,Jump Shot,8.415300546448087
2016-17,203093,Terrence Jones,PF,231,492,212,417,19,75,Center,8,Jump Shot,8.195121951219512
2018-19,203093,Terrence Jones,PF,1,4,1,2,0,2,Center,0,Jump Shot,13.25
2012-13,203082,Terrence Ross,SG,186,456,121,261,65,195,Center,10,Jump Shot,17.04824561403509
2013-14,203082,Terrence Ross,SG,318,750,157,343,161,407,Center,10,Jump Shot,17.729333333333333
2014-15,203082,Terrence Ross,SF,309,752,164,363,145,389,Center,8,Jump Shot,17.46808510638298
2015-16,203082,Terrence Ross,SF,270,623,139,287,131,336,Center,5,Jump Shot,18.86195826645265
2016-17,203082,Terrence Ross,SF,326,746,184,355,142,391,Center,8,Jump Shot,18.380697050938338
2017-18,203082,Terrence Ross,SG,76,191,46,98,30,93,Center,3,Jump Shot,17.712041884816752
2018-19,203082,Terrence Ross,SG,440,1027,223,461,217,566,Center,16,Jump Shot,20.15774099318403
2019-20,203082,Terrence Ross,SG,341,846,164,342,177,504,Center,9,Jump Shot,19.61583924349882
2020-21,203082,Terrence Ross,SG,254,616,165,352,89,264,Center,10,Pullup Jump shot,17.788961038961038
2021-22,203082,Terrence Ross,SG,220,554,143,290,77,264,Center,0,Jump Shot,17.53971119133574
2022-23,203082,Terrence Ross,SG,200,465,105,207,95,258,Center,2,Jump Shot,19.212903225806453
2009-10,201944,Terrence Williams,SF,261,651,230,551,31,100,Center,13,Jump Shot,10.565284178187405
2010-11,201944,Terrence Williams,SG,43,115,37,93,6,22,Center,5,Jump Shot,11.88695652173913
2011-12,201944,Terrence Williams,SG,85,198,69,152,16,46,Center,4,Jump Shot,13.691919191919192
2012-13,201944,Terrence Williams,SF,48,97,43,82,5,15,Center,5,Jump Shot,10.989690721649485
2015-16,1626179,Terry Rozier,PG,29,106,23,79,6,27,Center,6,Jump Shot,12.433962264150944
2016-17,1626179,Terry Rozier,PG,150,409,94,232,56,177,Center,8,Jump Shot,15.122249388753056
2017-18,1626179,Terry Rozier,PG,316,800,163,398,153,402,Center,18,Jump Shot,16.84375
2018-19,1626179,Terry Rozier,PG,258,666,139,329,119,337,Center,7,Jump Shot,16.45795795795796
2019-20,1626179,Terry Rozier,PG,398,941,226,518,172,423,Center,26,Jump Shot,15.075451647183847
2020-21,1626179,Terry Rozier,SG,510,1134,288,563,222,571,Center,32,Jump Shot,16.05026455026455
2021-22,1626179,Terry Rozier,SG,518,1167,296,574,222,593,Center,26,Jump Shot,15.867180805484148
2022-23,1626179,Terry Rozier,SG,493,1188,328,683,165,505,Center,26,Pullup Jump shot,14.56986531986532
2021-22,1630678,Terry Taylor,SG,135,220,123,182,12,38,Center,3,Jump Shot,6.718181818181818
2022-23,1630678,Terry Taylor,PF,39,75,34,56,5,19,Center,6,Jump Shot,8.493333333333334
2006-07,200757,Thabo Sefolosha,SG,109,256,94,214,15,42,Center,11,Jump Shot,12.0234375
2007-08,200757,Thabo Sefolosha,SG,180,421,151,333,29,88,Center,9,Jump Shot,12.864608076009501
2008-09,200757,Thabo Sefolosha,SF-SG,152,357,128,270,24,87,Center,13,Jump Shot,12.361344537815127
2009-10,200757,Thabo Sefolosha,SG,194,441,153,310,41,131,Center,5,Jump Shot,12.183673469387756
2010-11,200757,Thabo Sefolosha,SG,157,333,129,231,28,102,Center,3,Jump Shot,12.033033033033034
2011-12,200757,Thabo Sefolosha,SG,67,155,36,84,31,71,Center,2,Jump Shot,14.335483870967742
2012-13,200757,Thabo Sefolosha,SG,224,466,116,208,108,258,Center,7,Jump Shot,15.63519313304721
2013-14,200757,Thabo Sefolosha,SG,141,340,93,188,48,152,Center,5,Jump Shot,13.83529411764706
2014-15,200757,Thabo Sefolosha,SF,104,249,79,171,25,78,Center,7,Jump Shot,10.875502008032129
2015-16,200757,Thabo Sefolosha,SF,188,371,146,248,42,123,Center,1,Jump Shot,11.943396226415095
2016-17,200757,Thabo Sefolosha,SF,174,395,133,275,41,120,Center,3,Jump Shot,12.08860759493671
2017-18,200757,Thabo Sefolosha,SF,118,240,86,156,32,84,Center,7,Jump Shot,12.3125
2018-19,200757,Thabo Sefolosha,SF,71,149,37,71,34,78,Center,5,Jump Shot,15.006711409395972
2019-20,200757,Thabo Sefolosha,PF,37,91,22,37,15,54,Center,1,Jump Shot,16.428571428571427
2007-08,201152,Thaddeus Young,PF,264,490,258,471,6,19,Center,14,Jump Shot,5.973469387755102
2008-09,201152,Thaddeus Young,PF,475,960,419,796,56,164,Center,19,Jump Shot,9.347916666666666
2009-10,201152,Thaddeus Young,PF,382,813,334,675,48,138,Center,9,Jump Shot,8.441574415744157
2010-11,201152,Thaddeus Young,PF,458,847,452,825,6,22,Center,17,Jump Shot,6.807556080283353
2011-12,201152,Thaddeus Young,PF,348,687,347,683,1,4,Center,10,Jump Shot,7.346433770014556
2012-13,201152,Thaddeus Young,PF,509,958,508,950,1,8,Center,22,Jump Shot,6.531315240083507
2013-14,201152,Thaddeus Young,PF,582,1283,492,991,90,292,Center,29,Jump Shot,9.865159781761497
2014-15,201152,Thaddeus Young,PF,451,968,413,853,38,115,Center,13,Jump Shot,8.099173553719009
2015-16,201152,Thaddeus Young,PF,495,963,488,933,7,30,Center,17,Jump Shot,6.562824506749741
2016-17,201152,Thaddeus Young,PF,362,687,317,569,45,118,Center,4,Jump Shot,7.796215429403202
2017-18,201152,Thaddeus Young,PF,421,864,363,683,58,181,Center,9,Jump Shot,9.202546296296296
2018-19,201152,Thaddeus Young,PF,443,841,392,695,51,146,Center,16,Jump Shot,7.302021403091557
2019-20,201152,Thaddeus Young,PF,269,601,190,379,79,222,Center,4,Jump Shot,11.434276206322796
2020-21,201152,Thaddeus Young,PF,370,662,358,617,12,45,Center,8,Driving Layup Shot,5.231117824773414
2021-22,201152,Thaddeus Young,PF,141,272,124,224,17,48,Center,9,Jump Shot,7.2463235294117645
2022-23,201152,Thaddeus Young,PF,108,198,102,164,6,34,Center,4,Jump Shot,7.47979797979798
2015-16,203648,Thanasis Antetokounmpo,SF,3,4,3,3,0,1,Center,3,Dunk Shot,7.0
2019-20,203648,Thanasis Antetokounmpo,SF,24,48,24,38,0,10,Center,7,Jump Shot,7.625
2020-21,203648,Thanasis Antetokounmpo,SF,67,137,60,108,7,29,Center,8,Jump Shot,7.91970802919708
2021-22,203648,Thanasis Antetokounmpo,SF,70,128,68,114,2,14,Center,13,Layup Shot,4.8671875
2022-23,203648,Thanasis Antetokounmpo,SF,20,46,20,38,0,8,Center,5,Driving Dunk Shot,7.282608695652174
2020-21,1630177,Theo Maledon,PG,226,614,121,301,105,313,Center,10,Jump Shot,16.257328990228014
2021-22,1630177,Theo Maledon,PG,119,317,75,167,44,150,Center,11,Jump Shot,14.77602523659306
2022-23,1630177,Theo Maledon,PG,102,254,74,159,28,95,Center,6,Jump Shot,13.472440944881889
2018-19,1629033,Theo Pinson,SG,25,73,13,27,12,46,Center,2,Jump Shot,18.493150684931507
2019-20,1629033,Theo Pinson,SG,45,155,30,75,15,80,Center,3,Jump Shot,15.406451612903226
2020-21,1629033,Theo Pinson,SG,1,9,1,1,0,8,Left Side Center,1,Jump Shot,24.444444444444443
2021-22,1629033,Theo Pinson,SF,14,39,4,9,10,30,Left Side Center,3,Jump Shot,21.358974358974358
2022-23,1629033,Theo Pinson,SG,31,87,9,25,22,62,Center,5,Jump Shot,19.20689655172414
2003-04,689,Theo Ratliff,C,266,549,266,549,0,0,Center,8,Jump Shot,6.595628415300546
2004-05,689,Theo Ratliff,C,115,257,115,257,0,0,Center,3,Jump Shot,5.556420233463035
2005-06,689,Theo Ratliff,C,108,189,108,189,0,0,Center,4,Jump Shot,5.126984126984127
2006-07,689,Theo Ratliff,C,1,3,1,3,0,0,Center,0,Layup Shot,5.0
2007-08,689,Theo Ratliff,C-PF,41,85,41,84,0,1,Center,1,Jump Shot,5.341176470588235
2008-09,689,Theo Ratliff,C,34,64,34,64,0,0,Center,0,Layup Shot,2.84375
2009-10,689,Theo Ratliff,C,70,152,70,152,0,0,Center,4,Jump Shot,5.828947368421052
2010-11,689,Theo Ratliff,C,1,6,1,6,0,0,Center,0,Jump Shot,5.166666666666667
2003-04,2604,Theron Smith,SF,16,43,10,31,6,12,Center,0,Jump Shot,11.953488372093023
2004-05,2604,Theron Smith,SF,44,136,41,124,3,12,Center,1,Jump Shot,11.713235294117647
2017-18,1628418,Thomas Bryant,C,8,21,7,11,1,10,Center,4,Jump Shot,15.619047619047619
2018-19,1628418,Thomas Bryant,C,309,502,276,403,33,99,Center,19,Jump Shot,8.49800796812749
2019-20,1628418,Thomas Bryant,C,243,418,206,327,37,91,Center,9,Jump Shot,10.311004784688995
2020-21,1628418,Thomas Bryant,C,59,91,50,70,9,21,Center,3,Jump Shot,9.835164835164836
2021-22,1628418,Thomas Bryant,C,77,148,65,106,12,42,Center,4,Jump Shot,11.0
2022-23,1628418,Thomas Bryant,C,230,369,204,310,26,59,Center,9,Jump Shot,7.975609756097561
2007-08,201242,Thomas Gardner,SG,9,23,6,11,3,12,Center,1,Jump Shot,17.565217391304348
2008-09,201242,Thomas Gardner,SG,9,36,5,13,4,23,Center,3,Jump Shot,21.694444444444443
2012-13,203080,Thomas Robinson,PF,138,321,138,320,0,1,Center,5,Jump Shot,5.006230529595015
2013-14,203080,Thomas Robinson,PF,141,293,141,292,0,1,Center,8,Layup Shot,6.146757679180888
2014-15,203080,Thomas Robinson,PF,126,260,126,258,0,2,Center,7,Jump Shot,5.530769230769231
2015-16,203080,Thomas Robinson,PF,130,291,130,290,0,1,Center,11,Layup Shot,4.790378006872852
2016-17,203080,Thomas Robinson,PF,105,196,105,195,0,1,Center,6,Jump Shot,3.8469387755102042
2018-19,1629118,Thomas Welsh,C,7,13,4,6,3,7,Center,3,Jump Shot,19.692307692307693
2016-17,1627748,Thon Maker,C,81,179,55,107,26,72,Center,8,Jump Shot,12.810055865921788
2017-18,1627748,Thon Maker,C,130,316,99,212,31,104,Center,7,Jump Shot,13.376582278481013
2018-19,1627748,Thon Maker,C-PF,109,268,60,115,49,153,Center,8,Jump Shot,15.694029850746269
2019-20,1627748,Thon Maker,C,93,193,71,129,22,64,Center,8,Jump Shot,11.55958549222798
2020-21,1627748,Thon Maker,C,10,18,10,16,0,2,Center,5,Jump Shot,6.666666666666667
2010-11,201168,Tiago Splitter,C,101,191,101,190,0,1,Center,9,Layup Shot,3.413612565445026
2011-12,201168,Tiago Splitter,C,212,343,212,343,0,0,Center,6,Layup Shot,2.857142857142857
2012-13,201168,Tiago Splitter,PF,315,563,315,561,0,2,Center,6,Layup Shot,2.5879218472468914
2013-14,201168,Tiago Splitter,C,181,346,181,343,0,3,Center,3,Layup Shot,3.3294797687861273
2014-15,201168,Tiago Splitter,C,169,303,169,303,0,0,Center,3,Layup Shot,2.742574257425743
2015-16,201168,Tiago Splitter,C,81,155,81,153,0,2,Center,0,Layup Shot,3.0387096774193547
2016-17,201168,Tiago Splitter,C,14,31,12,25,2,6,Center,3,Layup Shot,6.387096774193548
2015-16,202353,Tibor Pleiss,C,11,25,11,23,0,2,Center,2,Jump Shot,6.12
2003-04,2357,Tierre Brown,PG,2,4,2,4,0,0,Right Side,0,Jump Shot,8.75
2004-05,2357,Tierre Brown,PG,124,348,98,276,26,72,Center,1,Jump Shot,11.160919540229886
2003-04,1495,Tim Duncan,PF,592,1181,590,1169,2,12,Center,20,Jump Shot,7.325994919559696
2004-05,1495,Tim Duncan,PF,517,1042,514,1033,3,9,Center,14,Jump Shot,7.782149712092131
2005-06,1495,Tim Duncan,PF,574,1185,572,1180,2,5,Center,13,Jump Shot,7.084388185654008
2006-07,1495,Tim Duncan,C,618,1131,617,1122,1,9,Center,18,Jump Shot,6.220159151193634
2007-08,1495,Tim Duncan,C,585,1178,585,1174,0,4,Center,25,Jump Shot,6.804753820033956
2008-09,1495,Tim Duncan,C,558,1107,558,1105,0,2,Center,14,Jump Shot,7.562782294489612
2009-10,1495,Tim Duncan,C,561,1082,559,1071,2,11,Center,17,Jump Shot,7.848428835489834
2010-11,1495,Tim Duncan,C,419,838,419,834,0,4,Center,6,Jump Shot,8.547732696897375
2011-12,1495,Tim Duncan,C,361,733,361,729,0,4,Center,11,Jump Shot,9.211459754433834
2012-13,1495,Tim Duncan,C,490,976,488,969,2,7,Center,20,Jump Shot,9.051229508196721
2013-14,1495,Tim Duncan,C,444,906,444,901,0,5,Center,13,Jump Shot,8.504415011037528
2014-15,1495,Tim Duncan,C,419,819,417,812,2,7,Center,12,Jump Shot,6.902319902319903
2015-16,1495,Tim Duncan,C,215,441,215,439,0,2,Center,6,Jump Shot,7.174603174603175
2014-15,204025,Tim Frazier,PG,21,61,16,44,5,17,Center,4,Jump Shot,12.60655737704918
2015-16,204025,Tim Frazier,PG,96,229,80,181,16,48,Center,7,Jump Shot,12.235807860262009
2016-17,204025,Tim Frazier,PG,163,404,123,276,40,128,Center,3,Jump Shot,12.952970297029703
2017-18,204025,Tim Frazier,PG,68,172,51,116,17,56,Center,4,Jump Shot,15.784883720930232
2018-19,204025,Tim Frazier,PG,116,261,79,160,37,101,Center,4,Jump Shot,13.793103448275861
2019-20,204025,Tim Frazier,PG,34,94,24,64,10,30,Center,2,Pullup Jump shot,14.74468085106383
2020-21,204025,Tim Frazier,PG,3,20,3,12,0,8,Center,0,Pullup Jump shot,16.4
2021-22,204025,Tim Frazier,PG,14,45,8,28,6,17,Center,1,Pullup Jump shot,16.955555555555556
2013-14,203501,Tim Hardaway Jr.,SG,294,687,164,329,130,358,Center,18,Jump Shot,17.00291120815138
2014-15,203501,Tim Hardaway Jr.,SG,279,717,158,363,121,354,Center,13,Jump Shot,16.91213389121339
2015-16,203501,Tim Hardaway Jr.,SG,114,265,66,122,48,143,Center,9,Jump Shot,17.049056603773586
2016-17,203501,Tim Hardaway Jr.,SG,415,912,266,495,149,417,Center,19,Jump Shot,14.99671052631579
2017-18,203501,Tim Hardaway Jr.,SG,360,856,230,446,130,410,Center,14,Jump Shot,16.419392523364486
2018-19,203501,Tim Hardaway Jr.,SG,390,993,228,516,162,477,Center,10,Jump Shot,16.924471299093657
2019-20,203501,Tim Hardaway Jr.,SG,384,884,180,371,204,513,Center,8,Jump Shot,18.105203619909503
2020-21,203501,Tim Hardaway Jr.,SG,407,911,200,382,207,529,Center,8,Jump Shot,18.00548847420417
2021-22,203501,Tim Hardaway Jr.,SG,209,530,107,226,102,304,Center,3,Jump Shot,19.150943396226417
2022-23,203501,Tim Hardaway Jr.,SG,340,847,128,297,212,550,Center,5,Jump Shot,19.26328217237308
2012-13,203317,Tim Ohlbrecht,C,1,3,1,3,0,0,Center,1,Jump Shot,5.333333333333333
2016-17,1627817,Tim Quarterman,SG,13,29,8,16,5,13,Center,7,Jump Shot,15.931034482758621
2017-18,1627817,Tim Quarterman,SG,1,3,1,1,0,2,Center,1,Jump Shot,18.666666666666668
2003-04,1501,Tim Thomas,SF,363,813,290,619,73,194,Center,10,Jump Shot,11.977859778597786
2004-05,1501,Tim Thomas,SF,315,718,230,510,85,208,Center,22,Jump Shot,12.420612813370473
2005-06,1501,Tim Thomas,PF-SF,113,262,67,151,46,111,Center,2,Jump Shot,14.958015267175572
2006-07,1501,Tim Thomas,PF,299,723,163,367,136,356,Center,13,Jump Shot,16.665283540802214
2007-08,1501,Tim Thomas,PF,291,705,208,434,83,271,Center,4,Jump Shot,15.47517730496454
2008-09,1501,Tim Thomas,PF,189,438,111,249,78,189,Center,4,Jump Shot,14.856164383561644
2009-10,1501,Tim Thomas,SF,49,106,33,63,16,43,Center,1,Jump Shot,14.971698113207546
2010-11,202389,Timofey Mozgov,C,63,133,63,133,0,0,Center,7,Jump Shot,5.849624060150376
2011-12,202389,Timofey Mozgov,C,100,190,100,190,0,0,Center,2,Jump Shot,4.652631578947369
2012-13,202389,Timofey Mozgov,C,44,87,44,85,0,2,Center,4,Jump Shot,6.091954022988506
2013-14,202389,Timofey Mozgov,C,285,545,281,521,4,24,Center,3,Layup Shot,4.809174311926606
2014-15,202389,Timofey Mozgov,C,314,566,312,560,2,6,Center,8,Jump Shot,4.53886925795053
2015-16,202389,Timofey Mozgov,C,203,359,202,352,1,7,Center,2,Jump Shot,4.654596100278551
2016-17,202389,Timofey Mozgov,C,169,328,169,327,0,1,Center,0,Jump Shot,6.524390243902439
2017-18,202389,Timofey Mozgov,C,52,93,48,75,4,18,Center,4,Jump Shot,7.32258064516129
2016-17,1627789,Timothe Luwawu-Cabarrot,SF,145,359,95,200,50,159,Center,12,Jump Shot,12.512534818941504
2017-18,1627789,Timothe Luwawu-Cabarrot,SF,100,267,47,109,53,158,Center,8,Jump Shot,16.179775280898877
2018-19,1627789,Timothe Luwawu-Cabarrot,SF,82,218,46,102,36,116,Center,4,Jump Shot,15.344036697247706
2019-20,1627789,Timothe Luwawu-Cabarrot,SF,117,269,55,109,62,160,Center,7,Jump Shot,15.973977695167287
2020-21,1627789,Timothe Luwawu-Cabarrot,SF,130,356,55,117,75,239,Center,12,Jump Shot,17.660112359550563
2021-22,1627789,Timothe Luwawu-Cabarrot,SF,74,186,30,64,44,122,Center,8,Jump Shot,17.026881720430108
2011-12,202699,Tobias Harris,SF,79,169,73,146,6,23,Center,11,Jump Shot,7.591715976331361
2012-13,202699,Tobias Harris,SF-PF,233,512,199,404,34,108,Center,15,Jump Shot,9.9765625
2013-14,202699,Tobias Harris,PF,332,716,300,590,32,126,Center,11,Jump Shot,11.033519553072626
2014-15,202699,Tobias Harris,SF,442,949,355,710,87,239,Center,23,Jump Shot,11.541622760800843
2015-16,202699,Tobias Harris,PF,417,889,337,650,80,239,Center,8,Jump Shot,10.551181102362206
2016-17,202699,Tobias Harris,PF,511,1062,402,749,109,313,Center,17,Jump Shot,12.779661016949152
2017-18,202699,Tobias Harris,PF,562,1221,379,776,183,445,Center,12,Jump Shot,13.877149877149877
2018-19,202699,Tobias Harris,PF,611,1254,455,861,156,393,Center,18,Jump Shot,12.884370015948964
2019-20,202699,Tobias Harris,PF,553,1173,422,816,131,357,Center,22,Jump Shot,12.736572890025576
2020-21,202699,Tobias Harris,PF,473,924,391,716,82,208,Center,9,Jump Shot,11.207792207792208
2021-22,202699,Tobias Harris,PF,493,1022,392,747,101,275,Center,9,Jump Shot,11.229941291585128
2022-23,202699,Tobias Harris,PF,423,845,297,521,126,324,Center,6,Jump Shot,12.753846153846155
2003-04,339,Tom Gugliotta,PF,70,203,69,199,1,4,Center,1,Jump Shot,11.507389162561577
2004-05,339,Tom Gugliotta,PF,99,241,91,215,8,26,Center,5,Jump Shot,14.141078838174273
2016-17,203107,Tomas Satoransky,SG,61,147,52,110,9,37,Center,6,Jump Shot,11.047619047619047
2017-18,203107,Tomas Satoransky,SG,201,384,154,283,47,101,Center,8,Jump Shot,11.940104166666666
2018-19,203107,Tomas Satoransky,PG,257,530,193,368,64,162,Center,6,Jump Shot,11.70188679245283
2019-20,203107,Tomas Satoransky,SG,237,551,173,352,64,199,Center,7,Jump Shot,12.203266787658801
2020-21,203107,Tomas Satoransky,SG,169,329,127,211,42,118,Center,1,Jump Shot,12.790273556231003
2021-22,203107,Tomas Satoransky,SG-PG-SF,72,191,61,138,11,53,Center,4,Jump Shot,12.497382198952879
2009-10,201962,Toney Douglas,PG,179,391,111,216,68,175,Center,18,Jump Shot,15.250639386189258
2010-11,201962,Toney Douglas,SG,314,754,171,372,143,382,Center,10,Jump Shot,16.591511936339522
2011-12,201962,Toney Douglas,PG,94,290,67,173,27,117,Center,8,Jump Shot,15.720689655172414
2012-13,201962,Toney Douglas,PG,188,466,106,250,82,216,Center,20,Jump Shot,14.879828326180258
2013-14,201962,Toney Douglas,PG,73,190,42,88,31,102,Center,7,Jump Shot,16.757894736842104
2014-15,201962,Toney Douglas,SG,19,51,14,33,5,18,Center,4,Jump Shot,14.823529411764707
2015-16,201962,Toney Douglas,PG,182,443,102,242,80,201,Center,13,Jump Shot,16.020316027088036
2016-17,201962,Toney Douglas,PG,43,117,36,75,7,42,Center,5,Jump Shot,15.726495726495726
2003-04,389,Toni Kukoc,PF,211,506,162,338,49,168,Center,6,Jump Shot,12.84387351778656
2004-05,389,Toni Kukoc,SF,105,256,63,140,42,116,Center,4,Jump Shot,15.76171875
2005-06,389,Toni Kukoc,PF,116,298,71,151,45,147,Center,3,Jump Shot,17.41946308724832
2004-05,2754,Tony Allen,SG,184,387,172,356,12,31,Center,16,Jump Shot,6.896640826873385
2005-06,2754,Tony Allen,PG,129,274,118,240,11,34,Center,8,Jump Shot,7.0583941605839415
2006-07,2754,Tony Allen,SG,133,259,125,226,8,33,Center,3,Jump Shot,7.324324324324325
2007-08,2754,Tony Allen,SG,169,389,151,332,18,57,Center,12,Jump Shot,8.287917737789202
2008-09,2754,Tony Allen,SG,137,284,131,257,6,27,Center,10,Layup Shot,6.144366197183099
2009-10,2754,Tony Allen,SG,129,253,129,248,0,5,Center,9,Layup Shot,5.221343873517786
2010-11,2754,Tony Allen,SG,251,492,247,469,4,23,Center,9,Jump Shot,5.8861788617886175
2011-12,2754,Tony Allen,SG,210,448,202,422,8,26,Center,12,Jump Shot,6.912946428571429
2012-13,2754,Tony Allen,SG,284,638,281,614,3,24,Center,7,Jump Shot,7.344827586206897
2013-14,2754,Tony Allen,SG,204,413,193,366,11,47,Center,5,Jump Shot,7.651331719128329
2014-15,2754,Tony Allen,SG,225,455,215,426,10,29,Center,6,Layup Shot,4.268131868131868
2015-16,2754,Tony Allen,SG,215,469,200,427,15,42,Center,7,Jump Shot,6.23454157782516
2016-17,2754,Tony Allen,SG,274,595,259,541,15,54,Center,8,Jump Shot,5.114285714285714
2017-18,2754,Tony Allen,SF,44,91,40,79,4,12,Center,2,Layup Shot,6.1208791208791204
2003-04,1499,Tony Battie,C,170,384,168,375,2,9,Center,3,Jump Shot,9.807291666666666
2004-05,1499,Tony Battie,C,163,354,163,348,0,6,Center,1,Jump Shot,9.700564971751412
2005-06,1499,Tony Battie,C,280,552,280,546,0,6,Center,6,Jump Shot,8.289855072463768
2006-07,1499,Tony Battie,PF,176,360,176,359,0,1,Center,2,Jump Shot,7.766666666666667
2008-09,1499,Tony Battie,PF,158,323,156,314,2,9,Center,0,Jump Shot,11.690402476780186
2009-10,1499,Tony Battie,C,14,40,13,36,1,4,Center,0,Jump Shot,14.875
2010-11,1499,Tony Battie,C,45,96,43,93,2,3,Center,3,Jump Shot,11.916666666666666
2011-12,1499,Tony Battie,C,19,51,19,50,0,1,Center,0,Jump Shot,12.431372549019608
2004-05,2800,Tony Bobbitt,SG,2,5,1,3,1,2,Left Side Center,2,Jump Shot,21.6
2017-18,1628396,Tony Bradley,C,3,11,3,10,0,1,Center,1,Jump Shot,9.272727272727273
2018-19,1628396,Tony Bradley,C,8,16,8,16,0,0,Center,2,Tip Layup Shot,2.5625
2019-20,1628396,Tony Bradley,C,126,189,123,186,3,3,Center,11,Tip Layup Shot,2.3703703703703702
2020-21,1628396,Tony Bradley,C,131,197,131,194,0,3,Center,7,Layup Shot,3.883248730964467
2021-22,1628396,Tony Bradley,C,72,123,72,123,0,0,Center,4,Putback Layup Shot,3.4796747967479673
2022-23,1628396,Tony Bradley,C,6,12,3,7,3,5,Center,6,Jump Shot,12.25
2003-04,960,Tony Delk,SG,70,184,50,118,20,66,Center,2,Jump Shot,14.73913043478261
2004-05,960,Tony Delk,SG,246,591,174,389,72,202,Center,9,Jump Shot,15.282571912013536
2005-06,960,Tony Delk,PG-SG,71,161,51,114,20,47,Center,4,Jump Shot,15.788819875776397
2003-04,763,Tony Massenburg,PF,104,219,104,218,0,1,Center,3,Jump Shot,7.598173515981735
2004-05,763,Tony Massenburg,PF,74,182,74,182,0,0,Center,5,Jump Shot,7.774725274725275
2013-14,203183,Tony Mitchell,PF,3,5,3,4,0,1,Center,3,Driving Slam Dunk Shot,5.8
2013-14,203502,Tony Mitchell,SF,5,12,4,11,1,1,Center,2,Layup Shot,7.0
2003-04,2225,Tony Parker,PG,423,946,361,747,62,199,Center,15,Jump Shot,12.121564482029598
2004-05,2225,Tony Parker,PG,539,1118,496,962,43,156,Center,23,Jump Shot,9.569767441860465
2005-06,2225,Tony Parker,PG,623,1136,612,1100,11,36,Center,21,Jump Shot,8.31338028169014
2006-07,2225,Tony Parker,PG,570,1096,555,1058,15,38,Center,23,Jump Shot,9.521897810218977
2007-08,2225,Tony Parker,PG,515,1043,498,977,17,66,Center,15,Jump Shot,9.73633748801534
2008-09,2225,Tony Parker,PG,639,1263,620,1198,19,65,Center,38,Jump Shot,9.187648456057007
2009-10,2225,Tony Parker,PG,349,716,339,682,10,34,Center,9,Jump Shot,9.544692737430168
2010-11,2225,Tony Parker,PG,555,1069,530,999,25,70,Center,15,Jump Shot,8.30776426566885
2011-12,2225,Tony Parker,PG,427,890,413,829,14,61,Center,16,Jump Shot,10.38314606741573
2012-13,2225,Tony Parker,PG,519,994,495,927,24,67,Center,17,Jump Shot,9.283702213279678
2013-14,2225,Tony Parker,PG,456,914,431,847,25,67,Center,15,Jump Shot,9.436542669584245
2014-15,2225,Tony Parker,PG,404,832,366,743,38,89,Center,9,Jump Shot,10.953125
2015-16,2225,Tony Parker,PG,350,710,323,645,27,65,Center,15,Jump Shot,10.464788732394366
2016-17,2225,Tony Parker,PG,265,569,242,500,23,69,Center,5,Jump Shot,10.611599297012303
2017-18,2225,Tony Parker,PG,178,388,168,351,10,37,Center,0,Pullup Jump shot,10.427835051546392
2018-19,2225,Tony Parker,PG,213,463,200,412,13,51,Center,6,Jump Shot,10.844492440604752
2013-14,203503,Tony Snell,SG,129,336,72,158,57,178,Center,4,Jump Shot,17.279761904761905
2014-15,203503,Tony Snell,SF,159,371,86,174,73,197,Center,8,Jump Shot,16.172506738544474
2015-16,203503,Tony Snell,SF,126,339,70,184,56,155,Center,9,Jump Shot,15.539823008849558
2016-17,203503,Tony Snell,SG,245,539,102,186,143,353,Center,5,Jump Shot,18.493506493506494
2017-18,203503,Tony Snell,SG,185,425,77,157,108,268,Center,4,Jump Shot,17.983529411764707
2018-19,203503,Tony Snell,SF,163,361,82,157,81,204,Center,5,Jump Shot,16.290858725761773
2019-20,203503,Tony Snell,SF,170,382,68,128,102,254,Center,4,Jump Shot,18.892670157068064
2020-21,203503,Tony Snell,SG,88,171,26,62,62,109,Center,5,Jump Shot,18.099415204678362
2021-22,203503,Tony Snell,SG,69,171,24,43,45,128,Center,4,Jump Shot,19.497076023391813
2012-13,203100,Tony Wroten,SG,33,86,29,70,4,16,Center,2,Layup Shot,7.244186046511628
2013-14,203100,Tony Wroten,PG,345,808,305,620,40,188,Center,16,Jump Shot,8.074257425742575
2014-15,203100,Tony Wroten,PG,175,434,138,292,37,142,Center,9,Jump Shot,10.11520737327189
2015-16,203100,Tony Wroten,PG,22,65,19,48,3,17,Center,0,Jump Shot,8.36923076923077
2012-13,203129,Tornike Shengelia,SF,10,22,9,21,1,1,Center,4,Layup Shot,4.181818181818182
2013-14,203129,Tornike Shengelia,SF,13,28,13,22,0,6,Center,5,Driving Layup Shot,7.464285714285714
2003-04,1765,Torraye Braggs,PF,16,33,16,33,0,0,Center,2,Jump Shot,5.818181818181818
2004-05,1765,Torraye Braggs,PF,3,7,3,7,0,0,Center,2,Tip Shot,2.0
2017-18,1628470,Torrey Craig,SF,62,137,45,79,17,58,Center,1,Jump Shot,12.416058394160585
2018-19,1628470,Torrey Craig,SF,160,362,99,174,61,188,Center,13,Jump Shot,14.013812154696133
2019-20,1628470,Torrey Craig,SF,124,269,79,131,45,138,Center,3,Jump Shot,14.442379182156134
2020-21,1628470,Torrey Craig,SF,109,227,70,121,39,106,Center,2,Jump Shot,13.977973568281937
2021-22,1628470,Torrey Craig,SF,200,441,123,207,77,234,Center,6,Jump Shot,15.476190476190476
2022-23,1628470,Torrey Craig,SF,228,500,128,247,100,253,Center,5,Jump Shot,14.5
2013-14,203315,Toure' Murry,PG,56,129,51,117,5,12,Center,11,Jump Shot,10.294573643410853
2014-15,203315,Toure' Murry,SG-PG,2,5,2,5,0,0,Center,0,Jump Shot,9.2
2003-04,1503,Tracy McGrady,SG,653,1566,479,1053,174,513,Center,30,Jump Shot,16.393997445721585
2004-05,1503,Tracy McGrady,SF,715,1660,573,1225,142,435,Center,26,Jump Shot,15.148795180722892
2005-06,1503,Tracy McGrady,SF,410,1011,337,777,73,234,Center,15,Jump Shot,15.293768545994066
2006-07,1503,Tracy McGrady,SG,638,1480,512,1099,126,381,Center,24,Jump Shot,15.583783783783783
2007-08,1503,Tracy McGrady,SG,548,1307,462,1012,86,295,Center,16,Jump Shot,15.087222647283856
2008-09,1503,Tracy McGrady,SG,188,485,144,368,44,117,Center,9,Jump Shot,14.983505154639175
2009-10,1503,Tracy McGrady,SG,91,235,75,171,16,64,Center,2,Jump Shot,14.87659574468085
2010-11,1503,Tracy McGrady,SG,227,514,197,426,30,88,Center,8,Jump Shot,13.478599221789883
2011-12,1503,Tracy McGrady,SF,101,231,86,198,15,33,Center,2,Jump Shot,12.974025974025974
2003-04,145,Tracy Murray,SF,3,12,1,7,2,5,Center,0,Jump Shot,16.0
2018-19,1629027,Trae Young,PG,525,1256,369,774,156,482,Center,24,Jump Shot,14.360668789808917
2019-20,1629027,Trae Young,PG,546,1249,341,681,205,568,Center,32,Pullup Jump shot,16.304243394715773
2020-21,1629027,Trae Young,PG,487,1112,351,715,136,397,Center,29,Driving Floating Jump Shot,14.819244604316546
2021-22,1629027,Trae Young,PG,711,1544,478,934,233,610,Center,33,Pullup Jump shot,15.999352331606218
2022-23,1629027,Trae Young,PG,597,1390,443,930,154,460,Center,30,Driving Floating Jump Shot,14.533812949640287
2003-04,696,Travis Best,PG,64,172,61,152,3,20,Center,4,Jump Shot,13.406976744186046
2004-05,696,Travis Best,PG,190,452,164,367,26,85,Center,11,Jump Shot,14.851769911504425
2005-06,101143,Travis Diener,PG,29,69,4,12,25,57,Right Side Center,4,Jump Shot,23.91304347826087
2006-07,101143,Travis Diener,PG,34,80,16,30,18,50,Center,8,Jump Shot,20.9875
2007-08,101143,Travis Diener,PG,159,430,85,197,74,233,Center,16,Jump Shot,19.634883720930233
2008-09,101143,Travis Diener,PG,74,179,28,61,46,118,Center,3,Jump Shot,21.16759776536313
2009-10,101143,Travis Diener,PG,2,10,1,3,1,7,Left Side Center,1,Jump Shot,22.8
2003-04,2580,Travis Hansen,SF,46,130,37,100,9,30,Center,5,Jump Shot,12.823076923076924
2011-12,202727,Travis Leslie,SG,5,14,5,14,0,0,Center,1,Jump Shot,4.0
2003-04,2566,Travis Outlaw,PF,3,7,3,7,0,0,Center,1,Jump Shot,10.285714285714286
2004-05,2566,Travis Outlaw,SF,133,267,129,257,4,10,Center,18,Jump Shot,9.715355805243446
2005-06,2566,Travis Outlaw,PF,162,368,148,315,14,53,Center,14,Jump Shot,13.923913043478262
2006-07,2566,Travis Outlaw,PF,246,567,236,530,10,37,Center,15,Jump Shot,13.652557319223986
2007-08,2566,Travis Outlaw,PF,417,964,377,863,40,101,Center,29,Jump Shot,14.308091286307054
2008-09,2566,Travis Outlaw,SF,385,850,296,614,89,236,Center,26,Jump Shot,14.509411764705883
2009-10,2566,Travis Outlaw,SF,110,281,70,176,40,105,Center,6,Jump Shot,16.19217081850534
2010-11,2566,Travis Outlaw,SF,274,731,198,479,76,252,Center,11,Jump Shot,16.40218878248974
2011-12,2566,Travis Outlaw,SF,60,175,44,115,16,60,Center,4,Jump Shot,15.657142857142857
2012-13,2566,Travis Outlaw,SF,74,177,60,127,14,50,Center,8,Jump Shot,15.875706214689265
2013-14,2566,Travis Outlaw,SF,130,326,89,209,41,117,Center,9,Jump Shot,16.812883435582823
2014-15,204037,Travis Wear,SF,84,209,73,179,11,30,Center,9,Jump Shot,15.119617224880383
2017-18,204037,Travis Wear,SF,25,72,8,25,17,47,Right Side Center,1,Jump Shot,21.98611111111111
2021-22,1629309,Trayvon Palmer,SG,0,1,0,1,0,0,Center,0,Layup Shot,4.0
2020-21,1630200,Tre Jones,PG,37,78,34,73,3,5,Center,7,Driving Floating Jump Shot,6.333333333333333
2021-22,1630200,Tre Jones,PG,166,339,156,288,10,51,Center,9,Driving Floating Jump Shot,9.20353982300885
2022-23,1630200,Tre Jones,PG,341,743,296,585,45,158,Center,13,Driving Floating Jump Shot,10.253028263795423
2021-22,1630544,Tre Mann,PG,231,588,133,316,98,272,Center,10,Jump Shot,16.15986394557823
2022-23,1630544,Tre Mann,PG,197,501,116,244,81,257,Center,8,Jump Shot,16.69261477045908
2003-04,1762,Tremaine Fowlkes,SF,15,48,14,40,1,8,Center,1,Jump Shot,11.583333333333334
2004-05,1762,Tremaine Fowlkes,SF,9,17,8,14,1,3,Right Side,3,Jump Shot,14.529411764705882
2019-20,1629682,Tremont Waters,PG,14,49,10,25,4,24,Center,2,Jump Shot,16.306122448979593
2020-21,1629682,Tremont Waters,PG,34,84,19,46,15,38,Center,8,Jump Shot,15.595238095238095
2021-22,1629682,Tremont Waters,PG,4,14,2,5,2,9,Right Side Center,0,Pullup Jump shot,22.214285714285715
2021-22,1630570,Trendon Watford,SF,142,267,133,229,9,38,Center,8,Floating Jump shot,7.49812734082397
2022-23,1630570,Trendon Watford,PF,181,323,156,259,25,64,Center,8,Jump Shot,8.445820433436532
2020-21,1630235,Trent Forrest,PG,32,71,27,45,5,26,Center,2,Jump Shot,12.366197183098592
2021-22,1630235,Trent Forrest,PG,76,155,71,128,5,27,Center,3,Driving Layup Shot,8.329032258064515
2022-23,1630235,Trent Forrest,PG,25,60,25,58,0,2,Center,0,Driving Floating Jump Shot,6.083333333333333
2003-04,2239,Trenton Hassell,SG,177,381,173,368,4,13,Center,3,Jump Shot,13.446194225721785
2004-05,2239,Trenton Hassell,SG,225,475,224,464,1,11,Center,6,Jump Shot,10.31578947368421
2005-06,2239,Trenton Hassell,SG,286,616,279,593,7,23,Center,14,Jump Shot,10.712662337662337
2006-07,2239,Trenton Hassell,SG,217,443,211,418,6,25,Center,7,Jump Shot,10.866817155756207
2007-08,2239,Trenton Hassell,SG,57,135,55,126,2,9,Center,6,Jump Shot,14.622222222222222
2008-09,2239,Trenton Hassell,SF,86,191,84,183,2,8,Center,2,Jump Shot,12.842931937172775
2009-10,2239,Trenton Hassell,SF,90,219,90,214,0,5,Center,4,Jump Shot,11.114155251141552
2021-22,1630243,Trevelin Queen,SG,15,33,6,9,9,24,Center,7,Jump Shot,19.060606060606062
2022-23,1630243,Trevelin Queen,SG,7,29,5,14,2,15,Center,2,Pullup Jump shot,15.137931034482758
2016-17,1626203,Treveon Graham,SG,19,40,10,25,9,15,Center,5,Jump Shot,13.575
2017-18,1626203,Treveon Graham,SG,96,221,56,124,40,97,Center,3,Jump Shot,14.402714932126697
2018-19,1626203,Treveon Graham,SG,64,191,26,63,38,128,Center,2,Jump Shot,18.76439790575916
2019-20,1626203,Treveon Graham,SF,87,242,54,122,33,120,Center,1,Jump Shot,14.107438016528926
2018-19,1628979,Trevon Duval,PG,2,3,1,2,1,1,Center,1,Jump Shot,13.0
2021-22,1630286,Trevon Scott,,3,6,3,5,0,1,Center,2,Turnaround Hook Shot,7.666666666666667
2004-05,2772,Trevor Ariza,SF,172,389,169,376,3,13,Center,9,Jump Shot,8.182519280205655
2005-06,2772,Trevor Ariza,SF,93,226,92,221,1,5,Center,6,Jump Shot,5.783185840707965
2006-07,2772,Trevor Ariza,SG,200,371,200,364,0,7,Center,4,Layup Shot,6.080862533692723
2007-08,2772,Trevor Ariza,SF,69,136,64,118,5,18,Center,5,Jump Shot,7.676470588235294
2008-09,2772,Trevor Ariza,SF,274,596,213,405,61,191,Center,10,Jump Shot,11.966442953020135
2009-10,2772,Trevor Ariza,SF,394,999,258,592,136,407,Center,15,Jump Shot,13.907907907907909
2010-11,2772,Trevor Ariza,SF,303,762,221,491,82,271,Center,5,Jump Shot,13.034120734908136
2011-12,2772,Trevor Ariza,SF,168,403,139,316,29,87,Center,5,Jump Shot,11.27047146401985
2012-13,2772,Trevor Ariza,SF,188,451,112,242,76,209,Center,9,Jump Shot,15.414634146341463
2013-14,2772,Trevor Ariza,SF,389,852,209,411,180,441,Center,7,Jump Shot,16.028169014084508
2014-15,2772,Trevor Ariza,SF,366,910,172,355,194,555,Center,6,Jump Shot,17.18241758241758
2015-16,2772,Trevor Ariza,SF,357,859,172,360,185,499,Center,10,Jump Shot,16.278230500582072
2016-17,2772,Trevor Ariza,SF,325,797,135,243,190,554,Center,9,Jump Shot,18.14805520702635
2017-18,2772,Trevor Ariza,SF,268,651,98,189,170,462,Center,9,Jump Shot,17.952380952380953
2018-19,2772,Trevor Ariza,SF,294,736,149,302,145,434,Center,8,Jump Shot,16.09375
2019-20,2772,Trevor Ariza,SF,142,324,65,117,77,207,Center,2,Jump Shot,16.503086419753085
2020-21,2772,Trevor Ariza,SF,99,241,49,98,50,143,Center,1,Jump Shot,15.643153526970954
2021-22,2772,Trevor Ariza,SF,33,99,13,25,20,74,Center,1,Jump Shot,18.717171717171716
2010-11,202344,Trevor Booker,PF,139,253,139,252,0,1,Center,13,Jump Shot,4.8023715415019765
2011-12,202344,Trevor Booker,PF,181,341,180,339,1,2,Center,8,Jump Shot,7.105571847507331
2012-13,202344,Trevor Booker,PF,108,220,108,215,0,5,Center,3,Jump Shot,6.6045454545454545
2013-14,202344,Trevor Booker,PF,222,403,222,401,0,2,Center,1,Jump Shot,6.910669975186104
2014-15,202344,Trevor Booker,PF,226,464,197,380,29,84,Center,5,Jump Shot,9.855603448275861
2015-16,202344,Trevor Booker,PF,190,388,178,347,12,41,Center,4,Jump Shot,5.791237113402062
2016-17,202344,Trevor Booker,PF,305,591,280,513,25,78,Center,11,Jump Shot,7.323181049069374
2017-18,202344,Trevor Booker,PF,177,343,169,310,8,33,Center,3,Layup Shot,6.553935860058309
2022-23,1631309,Trevor Hudgins,PG,2,9,0,1,2,8,Right Side Center,1,Jump Shot,24.22222222222222
2022-23,1631211,Trevor Keels,SG,1,4,0,0,1,4,Right Side Center,1,Jump Shot,24.75
2013-14,203504,Trey Burke,PG,341,896,230,561,111,335,Center,22,Jump Shot,16.340401785714285
2014-15,203504,Trey Burke,PG,370,1005,246,615,124,390,Center,13,Jump Shot,16.044776119402986
2015-16,203504,Trey Burke,PG,262,634,174,378,88,256,Center,9,Jump Shot,16.187697160883282
2016-17,203504,Trey Burke,PG,116,255,85,185,31,70,Center,5,Jump Shot,15.654901960784313
2017-18,203504,Trey Burke,PG,193,384,155,279,38,105,Center,12,Jump Shot,15.59375
2018-19,203504,Trey Burke,PG,236,548,180,389,56,159,Center,13,Jump Shot,13.755474452554745
2019-20,203504,Trey Burke,PG,94,209,62,134,32,75,Center,6,Jump Shot,14.555023923444976
2020-21,203504,Trey Burke,PG,151,353,93,189,58,164,Center,7,Jump Shot,16.592067988668557
2021-22,203504,Trey Burke,PG,84,215,58,133,26,82,Center,9,Pullup Jump shot,16.488372093023255
2009-10,201821,Trey Gilder,SF,1,1,1,1,0,0,Left Side Center,1,Jump Shot,17.0
2008-09,201234,Trey Johnson,SG,0,5,0,5,0,0,Left Side,0,Jump Shot,13.4
2010-11,201234,Trey Johnson,SG,12,33,11,30,1,3,Center,1,Jump Shot,12.818181818181818
2011-12,201234,Trey Johnson,SG,8,14,8,14,0,0,Center,3,Jump Shot,9.714285714285714
2015-16,1626168,Trey Lyles,PF,191,436,142,308,49,128,Center,6,Jump Shot,12.825688073394495
2016-17,1626168,Trey Lyles,PF,159,438,94,235,65,203,Center,9,Jump Shot,15.093607305936073
2017-18,1626168,Trey Lyles,PF,270,550,187,332,83,218,Center,15,Jump Shot,12.84909090909091
2018-19,1626168,Trey Lyles,PF,207,495,156,295,51,200,Center,5,Jump Shot,13.32929292929293
2019-20,1626168,Trey Lyles,PF,153,343,88,175,65,168,Center,5,Jump Shot,14.918367346938776
2020-21,1626168,Trey Lyles,PF,43,90,29,50,14,40,Center,2,Jump Shot,14.033333333333333
2021-22,1626168,Trey Lyles,PF,262,562,195,353,67,209,Center,2,Jump Shot,12.316725978647687
2022-23,1626168,Trey Lyles,PF,187,408,100,168,87,240,Center,2,Jump Shot,15.323529411764707
2021-22,1630530,Trey Murphy III,SF,109,277,38,91,71,186,Center,15,Jump Shot,18.03971119133574
2022-23,1630530,Trey Murphy III,SF,387,800,185,303,202,497,Center,15,Jump Shot,17.525
2011-12,202717,Trey Thompkins,C,24,61,20,48,4,13,Center,9,Jump Shot,13.639344262295081
2011-12,202684,Tristan Thompson,PF,194,442,194,440,0,2,Center,8,Jump Shot,3.5361990950226243
2012-13,202684,Tristan Thompson,PF,390,799,390,796,0,3,Center,16,Jump Shot,4.352941176470588
2013-14,202684,Tristan Thompson,PF,363,761,363,760,0,1,Center,11,Jump Shot,5.027595269382392
2014-15,202684,Tristan Thompson,PF,267,488,267,488,0,0,Center,10,Layup Shot,2.8114754098360657
2015-16,202684,Tristan Thompson,PF,247,420,247,420,0,0,Center,8,Layup Shot,2.426190476190476
2016-17,202684,Tristan Thompson,C,262,437,262,434,0,3,Center,3,Jump Shot,2.6727688787185353
2017-18,202684,Tristan Thompson,C,132,235,132,235,0,0,Center,1,Tip Layup Shot,3.2297872340425533
2018-19,202684,Tristan Thompson,C,201,380,201,380,0,0,Center,5,Hook Shot,4.28421052631579
2019-20,202684,Tristan Thompson,PF,288,562,279,539,9,23,Center,5,Hook Shot,4.606761565836299
2020-21,202684,Tristan Thompson,PF,169,326,169,323,0,3,Center,1,Tip Layup Shot,4.061349693251533
2021-22,202684,Tristan Thompson,PF,141,267,140,264,1,3,Center,2,Hook Shot,3.891385767790262
2003-04,2559,Troy Bell,PG,4,18,4,14,0,4,Center,1,Jump Shot,12.88888888888889
2018-19,1628972,Troy Brown Jr.,SF,97,234,75,165,22,69,Center,10,Jump Shot,12.452991452991453
2019-20,1628972,Troy Brown Jr.,SF,273,622,212,443,61,179,Center,15,Jump Shot,12.855305466237942
2020-21,1628972,Troy Brown Jr.,SF,62,144,40,74,22,70,Center,5,Jump Shot,16.96527777777778
2021-22,1628972,Troy Brown Jr.,SF,108,258,61,125,47,133,Center,11,Jump Shot,14.503875968992247
2022-23,1628972,Troy Brown Jr.,SF,200,465,93,184,107,281,Center,6,Jump Shot,17.036559139784945
2018-19,1628505,Troy Caupain,PG,4,8,2,5,2,3,Left Side Center,3,Pullup Jump shot,17.375
2013-14,203584,Troy Daniels,SG,15,31,3,6,12,25,Right Side Center,2,Jump Shot,21.741935483870968
2014-15,203584,Troy Daniels,SG,61,165,18,47,43,118,Left Side Center,17,Jump Shot,21.4
2015-16,203584,Troy Daniels,SG,89,187,30,65,59,122,Center,13,Jump Shot,21.22459893048128
2016-17,203584,Troy Daniels,SG,184,494,47,140,137,354,Right Side Center,15,Jump Shot,22.178137651821864
2017-18,203584,Troy Daniels,SG,232,575,49,117,183,458,Center,6,Jump Shot,22.245217391304347
2018-19,203584,Troy Daniels,SG,113,275,39,81,74,194,Center,12,Jump Shot,20.80727272727273
2019-20,203584,Troy Daniels,SG,72,186,26,54,46,132,Center,13,Jump Shot,21.080645161290324
2003-04,1607,Troy Hudson,PG,80,207,49,130,31,77,Center,3,Jump Shot,17.99033816425121
2004-05,1607,Troy Hudson,PG,266,664,177,406,89,258,Center,13,Jump Shot,17.628012048192772
2005-06,1607,Troy Hudson,PG,127,333,87,232,40,101,Center,6,Jump Shot,16.57957957957958
2006-07,1607,Troy Hudson,PG,74,195,46,115,28,80,Left Side Center,4,Jump Shot,17.907692307692308
2007-08,1607,Troy Hudson,PG,9,31,5,19,4,12,Center,1,Jump Shot,19.29032258064516
2003-04,2211,Troy Murphy,PF,107,243,102,226,5,17,Center,5,Jump Shot,11.74074074074074
2004-05,2211,Troy Murphy,PF,392,947,333,799,59,148,Center,9,Jump Shot,11.6441393875396
2005-06,2211,Troy Murphy,PF,363,838,305,657,58,181,Center,7,Jump Shot,12.301909307875896
2006-07,2211,Troy Murphy,PF,266,581,208,434,58,147,Center,3,Jump Shot,15.328743545611015
2007-08,2211,Troy Murphy,PF,315,693,221,457,94,236,Center,5,Jump Shot,14.878787878787879
2008-09,2211,Troy Murphy,PF,364,767,203,409,161,358,Center,5,Jump Shot,16.2503259452412
2009-10,2211,Troy Murphy,PF,384,813,256,480,128,333,Center,2,Jump Shot,15.451414514145142
2010-11,2211,Troy Murphy,PF,42,114,37,81,5,33,Center,1,Jump Shot,14.508771929824562
2011-12,2211,Troy Murphy,PF,77,171,49,104,28,67,Center,1,Jump Shot,17.23391812865497
2012-13,2211,Troy Murphy,PF,22,61,11,26,11,35,Center,0,Jump Shot,18.901639344262296
2016-17,1627786,Troy Williams,SF,73,167,55,105,18,62,Center,1,Jump Shot,11.802395209580839
2017-18,1627786,Troy Williams,SF,51,109,40,71,11,38,Center,8,Jump Shot,10.46788990825688
2018-19,1627786,Troy Williams,SF,44,98,30,54,14,44,Center,5,Jump Shot,13.459183673469388
2019-20,1629660,Ty Jerome,SG,38,113,24,63,14,50,Center,2,Jump Shot,15.557522123893806
2020-21,1629660,Ty Jerome,SG,128,287,57,119,71,168,Center,6,Jump Shot,18.4006968641115
2021-22,1629660,Ty Jerome,SG,124,328,70,142,54,186,Center,6,Jump Shot,17.740853658536587
2022-23,1629660,Ty Jerome,SG,118,242,83,152,35,90,Center,7,Jump Shot,14.177685950413224
2009-10,201951,Ty Lawson,PG,201,390,167,307,34,83,Center,8,Jump Shot,9.671794871794871
2010-11,201951,Ty Lawson,PG,346,688,277,517,69,171,Center,15,Jump Shot,10.42732558139535
2011-12,201951,Ty Lawson,PG,374,767,301,567,73,200,Center,13,Jump Shot,11.580182529335072
2012-13,201951,Ty Lawson,PG,448,971,363,739,85,232,Center,24,Jump Shot,11.583934088568487
2013-14,201951,Ty Lawson,PG,347,806,275,604,72,202,Center,14,Jump Shot,13.3151364764268
2014-15,201951,Ty Lawson,PG,404,926,334,721,70,205,Center,22,Jump Shot,13.295896328293736
2015-16,201951,Ty Lawson,PG,139,354,103,246,36,108,Center,2,Jump Shot,14.451977401129943
2016-17,201951,Ty Lawson,PG,237,522,203,404,34,118,Center,10,Jump Shot,12.649425287356323
2020-21,1630234,Ty-Shon Alexander,SG,3,12,1,3,2,9,Right Side Center,2,Jump Shot,21.666666666666668
2022-23,1631102,TyTy Washington Jr.,PG,58,160,39,80,19,80,Center,6,Jump Shot,17.04375
2020-21,1630189,Tyler Bey,SF,7,22,6,18,1,4,Center,3,Driving Floating Jump Shot,9.136363636363637
2017-18,1628463,Tyler Cavanaugh,PF,67,152,35,63,32,89,Center,1,Jump Shot,15.796052631578947
2018-19,1628463,Tyler Cavanaugh,PF,3,10,2,5,1,5,Center,1,Jump Shot,13.5
2019-20,1629076,Tyler Cook,PF-SF,8,12,8,12,0,0,Center,5,Layup Shot,2.1666666666666665
2020-21,1629076,Tyler Cook,SF-PF,69,103,68,101,1,2,Center,3,Dunk Shot,2.6990291262135924
2021-22,1629076,Tyler Cook,PF,23,38,23,38,0,0,Center,0,Cutting Dunk Shot,1.7894736842105263
2018-19,1629093,Tyler Davis,C,0,1,0,1,0,0,Center,0,Hook Shot,1.0
2017-18,1628416,Tyler Dorsey,SG,144,382,72,183,72,199,Center,14,Jump Shot,17.513089005235603
2018-19,1628416,Tyler Dorsey,SG,107,264,63,132,44,132,Center,9,Jump Shot,15.681818181818182
2022-23,1628416,Tyler Dorsey,SG,4,5,3,3,1,2,Center,2,Jump Shot,20.4
2014-15,203898,Tyler Ennis,PG,52,144,40,101,12,43,Center,4,Jump Shot,12.29861111111111
2015-16,203898,Tyler Ennis,PG,84,187,71,148,13,39,Center,9,Jump Shot,10.497326203208557
2016-17,203898,Tyler Ennis,PG,90,208,63,138,27,70,Center,7,Jump Shot,12.139423076923077
2017-18,203898,Tyler Ennis,PG,94,224,80,168,14,56,Center,7,Jump Shot,10.683035714285714
2009-10,201946,Tyler Hansbrough,PF,81,225,81,221,0,4,Center,7,Jump Shot,8.96
2010-11,201946,Tyler Hansbrough,PF,285,613,285,611,0,2,Center,9,Jump Shot,10.078303425774878
2011-12,201946,Tyler Hansbrough,PF,194,479,194,478,0,1,Center,3,Jump Shot,9.298538622129437
2012-13,201946,Tyler Hansbrough,PF,176,407,176,404,0,3,Center,3,Jump Shot,6.641277641277641
2013-14,201946,Tyler Hansbrough,PF,93,196,93,194,0,2,Center,2,Jump Shot,4.198979591836735
2014-15,201946,Tyler Hansbrough,PF,86,165,85,158,1,7,Center,2,Layup Shot,3.5393939393939395
2015-16,201946,Tyler Hansbrough,PF,32,71,30,68,2,3,Center,7,Jump Shot,3.5211267605633805
2019-20,1629639,Tyler Herro,SG,270,631,154,333,116,298,Center,14,Jump Shot,17.465927099841522
2020-21,1629639,Tyler Herro,SG,307,699,200,402,107,297,Center,13,Jump Shot,16.027181688125893
2021-22,1629639,Tyler Herro,SG,501,1122,326,683,175,439,Center,11,Jump Shot,15.496434937611408
2022-23,1629639,Tyler Herro,SG,487,1109,284,572,203,537,Center,24,Pullup Jump shot,16.893597835888187
2011-12,202715,Tyler Honeycutt,SF,8,24,7,21,1,3,Center,1,Jump Shot,11.625
2012-13,202715,Tyler Honeycutt,SF,3,11,3,9,0,2,Center,3,Jump Shot,12.454545454545455
2014-15,204020,Tyler Johnson,SG,70,167,52,119,18,48,Center,8,Jump Shot,13.035928143712574
2015-16,204020,Tyler Johnson,SG,118,243,91,172,27,71,Center,8,Jump Shot,13.08641975308642
2016-17,204020,Tyler Johnson,PG,356,822,264,574,92,248,Center,13,Jump Shot,13.416058394160585
2017-18,204020,Tyler Johnson,PG,309,711,190,387,119,324,Center,6,Jump Shot,16.0056258790436
2018-19,204020,Tyler Johnson,PG,217,526,127,266,90,260,Center,6,Jump Shot,15.686311787072244
2019-20,204020,Tyler Johnson,PG-SG,97,250,59,131,38,119,Center,3,Jump Shot,17.42
2020-21,204020,Tyler Johnson,SG,72,183,24,51,48,132,Center,4,Jump Shot,20.53551912568306
2021-22,204020,Tyler Johnson,PG,6,20,1,7,5,13,Left Side,1,Jump Shot,21.75
2018-19,1628399,Tyler Lydon,PF,9,18,5,8,4,10,Center,3,Jump Shot,14.055555555555555
2016-17,1627755,Tyler Ulis,PG,184,437,163,358,21,79,Center,15,Jump Shot,14.892448512585812
2017-18,1627755,Tyler Ulis,PG,214,551,172,405,42,146,Center,12,Jump Shot,14.980036297640654
2012-13,203092,Tyler Zeller,C,245,559,245,555,0,4,Center,2,Jump Shot,9.398926654740608
2013-14,203092,Tyler Zeller,C,156,290,156,289,0,1,Center,9,Jump Shot,5.8310344827586205
2014-15,203092,Tyler Zeller,C,340,619,340,619,0,0,Center,6,Jump Shot,5.332794830371567
2015-16,203092,Tyler Zeller,C,138,290,138,290,0,0,Center,7,Jump Shot,7.093103448275862
2016-17,203092,Tyler Zeller,C,78,158,78,157,0,1,Center,3,Jump Shot,7.132911392405063
2017-18,203092,Tyler Zeller,C,187,334,177,306,10,28,Center,3,Layup Shot,5.149700598802395
2018-19,203092,Tyler Zeller,C,16,30,16,29,0,1,Center,0,Hook Shot,4.266666666666667
2019-20,203092,Tyler Zeller,C,1,4,1,4,0,0,Center,0,Tip Layup Shot,2.5
2009-10,201936,Tyreke Evans,SG,533,1165,497,1024,36,141,Center,45,Jump Shot,8.162231759656652
2010-11,201936,Tyreke Evans,SG,382,932,339,785,43,147,Center,27,Jump Shot,10.412017167381974
2011-12,201936,Tyreke Evans,SG,408,900,388,801,20,99,Center,11,Jump Shot,8.564444444444444
2012-13,201936,Tyreke Evans,SG,366,765,321,632,45,133,Center,23,Jump Shot,8.964705882352941
2013-14,201936,Tyreke Evans,SF,391,897,370,802,21,95,Center,17,Layup Shot,6.568561872909699
2014-15,201936,Tyreke Evans,SG,521,1165,452,938,69,227,Center,27,Jump Shot,8.629184549356223
2015-16,201936,Tyreke Evans,SG,136,314,103,229,33,85,Center,6,Jump Shot,10.353503184713375
2016-17,201936,Tyreke Evans,SF,150,369,108,252,42,117,Center,3,Jump Shot,11.818428184281842
2017-18,201936,Tyreke Evans,PG,366,809,252,523,114,286,Center,19,Jump Shot,12.054388133498145
2018-19,201936,Tyreke Evans,SG,257,660,180,444,77,216,Center,3,Jump Shot,12.165151515151516
2020-21,1630179,Tyrell Terry,PG,5,16,5,9,0,7,Center,3,Jump Shot,14.125
2021-22,1630179,Tyrell Terry,PG,1,1,1,1,0,0,Center,1,Pullup Jump shot,15.0
2020-21,1630169,Tyrese Haliburton,PG,292,619,171,323,121,296,Center,12,Jump Shot,16.60420032310178
2021-22,1630169,Tyrese Haliburton,SG-PG,430,909,269,520,161,389,Center,19,Pullup Jump shot,16.233223322332233
2022-23,1630169,Tyrese Haliburton,PG,412,841,251,439,161,402,Center,25,Pullup Jump shot,15.730083234244946
2022-23,1631213,Tyrese Martin,SG,9,23,8,16,1,7,Center,6,Jump Shot,11.782608695652174
2020-21,1630178,Tyrese Maxey,SG,198,429,167,326,31,103,Center,20,Pullup Jump shot,11.813519813519813
2021-22,1630178,Tyrese Maxey,PG,483,995,351,686,132,309,Center,19,Jump Shot,12.37788944723618
2022-23,1630178,Tyrese Maxey,SG,439,913,279,544,160,369,Center,12,Jump Shot,14.173055859802847
2003-04,238,Tyrone Hill,PF,3,5,3,5,0,0,Center,0,Layup Shot,3.4
2017-18,1627820,Tyrone Wallace,PG,110,247,100,207,10,40,Center,5,Jump Shot,8.246963562753036
2018-19,1627820,Tyrone Wallace,PG,92,217,88,198,4,19,Center,14,Floating Jump shot,6.870967741935484
2019-20,1627820,Tyrone Wallace,SG,14,44,13,29,1,15,Center,3,Jump Shot,11.409090909090908
2021-22,1627820,Tyrone Wallace,SG,7,20,5,12,2,8,Center,2,Jump Shot,12.5
2003-04,1731,Tyronn Lue,PG,309,714,229,505,80,209,Center,8,Jump Shot,16.04621848739496
2004-05,1731,Tyronn Lue,PG,295,654,240,499,55,155,Center,9,Jump Shot,13.579510703363914
2005-06,1731,Tyronn Lue,PG,192,418,134,291,58,127,Center,13,Jump Shot,14.964114832535886
2006-07,1731,Tyronn Lue,PG,218,524,162,363,56,161,Center,12,Jump Shot,16.1793893129771
2007-08,1731,Tyronn Lue,PG,113,253,74,167,39,86,Center,5,Jump Shot,16.90909090909091
2008-09,1731,Tyronn Lue,PG,71,162,44,100,27,62,Center,2,Jump Shot,17.166666666666668
2006-07,200748,Tyrus Thomas,PF,134,282,134,280,0,2,Center,11,Layup Shot,4.25177304964539
2007-08,200748,Tyrus Thomas,PF,186,440,185,434,1,6,Center,3,Jump Shot,7.879545454545455
2008-09,200748,Tyrus Thomas,PF,308,683,305,674,3,9,Center,12,Jump Shot,8.592972181551977
2009-10,200748,Tyrus Thomas,PF-C,194,420,194,417,0,3,Center,10,Jump Shot,7.935714285714286
2010-11,200748,Tyrus Thomas,C,156,331,156,328,0,3,Center,10,Jump Shot,9.03323262839879
2011-12,200748,Tyrus Thomas,PF,120,327,119,324,1,3,Center,4,Jump Shot,11.880733944954128
2012-13,200748,Tyrus Thomas,PF,48,136,45,128,3,8,Center,1,Jump Shot,13.720588235294118
2014-15,200748,Tyrus Thomas,PF,1,1,1,1,0,0,Right Side,1,Pullup Jump shot,12.0
2012-13,203116,Tyshawn Taylor,PG,32,87,26,74,6,13,Center,9,Jump Shot,8.839080459770114
2013-14,203116,Tyshawn Taylor,PG,31,91,28,79,3,12,Center,1,Jump Shot,9.659340659340659
2003-04,2199,Tyson Chandler,PF,67,158,67,157,0,1,Center,0,Jump Shot,5.563291139240507
2004-05,2199,Tyson Chandler,C,207,419,207,417,0,2,Center,15,Layup Shot,4.102625298329356
2005-06,2199,Tyson Chandler,C,160,283,160,282,0,1,Center,5,Layup Shot,2.2508833922261484
2006-07,2199,Tyson Chandler,C,292,468,292,467,0,1,Center,11,Layup Shot,2.2457264957264957
2007-08,2199,Tyson Chandler,C,377,605,377,604,0,1,Center,12,Layup Shot,1.9289256198347107
2008-09,2199,Tyson Chandler,C,160,283,160,283,0,0,Center,4,Alley Oop Dunk Shot,1.4911660777385158
2009-10,2199,Tyson Chandler,C,109,190,109,190,0,0,Center,2,Layup Shot,1.8157894736842106
2010-11,2199,Tyson Chandler,C,266,407,266,407,0,0,Center,5,Layup Shot,3.2653562653562656
2011-12,2199,Tyson Chandler,C,241,355,241,353,0,2,Center,5,Layup Shot,1.8788732394366197
2012-13,2199,Tyson Chandler,C,255,400,255,400,0,0,Center,6,Layup Shot,1.7575
2013-14,2199,Tyson Chandler,C,191,322,191,321,0,1,Center,4,Layup Shot,3.2267080745341614
2014-15,2199,Tyson Chandler,C,293,440,293,440,0,0,Center,5,Alley Oop Dunk Shot,2.5386363636363636
2015-16,2199,Tyson Chandler,C,183,314,183,313,0,1,Center,5,Alley Oop Dunk Shot,2.78343949044586
2016-17,2199,Tyson Chandler,C,153,228,153,228,0,0,Center,7,Tip Layup Shot,1.1140350877192982
2017-18,2199,Tyson Chandler,C,121,187,121,187,0,0,Center,4,Tip Layup Shot,1.0
2018-19,2199,Tyson Chandler,C,61,99,61,98,0,1,Center,0,Tip Layup Shot,1.5555555555555556
2019-20,2199,Tyson Chandler,C,14,18,14,18,0,0,Center,2,Alley Oop Dunk Shot,0.8333333333333334
2015-16,1626145,Tyus Jones,PG,56,156,40,103,16,53,Center,5,Jump Shot,13.429487179487179
2016-17,1626145,Tyus Jones,PG,75,181,49,108,26,73,Center,9,Jump Shot,14.408839779005525
2017-18,1626145,Tyus Jones,PG,150,328,105,199,45,129,Center,4,Jump Shot,13.99390243902439
2018-19,1626145,Tyus Jones,PG,185,446,145,320,40,126,Center,1,Jump Shot,12.710762331838565
2019-20,1626145,Tyus Jones,PG,197,429,150,305,47,124,Center,4,Driving Floating Jump Shot,13.088578088578089
2020-21,1626145,Tyus Jones,PG,178,413,133,273,45,140,Center,3,Driving Floating Jump Shot,13.721549636803875
2021-22,1626145,Tyus Jones,PG,249,552,169,347,80,205,Center,3,Jump Shot,14.731884057971014
2022-23,1626145,Tyus Jones,PG,311,710,190,384,121,326,Center,4,Jump Shot,16.138028169014085
2020-21,1628962,Udoka Azubuike,C,4,9,4,9,0,0,Center,3,Layup Shot,2.3333333333333335
2021-22,1628962,Udoka Azubuike,C,37,49,37,49,0,0,Center,8,Dunk Shot,2.306122448979592
2022-23,1628962,Udoka Azubuike,C,59,72,59,72,0,0,Center,9,Dunk Shot,2.236111111111111
2003-04,2617,Udonis Haslem,PF,205,447,205,444,0,3,Center,11,Jump Shot,7.331096196868009
2004-05,2617,Udonis Haslem,PF,346,641,346,637,0,4,Center,6,Jump Shot,7.7067082683307335
2005-06,2617,Udonis Haslem,PF,300,591,300,589,0,2,Center,9,Jump Shot,10.656514382402706
2006-07,2617,Udonis Haslem,PF,353,717,353,713,0,4,Center,13,Jump Shot,9.253835425383542
2007-08,2617,Udonis Haslem,PF,237,507,237,507,0,0,Center,12,Jump Shot,10.226824457593688
2008-09,2617,Udonis Haslem,PF,333,643,333,643,0,0,Center,16,Jump Shot,10.384136858475895
2009-10,2617,Udonis Haslem,PF,312,632,312,632,0,0,Center,16,Jump Shot,11.045886075949367
2010-11,2617,Udonis Haslem,PF,44,86,44,86,0,0,Center,3,Jump Shot,11.848837209302326
2011-12,2617,Udonis Haslem,PF,151,357,151,357,0,0,Center,6,Jump Shot,9.795518207282914
2012-13,2617,Udonis Haslem,PF,129,251,129,251,0,0,Center,0,Jump Shot,8.641434262948207
2013-14,2617,Udonis Haslem,PF,74,146,74,146,0,0,Center,3,Jump Shot,8.342465753424657
2014-15,2617,Udonis Haslem,PF,107,239,105,229,2,10,Center,8,Jump Shot,8.305439330543933
2015-16,2617,Udonis Haslem,PF,23,61,22,52,1,9,Center,4,Jump Shot,13.065573770491802
2016-17,2617,Udonis Haslem,C,11,23,11,20,0,3,Center,0,Jump Shot,7.521739130434782
2017-18,2617,Udonis Haslem,C,3,15,2,7,1,8,Center,2,Jump Shot,19.666666666666668
2018-19,2617,Udonis Haslem,C,11,33,11,21,0,12,Center,1,Jump Shot,14.545454545454545
2019-20,2617,Udonis Haslem,C,4,11,3,8,1,3,Center,0,Jump Shot,9.909090909090908
2020-21,2617,Udonis Haslem,C,2,2,2,2,0,0,Left Side,0,Jump Shot,8.0
2021-22,2617,Udonis Haslem,C,14,31,13,27,1,4,Center,5,Jump Shot,8.838709677419354
2022-23,2617,Udonis Haslem,C,10,29,7,20,3,9,Center,1,Jump Shot,14.172413793103448
2006-07,101166,Uros Slokar,C,14,26,13,24,1,2,Center,4,Jump Shot,12.884615384615385
2021-22,1630586,Usman Garuba,PF,19,44,14,24,5,20,Center,1,Jump Shot,12.204545454545455
2022-23,1630586,Usman Garuba,PF,86,177,62,118,24,59,Center,5,Jump Shot,9.491525423728813
2013-14,203505,Vander Blue,SG,2,4,2,3,0,1,Center,1,Jump Shot,12.5
2014-15,203505,Vander Blue,SG,9,30,7,20,2,10,Center,0,Jump Shot,12.4
2017-18,203505,Vander Blue,SG,1,5,1,3,0,2,Center,0,Jump Shot,10.4
2006-07,2779,Vassilis Spanoulis,SG,23,72,18,43,5,29,Center,7,Jump Shot,13.777777777777779
2020-21,1630176,Vernon Carey Jr.,C,18,36,17,29,1,7,Center,4,Jump Shot,10.055555555555555
2021-22,1630176,Vernon Carey Jr.,C,7,13,7,13,0,0,Center,1,Jump Shot,7.538461538461538
2022-23,1630176,Vernon Carey Jr.,C,2,8,2,8,0,0,Center,1,Pullup Jump shot,7.25
2011-12,202731,Vernon Macklin,C,19,35,19,35,0,0,Center,9,Layup Shot,2.1142857142857143
2012-13,203139,Viacheslav Kravtsov,C,33,46,33,46,0,0,Center,7,Layup Shot,1.108695652173913
2013-14,203139,Viacheslav Kravtsov,C,8,15,8,15,0,0,Center,5,Layup Shot,1.2
2019-20,1629724,Vic Law,PF,6,18,5,11,1,7,Center,2,Jump Shot,18.666666666666668
2012-13,201964,Victor Claver,SF,74,189,49,102,25,87,Center,2,Jump Shot,14.08994708994709
2013-14,201964,Victor Claver,SF,17,42,14,24,3,18,Center,3,Jump Shot,13.023809523809524
2014-15,201964,Victor Claver,SF,9,20,3,9,6,11,Center,3,Jump Shot,15.7
2013-14,203506,Victor Oladipo,PG,392,936,318,710,74,226,Center,20,Jump Shot,11.865384615384615
2014-15,203506,Victor Oladipo,SG,473,1086,389,838,84,248,Center,27,Jump Shot,10.757826887661142
2015-16,203506,Victor Oladipo,SG,425,970,327,688,98,282,Center,10,Jump Shot,13.545360824742268
2016-17,203506,Victor Oladipo,SG,412,932,285,580,127,352,Center,14,Jump Shot,14.09656652360515
2017-18,203506,Victor Oladipo,SG,640,1342,479,908,161,434,Center,35,Jump Shot,14.540983606557377
2018-19,203506,Victor Oladipo,SG,249,588,175,372,74,216,Center,14,Pullup Jump shot,15.748299319727892
2019-20,203506,Victor Oladipo,SG,97,246,64,142,33,104,Center,3,Pullup Jump shot,16.073170731707318
2020-21,203506,Victor Oladipo,SG,235,576,157,337,78,239,Center,14,Jump Shot,14.553819444444445
2021-22,203506,Victor Oladipo,SG,35,73,20,37,15,36,Center,2,Jump Shot,16.410958904109588
2022-23,203506,Victor Oladipo,SG,160,403,90,191,70,212,Center,8,Jump Shot,16.65012406947891
2004-05,2751,Viktor Khryapa,SF,54,124,50,113,4,11,Center,4,Jump Shot,10.508064516129032
2005-06,2751,Viktor Khryapa,SF,158,342,148,312,10,30,Center,7,Jump Shot,10.2046783625731
2006-07,2751,Viktor Khryapa,PF,27,70,27,64,0,6,Center,3,Jump Shot,12.957142857142857
2007-08,2751,Viktor Khryapa,PF,12,31,12,30,0,1,Center,4,Jump Shot,13.0
2003-04,452,Vin Baker,PF,208,432,207,429,1,3,Center,5,Jump Shot,6.8842592592592595
2004-05,452,Vin Baker,PF-C,13,42,13,41,0,1,Center,0,Jump Shot,9.047619047619047
2005-06,452,Vin Baker,C,7,15,7,15,0,0,Center,0,Jump Shot,4.533333333333333
2003-04,1713,Vince Carter,SG,608,1457,515,1214,93,243,Center,37,Jump Shot,13.321207961564859
2004-05,1713,Vince Carter,SF-SG,696,1541,569,1228,127,313,Center,25,Jump Shot,12.45425048669695
2005-06,1713,Vince Carter,SG,653,1518,528,1151,125,367,Center,45,Jump Shot,12.204874835309617
2006-07,1713,Vince Carter,SG,726,1598,570,1161,156,437,Center,38,Jump Shot,12.528160200250312
2007-08,1713,Vince Carter,SG,587,1287,489,1014,98,273,Center,20,Jump Shot,12.424242424242424
2008-09,1713,Vince Carter,SG,587,1344,437,953,150,391,Center,29,Jump Shot,14.636904761904763
2009-10,1713,Vince Carter,SG,434,1015,315,691,119,324,Center,24,Jump Shot,14.317241379310344
2010-11,1713,Vince Carter,SG,389,891,273,570,116,321,Center,13,Jump Shot,14.450056116722783
2011-12,1713,Vince Carter,SG,223,542,149,337,74,205,Center,4,Jump Shot,14.249077490774908
2012-13,1713,Vince Carter,SF,372,855,210,456,162,399,Center,16,Jump Shot,16.608187134502923
2013-14,1713,Vince Carter,SG,330,811,184,440,146,371,Center,4,Jump Shot,16.08877928483354
2014-15,1713,Vince Carter,SG,135,406,66,174,69,232,Center,3,Jump Shot,18.82512315270936
2015-16,1713,Vince Carter,SG,133,343,74,174,59,169,Center,6,Jump Shot,16.886297376093296
2016-17,1713,Vince Carter,SF,193,489,81,194,112,295,Center,6,Jump Shot,17.955010224948875
2017-18,1713,Vince Carter,SF,114,283,57,118,57,165,Center,2,Jump Shot,18.247349823321557
2018-19,1713,Vince Carter,PF,196,468,73,152,123,316,Center,3,Jump Shot,19.331196581196583
2019-20,1713,Vince Carter,PF,107,304,46,102,61,202,Center,1,Jump Shot,19.825657894736842
2022-23,1631246,Vince Williams Jr.,SG,12,40,8,12,4,28,Center,3,Jump Shot,17.3
2018-19,1629053,Vincent Edwards,SF,1,4,0,0,1,4,Left Side,1,Jump Shot,23.75
2017-18,1626205,Vincent Hunter,PF,3,5,3,5,0,0,Center,3,Jump Shot,5.8
2019-20,1629738,Vincent Poirier,C,17,36,16,34,1,2,Center,3,Jump Shot,7.527777777777778
2020-21,1629738,Vincent Poirier,C,3,12,3,11,0,1,Center,2,Jump Shot,8.25
2021-22,1630249,Vit Krejci,SG,68,167,36,69,32,98,Center,1,Jump Shot,16.982035928143713
2022-23,1630249,Vit Krejci,PG,15,37,10,16,5,21,Center,6,Jump Shot,15.405405405405405
2003-04,958,Vitaly Potapenko,C,200,409,200,409,0,0,Center,10,Jump Shot,7.577017114914425
2004-05,958,Vitaly Potapenko,C,45,87,45,86,0,1,Center,2,Jump Shot,7.942528735632184
2005-06,958,Vitaly Potapenko,C,37,71,37,71,0,0,Center,4,Jump Shot,6.112676056338028
2006-07,958,Vitaly Potapenko,C,0,4,0,4,0,0,Center,0,Layup Shot,8.75
2013-14,203543,Vitor Faverani,,64,147,52,107,12,40,Center,2,Jump Shot,10.034013605442176
2003-04,124,Vlade Divac,C,314,668,312,655,2,13,Center,8,Jump Shot,7.264970059880239
2004-05,124,Vlade Divac,C,13,31,13,31,0,0,Center,0,Layup Shot,4.129032258064516
2003-04,2209,Vladimir Radmanovic,PF,345,812,205,435,140,377,Center,15,Jump Shot,16.110837438423644
2004-05,2209,Vladimir Radmanovic,PF,267,651,139,322,128,329,Center,9,Jump Shot,16.863287250384026
2005-06,2209,Vladimir Radmanovic,PF,262,643,124,289,138,354,Center,19,Jump Shot,17.321928460342146
2006-07,2209,Vladimir Radmanovic,PF,134,316,94,198,40,118,Center,10,Jump Shot,12.731012658227849
2007-08,2209,Vladimir Radmanovic,SF,198,437,103,203,95,234,Center,4,Jump Shot,15.778032036613272
2008-09,2209,Vladimir Radmanovic,SF,196,466,91,204,105,262,Center,4,Jump Shot,17.536480686695278
2009-10,2209,Vladimir Radmanovic,PF,103,273,73,165,30,108,Center,2,Jump Shot,13.853479853479854
2010-11,2209,Vladimir Radmanovic,PF,137,318,67,145,70,173,Center,11,Jump Shot,16.29559748427673
2011-12,2209,Vladimir Radmanovic,SF,74,197,24,62,50,135,Center,6,Jump Shot,18.934010152284262
2012-13,2209,Vladimir Radmanovic,PF,13,43,8,16,5,27,Center,4,Jump Shot,16.88372093023256
2003-04,1735,Vladimir Stepania,C,43,103,43,103,0,0,Center,2,Layup Shot,5.834951456310679
2019-20,1628427,Vlatko Cancar,PF,6,15,5,9,1,6,Center,4,Jump Shot,12.466666666666667
2020-21,1628427,Vlatko Cancar,PF,33,72,24,39,9,33,Center,4,Jump Shot,13.652777777777779
2021-22,1628427,Vlatko Cancar,PF,23,41,16,29,7,12,Center,1,Jump Shot,10.170731707317072
2022-23,1628427,Vlatko Cancar,PF,108,227,65,112,43,115,Center,3,Jump Shot,14.832599118942731
2005-06,101144,Von Wafer,SG,6,38,4,21,2,17,Center,3,Jump Shot,18.07894736842105
2006-07,101144,Von Wafer,SF,0,1,0,0,0,1,Right Side Center,0,Jump Shot,45.0
2007-08,101144,Von Wafer,SG,17,61,13,35,4,26,Center,5,Jump Shot,16.918032786885245
2008-09,101144,Von Wafer,SG,229,512,165,348,64,164,Center,18,Jump Shot,13.703125
2010-11,101144,Von Wafer,SG,67,159,49,92,18,67,Center,9,Jump Shot,14.874213836477987
2011-12,101144,Von Wafer,SG,71,157,57,118,14,39,Center,13,Jump Shot,11.745222929936306
2003-04,702,Voshon Lenard,SG,394,933,288,644,106,289,Center,13,Jump Shot,15.672025723472668
2004-05,702,Voshon Lenard,SG,10,26,6,14,4,12,Center,2,Jump Shot,16.192307692307693
2005-06,702,Voshon Lenard,SG,75,191,50,113,25,78,Center,6,Jump Shot,17.465968586387433
2016-17,1627735,Wade Baldwin IV,PG,36,115,33,93,3,22,Center,6,Jump Shot,10.939130434782609
2017-18,1627735,Wade Baldwin IV,PG,14,21,10,16,4,5,Center,1,Jump Shot,10.666666666666666
2018-19,1627735,Wade Baldwin IV,PG,10,33,8,24,2,9,Center,4,Driving Layup Shot,11.636363636363637
2022-23,1631117,Walker Kessler,C,298,414,297,411,1,3,Center,9,Putback Layup Shot,2.285024154589372
2011-12,201041,Walker Russell,PG,33,95,29,82,4,13,Center,2,Jump Shot,9.284210526315789
2003-04,1887,Wally Szczerbiak,SF,106,236,86,190,20,46,Center,4,Jump Shot,14.80084745762712
2004-05,1887,Wally Szczerbiak,SF,465,919,402,750,63,169,Center,17,Jump Shot,13.158868335146899
2005-06,1887,Wally Szczerbiak,SF,493,1012,391,757,102,255,Center,23,Jump Shot,13.987154150197629
2006-07,1887,Wally Szczerbiak,SF,161,388,117,282,44,106,Center,5,Jump Shot,15.530927835051546
2007-08,1887,Wally Szczerbiak,SF,311,722,221,504,90,218,Center,11,Jump Shot,16.526315789473685
2008-09,1887,Wally Szczerbiak,SF,179,398,110,230,69,168,Left Side,3,Jump Shot,17.42211055276382
2017-18,1627215,Walt Lemon Jr.,PG,7,16,6,15,1,1,Center,0,Driving Layup Shot,5.125
2018-19,1627215,Walt Lemon Jr.,PG,38,87,36,82,2,5,Center,3,Driving Layup Shot,6.586206896551724
2006-07,200835,Walter Herrmann,PF,174,330,121,215,53,115,Center,15,Jump Shot,13.781818181818181
2007-08,200835,Walter Herrmann,PF,56,144,36,80,20,64,Center,12,Jump Shot,15.61111111111111
2008-09,200835,Walter Herrmann,SF,82,207,41,87,41,120,Left Side,5,Jump Shot,16.96135265700483
2003-04,962,Walter McCarty,PF,203,523,66,157,137,366,Center,6,Jump Shot,20.08604206500956
2004-05,962,Walter McCarty,PF,95,235,40,80,55,155,Center,1,Jump Shot,19.612765957446808
2005-06,962,Walter McCarty,SF,33,99,23,54,10,45,Center,6,Jump Shot,16.626262626262626
2008-09,201594,Walter Sharpe,PF,4,11,4,9,0,2,Center,4,Jump Shot,10.727272727272727
2003-04,1917,Wang Zhi-zhi,C,17,46,13,32,4,14,Center,2,Jump Shot,11.347826086956522
2004-05,1917,Wang Zhi-zhi,C,17,36,15,33,2,3,Center,8,Jump Shot,9.972222222222221
2009-10,201961,Wayne Ellington,SG,190,448,126,286,64,162,Center,18,Jump Shot,15.959821428571429
2010-11,201961,Wayne Ellington,SG,160,397,112,276,48,121,Center,14,Jump Shot,16.037783375314863
2011-12,201961,Wayne Ellington,SG,122,302,87,194,35,108,Center,8,Jump Shot,16.635761589403973
2012-13,201961,Wayne Ellington,SG,226,529,132,289,94,240,Center,10,Jump Shot,17.313799621928165
2013-14,201961,Wayne Ellington,SG,55,126,30,67,25,59,Right Side Center,13,Jump Shot,17.57936507936508
2014-15,201961,Wayne Ellington,SG,254,617,164,374,90,243,Center,9,Jump Shot,17.07617504051864
2015-16,201961,Wayne Ellington,SG,218,561,122,293,96,268,Center,9,Jump Shot,18.32976827094474
2016-17,201961,Wayne Ellington,SG,231,554,82,161,149,393,Left Side Center,9,Jump Shot,21.6028880866426
2017-18,201961,Wayne Ellington,SG,285,700,58,121,227,579,Left Side Center,16,Jump Shot,22.02285714285714
2018-19,201961,Wayne Ellington,SG,184,457,46,85,138,372,Right Side Center,9,Jump Shot,21.282275711159738
2019-20,201961,Wayne Ellington,SG,61,174,11,31,50,143,Right Side Center,4,Jump Shot,22.620689655172413
2020-21,201961,Wayne Ellington,SG,149,338,33,63,116,275,Center,5,Jump Shot,21.91715976331361
2021-22,201961,Wayne Ellington,SG,98,237,16,26,82,211,Right Side Center,7,Jump Shot,22.949367088607595
2016-17,1627782,Wayne Selden,SG,25,58,18,30,7,28,Center,1,Jump Shot,14.620689655172415
2017-18,1627782,Wayne Selden,SG,116,269,67,147,49,122,Center,13,Jump Shot,15.029739776951672
2018-19,1627782,Wayne Selden,SG,196,483,141,309,55,174,Center,8,Jump Shot,13.652173913043478
2021-22,1627782,Wayne Selden,SG,1,4,0,2,1,2,Center,0,Step Back Jump shot,15.25
2005-06,101134,Wayne Simien,PF,58,120,58,120,0,0,Center,5,Jump Shot,9.1
2006-07,101134,Wayne Simien,PF,9,23,9,23,0,0,Center,0,Jump Shot,8.652173913043478
2018-19,1628976,Wendell Carter Jr.,C,180,371,174,339,6,32,Center,4,Jump Shot,7.948787061994609
2019-20,1628976,Wendell Carter Jr.,C,183,343,177,314,6,29,Center,3,Jump Shot,5.524781341107872
2020-21,1628976,Wendell Carter Jr.,C,230,457,215,406,15,51,Center,5,Jump Shot,7.763676148796499
2021-22,1628976,Wendell Carter Jr.,PF,359,684,289,470,70,214,Center,9,Jump Shot,11.640350877192983
2022-23,1628976,Wendell Carter Jr.,C,322,613,242,388,80,225,Center,14,Jump Shot,12.799347471451876
2022-23,1631111,Wendell Moore Jr.,SG,18,43,16,26,2,17,Center,5,Jump Shot,11.232558139534884
2019-20,1629117,Wenyen Gabriel,PF,21,48,15,28,6,20,Center,8,Jump Shot,11.520833333333334
2020-21,1629117,Wenyen Gabriel,PF,24,60,11,28,13,32,Center,2,Jump Shot,14.516666666666667
2021-22,1629117,Wenyen Gabriel,PF,54,110,46,82,8,28,Center,3,Jump Shot,7.990909090909091
2022-23,1629117,Wenyen Gabriel,PF,155,260,145,224,10,36,Center,3,Cutting Layup Shot,5.630769230769231
2017-18,1628411,Wes Iwundu,SF,93,218,84,172,9,46,Center,5,Jump Shot,10.036697247706423
2018-19,1628411,Wes Iwundu,SF,113,274,84,195,29,79,Center,1,Jump Shot,12.138686131386862
2019-20,1628411,Wes Iwundu,SF,97,233,69,151,28,82,Center,5,Jump Shot,13.768240343347639
2020-21,1628411,Wes Iwundu,SF,34,102,29,61,5,41,Center,4,Jump Shot,11.607843137254902
2021-22,1628411,Wes Iwundu,SF,8,18,5,13,3,5,Center,2,Jump Shot,11.88888888888889
2010-11,202325,Wesley Johnson,SG,271,682,168,393,103,289,Center,8,Jump Shot,17.967741935483872
2011-12,202325,Wesley Johnson,SF,158,397,105,228,53,169,Center,4,Jump Shot,17.282115869017634
2012-13,202325,Wesley Johnson,SF,161,396,111,241,50,155,Center,10,Jump Shot,17.87878787878788
2013-14,202325,Wesley Johnson,SF,277,649,177,380,100,269,Center,10,Jump Shot,15.590138674884438
2014-15,202325,Wesley Johnson,SF,286,691,195,432,91,259,Center,10,Jump Shot,16.806078147612155
2015-16,202325,Wesley Johnson,SF,202,507,105,206,97,301,Center,3,Jump Shot,18.757396449704142
2016-17,202325,Wesley Johnson,SF,73,196,44,82,29,114,Center,4,Jump Shot,18.846938775510203
2017-18,202325,Wesley Johnson,SF,150,368,90,191,60,177,Left Side,6,Jump Shot,17.52445652173913
2018-19,202325,Wesley Johnson,SF,45,128,20,52,25,76,Left Side,1,Jump Shot,19.03125
2009-10,202083,Wesley Matthews,SG,273,565,210,400,63,165,Center,9,Jump Shot,10.96283185840708
2010-11,202083,Wesley Matthews,SG,440,979,286,601,154,378,Center,18,Jump Shot,13.489274770173646
2011-12,202083,Wesley Matthews,SG,314,763,185,426,129,337,Center,17,Jump Shot,14.908256880733944
2012-13,202083,Wesley Matthews,SG,351,807,183,383,168,424,Center,20,Jump Shot,16.205700123915737
2013-14,202083,Wesley Matthews,SG,445,1009,244,498,201,511,Center,15,Jump Shot,16.142715559960358
2014-15,202083,Wesley Matthews,SG,336,751,164,307,172,444,Center,11,Jump Shot,17.533954727030626
2015-16,202083,Wesley Matthews,SF,331,854,142,329,189,525,Center,12,Jump Shot,18.489461358313818
2016-17,202083,Wesley Matthews,SG,333,847,159,368,174,479,Center,7,Jump Shot,18.240850059031878
2017-18,202083,Wesley Matthews,SF,283,697,130,295,153,402,Center,10,Jump Shot,18.39167862266858
2018-19,202083,Wesley Matthews,SF-SG,279,698,129,295,150,403,Center,11,Jump Shot,17.792263610315185
2019-20,202083,Wesley Matthews,SG,167,422,59,125,108,297,Center,3,Jump Shot,19.44312796208531
2020-21,202083,Wesley Matthews,SG,89,252,23,55,66,197,Center,4,Jump Shot,20.69047619047619
2021-22,202083,Wesley Matthews,SG,87,220,34,63,53,157,Center,5,Jump Shot,18.65
2022-23,202083,Wesley Matthews,SG,58,160,19,36,39,124,Center,2,Jump Shot,20.50625
2003-04,445,Wesley Person,SG,126,314,71,176,55,138,Left Side Center,1,Jump Shot,19.452229299363058
2004-05,445,Wesley Person,SF,107,226,66,137,41,89,Center,10,Jump Shot,19.030973451327434
2012-13,203115,Will Barton,SG,118,309,109,244,9,65,Center,9,Jump Shot,10.31715210355987
2013-14,203115,Will Barton,SG,65,156,55,123,10,33,Center,9,Jump Shot,10.871794871794872
2014-15,203115,Will Barton,SG,150,353,127,268,23,85,Center,15,Jump Shot,10.827195467422097
2015-16,203115,Will Barton,SG,425,983,313,658,112,325,Center,19,Jump Shot,12.635808748728383
2016-17,203115,Will Barton,SG,295,666,208,431,87,235,Center,14,Jump Shot,12.546546546546546
2017-18,203115,Will Barton,SG,465,1028,309,606,156,422,Center,12,Jump Shot,13.240272373540856
2018-19,203115,Will Barton,SF,185,460,118,264,67,196,Center,6,Jump Shot,14.615217391304348
2019-20,203115,Will Barton,SF,332,738,224,450,108,288,Center,14,Jump Shot,13.047425474254743
2020-21,203115,Will Barton,SF,259,608,161,351,98,257,Center,5,Jump Shot,14.032894736842104
2021-22,203115,Will Barton,SG,392,896,235,466,157,430,Center,15,Jump Shot,15.5078125
2022-23,203115,Will Barton,SG,138,364,72,184,66,180,Center,2,Jump Shot,16.782967032967033
2006-07,200807,Will Blalock,PG,9,30,8,25,1,5,Center,3,Jump Shot,7.833333333333333
2005-06,101198,Will Bynum,PG,21,52,19,43,2,9,Center,2,Jump Shot,10.23076923076923
2008-09,101198,Will Bynum,PG,156,342,153,323,3,19,Center,13,Jump Shot,9.54093567251462
2009-10,101198,Will Bynum,PG,237,534,225,479,12,55,Center,17,Jump Shot,10.837078651685394
2010-11,101198,Will Bynum,PG,182,406,166,356,16,50,Center,16,Jump Shot,9.591133004926109
2011-12,101198,Will Bynum,PG,74,194,67,165,7,29,Center,8,Jump Shot,9.623711340206185
2012-13,101198,Will Bynum,PG,253,540,229,464,24,76,Center,15,Jump Shot,9.435185185185185
2013-14,101198,Will Bynum,PG,184,430,164,368,20,62,Center,13,Jump Shot,10.193023255813953
2014-15,101198,Will Bynum,SG,10,31,10,22,0,9,Left Side Center,1,Jump Shot,14.806451612903226
2014-15,203805,Will Cherry,PG,5,19,3,10,2,9,Center,1,Jump Shot,13.68421052631579
2006-07,101215,Will Conroy,PG-SG,0,3,0,3,0,0,Center,0,Driving Layup Shot,6.333333333333333
2009-10,101215,Will Conroy,PG,3,10,3,7,0,3,Center,1,Jump Shot,9.3
2012-13,101215,Will Conroy,PG,0,9,0,6,0,3,Right Side,0,Jump Shot,13.0
2020-21,1630266,Will Magnay,C,0,1,0,0,0,1,Right Side Center,0,Jump Shot,26.0
2008-09,2226,Will Solomon,PG,105,245,77,159,28,86,Center,11,Jump Shot,16.79591836734694
2019-20,1629739,William Howard,PF,0,4,0,0,0,4,Left Side Center,0,Jump Shot,25.0
2015-16,1626161,Willie Cauley-Stein,C,191,339,191,337,0,2,Center,5,Jump Shot,3.737463126843658
2016-17,1626161,Willie Cauley-Stein,C,255,481,255,479,0,2,Center,19,Jump Shot,5.523908523908524
2017-18,1626161,Willie Cauley-Stein,C,388,773,385,761,3,12,Center,14,Jump Shot,6.240620957309185
2018-19,1626161,Willie Cauley-Stein,C,412,741,411,739,1,2,Center,24,Jump Shot,4.010796221322537
2019-20,1626161,Willie Cauley-Stein,C,175,302,175,301,0,1,Center,4,Jump Shot,4.933774834437086
2020-21,1626161,Willie Cauley-Stein,C,115,182,114,171,1,11,Center,3,Alley Oop Dunk Shot,3.4285714285714284
2021-22,1626161,Willie Cauley-Stein,C,16,35,15,33,1,2,Center,1,Alley Oop Dunk Shot,4.8
2003-04,2584,Willie Green,SG,143,357,124,296,19,61,Center,7,Jump Shot,12.058823529411764
2004-05,2584,Willie Green,SG,155,423,125,318,30,105,Center,17,Jump Shot,13.252955082742316
2005-06,2584,Willie Green,SG,28,66,18,47,10,19,Center,3,Jump Shot,15.878787878787879
2006-07,2584,Willie Green,SG,357,868,306,711,51,157,Center,17,Jump Shot,13.19700460829493
2007-08,2584,Willie Green,SG,379,870,328,691,51,179,Center,2,Jump Shot,12.120689655172415
2008-09,2584,Willie Green,SG,286,657,235,497,51,160,Center,1,Jump Shot,13.799086757990867
2009-10,2584,Willie Green,SG,248,543,201,407,47,136,Center,3,Jump Shot,15.648250460405157
2010-11,2584,Willie Green,SG,270,609,216,454,54,155,Center,10,Jump Shot,15.10344827586207
2011-12,2584,Willie Green,SG,153,325,103,212,50,113,Center,16,Jump Shot,15.775384615384615
2012-13,2584,Willie Green,SG,178,386,107,220,71,166,Center,8,Jump Shot,16.740932642487046
2013-14,2584,Willie Green,SG,102,270,61,150,41,120,Center,6,Jump Shot,17.025925925925925
2014-15,2584,Willie Green,SG,118,306,76,185,42,121,Center,10,Jump Shot,15.705882352941176
2015-16,203186,Willie Reed,C,76,133,76,133,0,0,Center,4,Jump Shot,3.7218045112781954
2016-17,203186,Willie Reed,C,162,285,161,281,1,4,Center,6,Jump Shot,4.021052631578947
2017-18,203186,Willie Reed,C,81,121,80,119,1,2,Center,3,Layup Shot,4.074380165289257
2010-11,202378,Willie Warren,PG,13,35,8,20,5,15,Center,3,Jump Shot,15.057142857142857
2016-17,1626195,Willy Hernangomez,C,246,465,242,450,4,15,Center,8,Layup Shot,4.548387096774194
2017-18,1626195,Willy Hernangomez,C,91,164,86,152,5,12,Center,12,Layup Shot,5.304878048780488
2018-19,1626195,Willy Hernangomez,C,153,295,138,256,15,39,Center,7,Layup Shot,5.864406779661017
2019-20,1626195,Willy Hernangomez,C,74,139,69,117,5,22,Center,6,Jump Shot,6.805755395683454
2020-21,1626195,Willy Hernangomez,C,151,268,150,258,1,10,Center,7,Layup Shot,3.701492537313433
2021-22,1626195,Willy Hernangomez,C,170,327,166,315,4,12,Center,12,Tip Layup Shot,3.840978593272171
2022-23,1626195,Willy Hernangomez,C,89,169,86,158,3,11,Center,6,Layup Shot,4.544378698224852
2007-08,201163,Wilson Chandler,SF,106,242,97,212,9,30,Center,12,Jump Shot,10.62809917355372
2008-09,201163,Wilson Chandler,SF,455,1054,352,740,103,314,Center,10,Jump Shot,13.60246679316888
2009-10,201163,Wilson Chandler,SG,412,860,372,710,40,150,Center,12,Jump Shot,10.652325581395349
2010-11,201163,Wilson Chandler,SF,429,953,317,633,112,320,Center,13,Jump Shot,14.096537250786989
2011-12,201163,Wilson Chandler,SF,31,79,28,67,3,12,Center,2,Jump Shot,12.278481012658228
2012-13,201163,Wilson Chandler,PF,210,455,158,329,52,126,Center,2,Jump Shot,11.281318681318682
2013-14,201163,Wilson Chandler,SF,307,738,185,387,122,351,Center,10,Jump Shot,15.592140921409214
2014-15,201163,Wilson Chandler,SF,418,975,279,569,139,406,Center,10,Jump Shot,13.787692307692307
2016-17,201163,Wilson Chandler,SF,433,939,323,613,110,326,Center,11,Jump Shot,12.995740149094782
2017-18,201163,Wilson Chandler,SF,281,631,193,385,88,246,Center,4,Jump Shot,12.8256735340729
2018-19,201163,Wilson Chandler,PF-SF,114,273,55,115,59,158,Center,2,Jump Shot,17.333333333333332
2019-20,201163,Wilson Chandler,PF,74,183,37,62,37,121,Center,2,Jump Shot,18.360655737704917
2022-23,1641645,Xavier Cooks,PF,17,28,17,27,0,1,Center,3,Layup Shot,5.535714285714286
2010-11,202333,Xavier Henry,SG,65,160,63,143,2,17,Center,4,Jump Shot,13.0
2011-12,202333,Xavier Henry,SG,90,228,83,211,7,17,Center,6,Jump Shot,11.350877192982455
2012-13,202333,Xavier Henry,SF,66,161,62,150,4,11,Center,7,Jump Shot,10.335403726708075
2013-14,202333,Xavier Henry,SF,144,345,116,264,28,81,Center,5,Jump Shot,11.802898550724638
2014-15,202333,Xavier Henry,SF,3,13,3,13,0,0,Center,0,Jump Shot,9.538461538461538
2021-22,1629875,Xavier Moon,SG,25,51,20,37,5,14,Center,2,Pullup Jump shot,15.823529411764707
2022-23,1629875,Xavier Moon,SG,3,9,2,6,1,3,Center,2,Pullup Jump shot,17.666666666666668
2015-16,204098,Xavier Munford,SG,32,77,23,54,9,23,Center,1,Jump Shot,13.454545454545455
2017-18,204098,Xavier Munford,SG,1,6,1,4,0,2,Right Side Center,0,Jump Shot,14.833333333333334
2017-18,1628504,Xavier Rathan-Mayes,SG,12,42,11,28,1,14,Center,2,Jump Shot,16.452380952380953
2011-12,202918,Xavier Silas,SG,4,15,3,9,1,6,Center,0,Jump Shot,13.2
2017-18,202918,Xavier Silas,SG,0,3,0,1,0,2,Center,0,Jump Shot,21.666666666666668
2021-22,1630270,Xavier Sneed,SF,2,10,1,2,1,8,Center,1,Jump Shot,20.5
2022-23,1630270,Xavier Sneed,SF,5,10,2,4,3,6,Center,0,Jump Shot,17.3
2022-23,1630214,Xavier Tillman,,188,306,184,291,4,15,Center,8,Floating Jump shot,4.996732026143791
2020-21,1630214,Xavier Tillman Sr.,,167,299,145,234,22,65,Center,3,Jump Shot,9.301003344481606
2021-22,1630214,Xavier Tillman Sr.,,98,216,88,167,10,49,Center,11,Jump Shot,9.097222222222221
2006-07,200821,Yakhouba Diawara,SG,100,292,51,122,49,170,Center,4,Jump Shot,16.051369863013697
2007-08,200821,Yakhouba Diawara,SG,55,134,34,68,21,66,Center,5,Jump Shot,14.313432835820896
2008-09,200821,Yakhouba Diawara,SF,76,217,25,54,51,163,Right Side Center,4,Jump Shot,20.387096774193548
2009-10,200821,Yakhouba Diawara,SG,2,10,1,4,1,6,Right Side Center,0,Jump Shot,17.9
2018-19,1628999,Yante Maten,PF,1,4,1,3,0,1,Center,0,Jump Shot,9.5
2003-04,2397,Yao Ming,C,535,1025,535,1023,0,2,Center,20,Jump Shot,6.788292682926829
2004-05,2397,Yao Ming,C,538,975,538,975,0,0,Center,23,Jump Shot,5.917948717948718
2005-06,2397,Yao Ming,C,467,900,467,899,0,1,Center,12,Jump Shot,5.907777777777778
2006-07,2397,Yao Ming,C,423,819,423,817,0,2,Center,10,Jump Shot,6.459096459096459
2007-08,2397,Yao Ming,C,432,852,432,850,0,2,Center,13,Jump Shot,7.115023474178404
2008-09,2397,Yao Ming,C,566,1032,565,1031,1,1,Center,15,Layup Shot,6.093023255813954
2010-11,2397,Yao Ming,C,18,37,18,37,0,0,Center,0,Jump Shot,6.891891891891892
2005-06,101117,Yaroslav Korolev,SF,9,30,7,23,2,7,Center,1,Jump Shot,13.666666666666666
2006-07,101117,Yaroslav Korolev,SF,4,16,3,11,1,5,Center,2,Jump Shot,15.75
2007-08,201146,Yi Jianlian,PF,219,520,213,499,6,21,Center,12,Jump Shot,11.98076923076923
2008-09,201146,Yi Jianlian,PF,191,500,143,360,48,140,Center,9,Jump Shot,14.672
2009-10,201146,Yi Jianlian,PF,227,563,212,522,15,41,Center,7,Jump Shot,11.38721136767318
2010-11,201146,Yi Jianlian,PF,145,347,142,334,3,13,Center,4,Jump Shot,12.371757925072046
2011-12,201146,Yi Jianlian,PF,31,82,28,72,3,10,Center,7,Jump Shot,14.890243902439025
2016-17,1627812,Yogi Ferrell,PG,160,394,92,218,68,176,Center,6,Jump Shot,16.21319796954315
2017-18,1627812,Yogi Ferrell,SG,311,730,177,371,134,359,Center,26,Jump Shot,17.352054794520548
2018-19,1627812,Yogi Ferrell,PG,153,352,99,203,54,149,Center,4,Jump Shot,15.582386363636363
2019-20,1627812,Yogi Ferrell,PG,79,188,55,109,24,79,Center,9,Pullup Jump shot,16.867021276595743
2020-21,1627812,Yogi Ferrell,PG,20,57,11,29,9,28,Center,1,Pullup Jump shot,17.736842105263158
2004-05,2657,Yuta Tabuse,PG,1,6,0,5,1,1,Center,0,Jump Shot,12.333333333333334
2018-19,1629139,Yuta Watanabe,SF,15,51,13,35,2,16,Center,4,Jump Shot,13.313725490196079
2019-20,1629139,Yuta Watanabe,SF,15,34,12,26,3,8,Center,6,Jump Shot,10.382352941176471
2020-21,1629139,Yuta Watanabe,SF,79,180,43,90,36,90,Center,6,Jump Shot,14.594444444444445
2021-22,1629139,Yuta Watanabe,SF,56,138,29,59,27,79,Center,11,Jump Shot,16.695652173913043
2022-23,1629139,Yuta Watanabe,SF,114,232,54,97,60,135,Center,9,Jump Shot,15.948275862068966
2021-22,1630582,Yves Pons,SF,5,16,2,7,3,9,Center,3,Jump Shot,14.5
2010-11,202220,Zabian Dowdell,PG,51,125,48,115,3,10,Center,9,Jump Shot,12.92
2017-18,1628380,Zach Collins,C,115,289,80,176,35,113,Center,5,Jump Shot,13.480968858131488
2018-19,1628380,Zach Collins,C,189,400,149,279,40,121,Center,9,Jump Shot,10.3375
2019-20,1628380,Zach Collins,PF,32,68,25,49,7,19,Center,0,Jump Shot,9.308823529411764
2021-22,1628380,Zach Collins,C,76,155,62,114,14,41,Center,3,Jump Shot,10.574193548387097
2022-23,1628380,Zach Collins,C,284,548,229,401,55,147,Center,5,Jump Shot,10.620437956204379
2014-15,203897,Zach LaVine,PG,286,677,229,510,57,167,Center,26,Jump Shot,13.62629246676514
2015-16,203897,Zach LaVine,SG,433,959,310,643,123,316,Center,39,Jump Shot,14.27320125130344
2016-17,203897,Zach LaVine,SG,326,710,206,400,120,310,Center,16,Jump Shot,15.29718309859155
2017-18,203897,Zach LaVine,SG,136,355,94,232,42,123,Center,8,Jump Shot,13.256338028169013
2018-19,203897,Zach LaVine,SG,530,1135,410,814,120,321,Center,31,Jump Shot,11.510132158590308
2019-20,203897,Zach LaVine,SF,539,1199,355,715,184,484,Center,31,Jump Shot,13.437030859049207
2020-21,203897,Zach LaVine,SG,569,1123,369,646,200,477,Center,38,Jump Shot,14.407836153161176
2021-22,203897,Zach LaVine,SG,565,1186,380,711,185,475,Center,23,Jump Shot,14.720067453625632
2022-23,203897,Zach LaVine,SG,673,1388,469,844,204,544,Center,20,Pullup Jump shot,14.436599423631124
2018-19,1629155,Zach Lofton,SG,0,1,0,0,0,1,Left Side Center,0,Jump Shot,25.0
2019-20,1629668,Zach Norvell Jr.,SG,3,12,0,4,3,8,Left Side Center,1,Jump Shot,22.0
2003-04,2216,Zach Randolph,PF,663,1368,662,1363,1,5,Center,26,Jump Shot,7.305555555555555
2004-05,2216,Zach Randolph,PF,332,741,332,735,0,6,Center,14,Jump Shot,7.5425101214574894
2005-06,2216,Zach Randolph,PF,536,1229,520,1174,16,55,Center,16,Jump Shot,9.483319772172498
2006-07,2216,Zach Randolph,PF,600,1286,586,1238,14,48,Center,17,Jump Shot,8.100311041990668
2007-08,2216,Zach Randolph,C,486,1058,464,978,22,80,Center,12,Jump Shot,9.381852551984878
2008-09,2216,Zach Randolph,PF-C,415,873,383,776,32,97,Center,20,Jump Shot,9.61397479954181
2009-10,2216,Zach Randolph,PF,652,1336,637,1284,15,52,Center,20,Jump Shot,7.197604790419161
2010-11,2216,Zach Randolph,PF,598,1188,590,1145,8,43,Center,20,Jump Shot,6.8627946127946124
2011-12,2216,Zach Randolph,PF,132,285,130,277,2,8,Center,3,Jump Shot,7.950877192982456
2012-13,2216,Zach Randolph,PF,471,1024,469,1001,2,23,Center,13,Jump Shot,7.1064453125
2013-14,2216,Zach Randolph,PF,560,1198,558,1178,2,20,Center,24,Jump Shot,7.383138564273789
2014-15,2216,Zach Randolph,PF,454,932,447,912,7,20,Center,13,Jump Shot,7.215665236051502
2015-16,2216,Zach Randolph,PF,431,907,425,881,6,26,Center,13,Jump Shot,8.55457552370452
2016-17,2216,Zach Randolph,PF,433,964,412,870,21,94,Center,7,Jump Shot,9.792531120331951
2017-18,2216,Zach Randolph,PF,361,763,310,616,51,147,Center,12,Jump Shot,11.43905635648755
2003-04,2560,Zarko Cabarkapa,PF,81,197,75,165,6,32,Center,5,Jump Shot,10.263959390862944
2004-05,2560,Zarko Cabarkapa,PF,86,177,73,141,13,36,Center,6,Jump Shot,10.994350282485875
2005-06,2560,Zarko Cabarkapa,PF,67,174,62,154,5,20,Center,5,Jump Shot,9.626436781609195
2021-22,1630285,Zavier Simpson,PG,19,52,18,44,1,8,Center,0,Driving Layup Shot,8.634615384615385
2003-04,2585,Zaza Pachulia,C,68,175,68,175,0,0,Center,7,Layup Shot,3.5714285714285716
2004-05,2585,Zaza Pachulia,C,160,354,160,353,0,1,Center,2,Layup Shot,3.6920903954802258
2005-06,2585,Zaza Pachulia,C,307,681,307,679,0,2,Center,7,Layup Shot,4.466960352422907
2006-07,2585,Zaza Pachulia,C,291,614,291,613,0,1,Center,5,Layup Shot,5.02442996742671
2007-08,2585,Zaza Pachulia,C,107,245,107,242,0,3,Center,1,Jump Shot,6.408163265306122
2008-09,2585,Zaza Pachulia,C,159,320,159,317,0,3,Center,1,Layup Shot,4.48125
2009-10,2585,Zaza Pachulia,C,120,246,120,242,0,4,Center,1,Jump Shot,5.90650406504065
2010-11,2585,Zaza Pachulia,C,107,232,107,232,0,0,Center,2,Layup Shot,4.681034482758621
2011-12,2585,Zaza Pachulia,C,169,339,169,339,0,0,Center,4,Jump Shot,5.209439528023599
2012-13,2585,Zaza Pachulia,C,114,241,114,238,0,3,Center,0,Jump Shot,5.775933609958506
2013-14,2585,Zaza Pachulia,C,149,349,149,348,0,1,Center,9,Jump Shot,5.845272206303725
2014-15,2585,Zaza Pachulia,C,240,529,240,526,0,3,Center,7,Jump Shot,7.455576559546314
2015-16,2585,Zaza Pachulia,C,219,470,219,467,0,3,Center,1,Jump Shot,5.914893617021277
2016-17,2585,Zaza Pachulia,C,164,307,164,305,0,2,Center,0,Layup Shot,4.403908794788274
2017-18,2585,Zaza Pachulia,C,149,264,149,263,0,1,Center,4,Layup Shot,4.6856060606060606
2018-19,2585,Zaza Pachulia,C,85,193,85,189,0,4,Center,2,Layup Shot,6.642487046632124
2020-21,1630192,Zeke Nnaji,PF,50,104,26,45,24,59,Center,10,Jump Shot,15.807692307692308
2021-22,1630192,Zeke Nnaji,PF,96,186,59,106,37,80,Center,3,Jump Shot,12.586021505376344
2022-23,1630192,Zeke Nnaji,PF,110,196,93,131,17,65,Center,5,Jump Shot,9.520408163265307
2003-04,1442,Zeljko Rebraca,C,34,77,34,77,0,0,Center,0,Jump Shot,7.714285714285714
2004-05,1442,Zeljko Rebraca,C,133,234,133,234,0,0,Center,5,Jump Shot,6.482905982905983
2005-06,1442,Zeljko Rebraca,C,52,96,52,96,0,0,Center,0,Jump Shot,6.0
2003-04,1985,Zendon Hamilton,C,51,95,51,95,0,0,Center,4,Layup Shot,2.7578947368421054
2004-05,1985,Zendon Hamilton,C,11,32,11,32,0,0,Center,2,Layup Shot,3.875
2005-06,1985,Zendon Hamilton,C,7,14,7,14,0,0,Center,1,Layup Shot,1.9285714285714286
2018-19,1629015,Zhaire Smith,SG,14,34,8,18,6,16,Center,1,Jump Shot,14.294117647058824
2019-20,1629015,Zhaire Smith,SF,3,11,3,8,0,3,Center,1,Jump Shot,9.727272727272727
2017-18,1627753,Zhou Qi,C,6,32,4,13,2,19,Center,4,Jump Shot,16.8125
2018-19,1627753,Zhou Qi,PF,1,1,1,1,0,0,Center,1,Cutting Dunk Shot,1.0
2021-22,1630533,Ziaire Williams,SF,191,424,115,182,76,242,Center,3,Jump Shot,16.7311320754717
2022-23,1630533,Ziaire Williams,SF,84,196,59,99,25,97,Center,2,Jump Shot,15.153061224489797
2019-20,1629627,Zion Williamson,PF,210,360,204,346,6,14,Center,4,Layup Shot,3.013888888888889
2020-21,1629627,Zion Williamson,PF,634,1037,624,1003,10,34,Center,22,Driving Layup Shot,2.9594985535197686
2022-23,1629627,Zion Williamson,PF,285,469,278,450,7,19,Center,16,Driving Layup Shot,3.624733475479744
2014-15,204054,Zoran Dragic,SG,11,30,8,16,3,14,Center,2,Jump Shot,13.533333333333333
2003-04,2565,Zoran Planinic,SG,53,129,44,97,9,32,Center,7,Jump Shot,11.24031007751938
2004-05,2565,Zoran Planinic,PG,78,174,63,134,15,40,Center,9,Jump Shot,11.706896551724139
2005-06,2565,Zoran Planinic,PG,66,183,53,127,13,56,Center,7,Jump Shot,12.349726775956285
2003-04,980,Zydrunas Ilgauskas,C,466,965,464,958,2,7,Center,7,Jump Shot,6.6082901554404145
2004-05,980,Zydrunas Ilgauskas,C,458,979,456,972,2,7,Center,17,Jump Shot,7.104187946884576
2005-06,980,Zydrunas Ilgauskas,C,450,889,450,884,0,5,Center,4,Jump Shot,6.515185601799775
2006-07,980,Zydrunas Ilgauskas,C,385,793,385,792,0,1,Center,12,Jump Shot,7.5195460277427495
2007-08,980,Zydrunas Ilgauskas,C,417,879,417,878,0,1,Center,12,Jump Shot,9.05688282138794
2008-09,980,Zydrunas Ilgauskas,C,342,724,327,685,15,39,Center,3,Jump Shot,11.660220994475138
2009-10,980,Zydrunas Ilgauskas,C,194,438,183,415,11,23,Center,2,Jump Shot,11.627853881278538
2010-11,980,Zydrunas Ilgauskas,C,162,319,162,318,0,1,Center,1,Jump Shot,11.52037617554859
2019-20,1629597,Zylan Cheatham,PF,6,9,6,8,0,1,Center,1,Putback Layup Shot,5.222222222222222
2021-22,1629597,Zylan Cheatham,SF,0,3,0,1,0,2,Center,0,Jump Shot,16.333333333333332
