SEASON_2,TEAM_ID,TEAM_NAME,total_shots_made,total_shots_attempted,total_2pt_made,total_2pt_attempted,total_3pt_made,total_3pt_attempted,preferred_shot_zone,clutch_shots_made,average_shot_distance,home_performance,away_performance
2003-04,1610612737,Atlanta Hawks,2829,6529,2410,5280,419,1249,Center,129,11.302496553836729,0.44042879019908115,0.4261642156862745
2004-05,1610612737,Atlanta Hawks,2942,6672,2638,5699,304,973,Center,144,10.049010791366907,0.4459783913565426,0.4359281437125748
2005-06,1610612737,Atlanta Hawks,2946,6496,2522,5342,424,1154,Center,141,10.995535714285714,0.4621258399511301,0.4447548106765984
2006-07,1610612737,Atlanta Hawks,2831,6372,2490,5334,341,1038,Center,127,11.360954174513497,0.4519826517967782,0.43638676844783714
2007-08,1610612737,Atlanta Hawks,2975,6552,2591,5474,384,1078,Center,137,11.171550671550671,0.4682660188278166,0.4397054311138386
2008-09,1610612737,Atlanta Hawks,2954,6447,2359,4818,595,1629,Center,142,12.843803319373352,0.4696545284780579,0.44681508967223255
2009-10,1610612737,Atlanta Hawks,3181,6799,2657,5346,524,1453,Center,125,11.8471834093249,0.4715070870697136,0.46409335727109513
2010-11,1610612737,Atlanta Hawks,2971,6428,2469,5002,502,1426,Center,128,13.028469197261979,0.4648365206662554,0.4595103578154426
2011-12,1610612737,Atlanta Hawks,2429,5348,1937,4018,492,1330,Center,99,12.761406133133882,0.45539033457249073,0.4529721595184349
2012-13,1610612737,Atlanta Hawks,3084,6644,2378,4743,706,1901,Center,131,12.94521372667068,0.4688908926961226,0.45945131142598733
2013-14,1610612737,Atlanta Hawks,3061,6687,2293,4572,768,2115,Center,133,12.907581875280394,0.453781512605042,0.461698956780924
2014-15,1610612737,Atlanta Hawks,3121,6699,2303,4547,818,2152,Center,123,12.747574264815643,0.4758745476477684,0.456104049660065
2015-16,1610612737,Atlanta Hawks,3166,6920,2353,4597,813,2323,Center,116,12.684826589595376,0.4672225416906268,0.447704822777455
2016-17,1610612737,Atlanta Hawks,3122,6913,2394,4781,728,2132,Center,142,12.508028352379574,0.4568817818389492,0.44620345939607153
2017-18,1610612737,Atlanta Hawks,3130,7015,2213,4471,917,2544,Center,141,13.573057733428367,0.45277060005742176,0.4396942242355606
2018-19,1610612737,Atlanta Hawks,3392,7524,2325,4490,1067,3034,Center,151,13.072833599149389,0.4540441176470588,0.447524219590958
2019-20,1610612737,Atlanta Hawks,2723,6067,1918,3651,805,2416,Center,116,13.581506510631284,0.45830639948287005,0.4389505549949546
2020-21,1610612737,Atlanta Hawks,2937,6281,2042,3879,895,2402,Center,119,13.456774398981054,0.47541507024265645,0.4598285169895205
2021-22,1610612737,Atlanta Hawks,3401,7241,2345,4420,1056,2821,Center,127,14.049164480044192,0.48150224215246634,0.4582085488701334
2022-23,1610612737,Atlanta Hawks,3658,7574,2776,5069,882,2505,Center,147,12.8662529706892,0.4812322029510743,0.48477499326327134
2003-04,1610612738,Boston Celtics,2843,6415,2290,4816,553,1599,Center,123,12.621200311769291,0.4437577255871446,0.4425920100660585
2004-05,1610612738,Boston Celtics,3046,6511,2609,5259,437,1252,Center,123,10.945630471509753,0.46863468634686345,0.4670144216017183
2005-06,1610612738,Boston Celtics,2951,6322,2484,5032,467,1290,Center,132,11.564220183486238,0.46112,0.4723177979355646
2006-07,1610612738,Boston Celtics,2858,6454,2387,5171,471,1283,Center,147,11.612643321970872,0.442799876657416,0.4428526938648396
2007-08,1610612738,Boston Celtics,2986,6286,2390,4722,596,1564,Center,133,12.255170219535476,0.482085732565579,0.4680379746835443
2008-09,1610612738,Boston Celtics,3075,6333,2537,4978,538,1355,Center,115,11.663350702668561,0.49705608924697864,0.4735994848679974
2009-10,1610612738,Boston Celtics,3039,6293,2540,4861,499,1432,Center,111,11.493246464325441,0.48902132998745296,0.47665056360708535
2010-11,1610612738,Boston Celtics,3023,6219,2615,5100,408,1119,Center,110,11.575816047596076,0.5032278889606198,0.4690804229413649
2011-12,1610612738,Boston Celtics,2341,5086,1978,4098,363,988,Center,95,12.411521824616594,0.46001552795031053,0.4605577689243028
2012-13,1610612738,Boston Celtics,3001,6458,2503,5069,498,1389,Center,125,12.388355528027253,0.4769861286254729,0.4528301886792453
2013-14,1610612738,Boston Celtics,2996,6881,2421,5154,575,1727,Center,117,12.770963522743788,0.44184002343978906,0.4290657439446367
2014-15,1610612738,Boston Celtics,3193,7209,2533,5190,660,2019,Center,153,12.84006103481759,0.4419630548662807,0.4438860971524288
2015-16,1610612738,Boston Celtics,3216,7316,2499,5176,717,2140,Center,148,12.388463641334063,0.4355099838100378,0.4437673130193906
2016-17,1610612738,Boston Celtics,3166,6974,2183,4236,983,2738,Center,124,13.77717235445942,0.4557610241820768,0.4521538016767852
2017-18,1610612738,Boston Celtics,3141,6975,2202,4483,939,2492,Center,140,13.677562724014336,0.4546228020419739,0.44592635546535225
2018-19,1610612738,Boston Celtics,3451,7423,2419,4594,1032,2829,Center,148,14.003367910548295,0.47237124463519314,0.45737483085250336
2019-20,1610612738,Boston Celtics,2971,6448,2066,3961,905,2487,Center,133,13.451923076923077,0.46825642613812324,0.45324634979807393
2020-21,1610612738,Boston Celtics,2985,6401,2006,3783,979,2618,Center,141,14.198718950164038,0.4744479495268139,0.45837202104611574
2021-22,1610612738,Boston Celtics,3341,7167,2256,4123,1085,3044,Center,128,14.341146923398911,0.4664617104527669,0.46586792978545555
2022-23,1610612738,Boston Celtics,3460,7278,2145,3786,1315,3492,Center,129,15.028854080791426,0.4825117047645277,0.46833013435700577
2012-13,1610612751,Brooklyn Nets,2942,6541,2314,4784,628,1757,Center,102,12.157009631554809,0.45066991473812423,0.4488793368130181
2013-14,1610612751,Brooklyn Nets,2930,6390,2222,4469,708,1921,Center,106,13.092801251956182,0.4768148385033579,0.4410052099295127
2014-15,1610612751,Brooklyn Nets,3069,6804,2528,5171,541,1633,Center,119,11.918577307466196,0.4486769409712126,0.4534918276374443
2015-16,1610612751,Brooklyn Nets,3135,6918,2605,5412,530,1506,Center,146,11.59207863544377,0.4636443921106859,0.4430559500142005
2016-17,1610612751,Brooklyn Nets,3101,6985,2225,4395,876,2590,Center,154,12.74001431639227,0.4361671879442707,0.45184544405997695
2017-18,1610612751,Brooklyn Nets,3136,7114,2095,4190,1041,2924,Center,130,13.687095867303908,0.43554301833568404,0.4460633230596806
2018-19,1610612751,Brooklyn Nets,3301,7358,2254,4393,1047,2965,Center,137,13.184968741505845,0.45636856368563683,0.44083969465648853
2019-20,1610612751,Brooklyn Nets,2908,6498,1967,3752,941,2746,Center,108,13.282856263465682,0.461659333752357,0.433956574185766
2020-21,1610612751,Brooklyn Nets,3106,6289,2086,3689,1020,2600,Center,107,13.63507711877882,0.4950176792028287,0.49276274386406543
2021-22,1610612751,Brooklyn Nets,3442,7251,2502,4649,940,2602,Center,118,13.476486001930768,0.46580253723110865,0.48358620689655174
2022-23,1610612751,Brooklyn Nets,3399,6978,2351,4207,1048,2771,Center,135,14.103038119805102,0.4851598173515982,0.4890616004605642
2004-05,1610612766,Charlotte Bobcats,2961,6859,2641,5978,320,881,Center,116,11.377751858871555,0.43874560375146543,0.4247171453437772
2005-06,1610612766,Charlotte Bobcats,2961,6843,2533,5582,428,1261,Center,136,11.576355399678503,0.43241678726483357,0.4329988193624557
2006-07,1610612766,Charlotte Bobcats,2960,6643,2503,5363,457,1280,Center,121,11.409905163329821,0.44350961538461536,0.44766214177978886
2007-08,1610612766,Charlotte Bobcats,2960,6554,2431,5111,529,1443,Center,117,11.69438510833079,0.4584848484848485,0.4446834665027658
2008-09,1610612766,Charlotte Bobcats,2866,6299,2376,4960,490,1339,Center,127,11.225591363708524,0.45428203477141016,0.45568430942687127
2009-10,1610612766,Charlotte Bobcats,2858,6305,2398,4975,460,1330,Center,111,10.73148295003965,0.46091307066916826,0.44544576762149984
2010-11,1610612766,Charlotte Bobcats,2873,6364,2480,5162,393,1202,Center,135,11.461973601508486,0.4595519601742377,0.44317460317460317
2011-12,1610612766,Charlotte Bobcats,2193,5293,1930,4401,263,892,Center,115,12.301152465520499,0.4066390041493776,0.42202876608629825
2012-13,1610612766,Charlotte Bobcats,2823,6649,2354,5250,469,1399,Center,112,11.707474808241841,0.4350571256764883,0.4140836593439663
2013-14,1610612766,Charlotte Bobcats,2976,6727,2460,5259,516,1468,Center,135,12.150587185966998,0.441527446300716,0.44325925925925924
2014-15,1610612766,Charlotte Hornets,2913,6932,2415,5366,498,1566,Center,127,12.747836122331217,0.41914285714285715,0.42132867132867136
2015-16,1610612766,Charlotte Hornets,3036,6921,2163,4512,873,2409,Center,121,13.701632712035833,0.4451201853460759,0.432237600922722
2016-17,1610612766,Charlotte Hornets,3093,6998,2269,4653,824,2345,Center,147,13.412403543869678,0.4485230857470605,0.4354884648248362
2017-18,1610612766,Charlotte Hornets,3197,7106,2373,4873,824,2233,Center,112,13.162257247396566,0.45636261261261263,0.4434440067529544
2018-19,1610612766,Charlotte Hornets,3297,7362,2320,4579,977,2783,Center,130,13.401792991035045,0.4596001095590249,0.43627054702236595
2019-20,1610612766,Charlotte Hornets,2425,5586,1640,3355,785,2231,Center,102,13.020766201217329,0.44088855421686746,0.4279863481228669
2020-21,1610612766,Charlotte Hornets,2875,6324,1890,3658,985,2666,Center,124,13.741302972802025,0.45500473634354277,0.45422869813113714
2021-22,1610612766,Charlotte Hornets,3508,7497,2365,4367,1143,3130,Center,148,13.424569827931172,0.4642094017094017,0.47162270183852917
2022-23,1610612766,Charlotte Hornets,3385,7413,2504,4744,881,2669,Center,165,12.598947794415217,0.45292829775588395,0.4602287842511306
2003-04,1610612741,Chicago Bulls,2798,6753,2369,5497,429,1256,Center,129,12.08262994224789,0.4044679600235156,0.4243509400179051
2004-05,1610612741,Chicago Bulls,2849,6592,2338,5159,511,1433,Center,124,11.936893203883495,0.4343098761703413,0.43005181347150256
2005-06,1610612741,Chicago Bulls,3004,6737,2444,5260,560,1477,Center,136,12.626243134926526,0.4503271861986913,0.4414814814814815
2006-07,1610612741,Chicago Bulls,3046,6663,2566,5426,480,1237,Center,143,12.316073840612336,0.46395453185761293,0.4503012048192771
2007-08,1610612741,Chicago Bulls,2987,6861,2513,5556,474,1305,Center,111,12.212505465675557,0.4383443518252371,0.43228858663512715
2008-09,1610612741,Chicago Bulls,3126,6844,2633,5553,493,1291,Center,134,12.0562536528346,0.46036852880959345,0.45313868613138686
2009-10,1610612741,Chicago Bulls,3081,6824,2729,5759,352,1065,Center,121,11.500879249706916,0.45198723527705253,0.45099200473793305
2010-11,1610612741,Chicago Bulls,3042,6587,2531,5172,511,1415,Center,137,12.047517838166085,0.46424242424242423,0.45938545786431395
2011-12,1610612741,Chicago Bulls,2467,5461,2048,4345,419,1116,Center,99,12.103094671305621,0.4442426443879404,0.45937961595273263
2012-13,1610612741,Chicago Bulls,2926,6698,2480,5433,446,1265,Center,116,11.733502538071066,0.4316353887399464,0.4420832086201736
2013-14,1610612741,Chicago Bulls,2843,6577,2335,5118,508,1459,Center,97,12.184734681465715,0.4324970131421744,0.4320222979250542
2014-15,1610612741,Chicago Bulls,3001,6797,2356,4972,645,1825,Center,129,12.179049580697367,0.4396999422965955,0.4434103872710898
2015-16,1610612741,Chicago Bulls,3165,7170,2514,5417,651,1753,Center,134,12.189958158995816,0.4386936064212566,0.44419454596570146
2016-17,1610612741,Chicago Bulls,3169,7138,2546,5310,623,1828,Center,126,12.355001400952649,0.43850415512465374,0.44954648526077096
2017-18,1610612741,Chicago Bulls,3170,7285,2264,4736,906,2549,Center,132,13.611805078929306,0.4378600823045268,0.43241758241758244
2018-19,1610612741,Chicago Bulls,3266,7205,2521,5082,745,2123,Center,170,11.897571131158918,0.44896265560165977,0.4576601671309192
2019-20,1610612741,Chicago Bulls,2573,5762,1780,3480,793,2282,Center,107,12.760152724748352,0.44370860927152317,0.449671772428884
2020-21,1610612741,Chicago Bulls,3035,6380,2131,3934,904,2446,Center,110,13.303291536050157,0.4690851735015773,0.4822429906542056
2021-22,1610612741,Chicago Bulls,3422,7127,2550,4763,872,2364,Center,131,13.367756419250737,0.4852005532503458,0.47494305239179957
2022-23,1610612741,Chicago Bulls,3488,7116,2634,4749,854,2367,Center,133,13.100758853288363,0.49490950226244346,0.48547486033519555
2003-04,1610612739,Cleveland Cavaliers,2922,6753,2675,5967,247,786,Center,119,10.155042203465127,0.43338171262699565,0.4319830713422007
2004-05,1610612739,Cleveland Cavaliers,2990,6687,2690,5783,300,904,Center,135,10.741887243906087,0.4620731338773043,0.4325044404973357
2005-06,1610612739,Cleveland Cavaliers,2908,6412,2411,4947,497,1465,Center,132,11.494541484716157,0.46283572767020614,0.4442367601246106
2006-07,1610612739,Cleveland Cavaliers,2978,6658,2484,5254,494,1404,Center,128,11.629918894562932,0.4536760310818888,0.44082125603864736
2007-08,1610612739,Cleveland Cavaliers,2937,6697,2385,5153,552,1544,Center,149,12.284903688218606,0.4427253793513835,0.43435251798561153
2008-09,1610612739,Cleveland Cavaliers,3022,6454,2366,4784,656,1670,Center,105,13.315308335915711,0.4777365491651206,0.45869565217391306
2009-10,1610612739,Cleveland Cavaliers,3100,6390,2499,4809,601,1581,Center,106,12.050234741784038,0.4965560425798372,0.4737171464330413
2010-11,1610612739,Cleveland Cavaliers,2886,6647,2377,5158,509,1489,Center,116,11.850910185045885,0.4336842105263158,0.43467790487658037
2011-12,1610612739,Cleveland Cavaliers,2261,5360,1821,4087,440,1273,Center,129,11.255597014925373,0.4227188081936685,0.42093457943925233
2012-13,1610612739,Cleveland Cavaliers,2993,6901,2446,5320,547,1581,Center,136,11.88566874366034,0.4351476548928778,0.43225993617638525
2013-14,1610612739,Cleveland Cavaliers,3036,6954,2452,5315,584,1639,Center,121,12.298964624676445,0.43379642755883185,0.43945141523198133
2014-15,1610612739,Cleveland Cavaliers,3088,6738,2263,4486,825,2252,Center,119,12.770851884832295,0.4683088014418744,0.448518627163391
2015-16,1610612739,Cleveland Cavaliers,3169,6883,2291,4460,878,2423,Center,133,13.246404184221996,0.46887608069164266,0.451801933782596
2016-17,1610612739,Cleveland Cavaliers,3273,6956,2208,4184,1065,2772,Center,129,13.98174238067855,0.48185195770220063,0.45906855655192363
2017-18,1610612739,Cleveland Cavaliers,3311,6950,2330,4314,981,2636,Center,126,13.810935251798561,0.48320413436692505,0.4695702336313816
2018-19,1610612739,Cleveland Cavaliers,3189,7184,2342,4796,847,2388,Center,131,12.937360801781738,0.44509313316652765,0.4427097853359353
2019-20,1610612739,Cleveland Cavaliers,2619,5715,1892,3645,727,2070,Center,115,12.745056867891513,0.46163522012578617,0.454043392504931
2020-21,1610612739,Cleveland Cavaliers,2778,6175,2058,4034,720,2141,Center,96,12.07012145748988,0.4596513879922531,0.44003899902502436
2021-22,1610612739,Cleveland Cavaliers,3255,6940,2302,4254,953,2686,Center,127,13.263544668587896,0.4678951914771091,0.4701471012402654
2022-23,1610612739,Cleveland Cavaliers,3408,6984,2458,4395,950,2589,Center,108,12.932846506300114,0.4918126975007182,0.4841564373394234
2003-04,1610612742,Dallas Mavericks,3322,7230,2815,5774,507,1456,Center,134,11.717704011065006,0.4803215077605322,0.4387078961899503
2004-05,1610612742,Dallas Mavericks,3058,6691,2595,5418,463,1273,Center,122,11.904498580182334,0.45725235849056606,0.45680509245225825
2005-06,1610612742,Dallas Mavericks,2948,6375,2532,5262,416,1113,Center,112,11.485333333333333,0.47125710675931776,0.45372390152695546
2006-07,1610612742,Dallas Mavericks,3010,6442,2475,5038,535,1404,Center,115,12.621701334989133,0.47679455445544555,0.45763239875389405
2007-08,1610612742,Dallas Mavericks,3025,6515,2531,5112,494,1403,Center,127,12.66968534151957,0.4788602941176471,0.4497077822208551
2008-09,1610612742,Dallas Mavericks,3128,6770,2557,5138,571,1632,Center,127,13.002363367799115,0.47917906008328376,0.4451291079812207
2009-10,1610612742,Dallas Mavericks,3140,6759,2582,5262,558,1497,Center,113,12.340434975588105,0.46069739952718675,0.46844444444444444
2010-11,1610612742,Dallas Mavericks,3069,6463,2424,4695,645,1768,Center,124,13.125019340863377,0.4824588637069233,0.46730413325107956
2011-12,1610612742,Dallas Mavericks,2398,5412,1901,3948,497,1464,Center,90,12.911677753141168,0.44265298644192014,0.44353335818114054
2012-13,1610612742,Dallas Mavericks,3182,6892,2576,5264,606,1628,Center,121,12.55034822983169,0.4676113360323887,0.4557367501456028
2013-14,1610612742,Dallas Mavericks,3248,6857,2528,4981,720,1876,Center,124,12.773078605804288,0.4797297297297297,0.46770923834346945
2014-15,1610612742,Dallas Mavericks,3255,7036,2523,4954,732,2082,Center,144,12.805571347356453,0.47179635522129015,0.45375803297010336
2015-16,1610612742,Dallas Mavericks,3062,6898,2258,4558,804,2340,Center,118,13.692809510002899,0.4515001456452083,0.43636363636363634
2016-17,1610612742,Dallas Mavericks,2967,6749,2090,4277,877,2472,Center,127,14.890650466735813,0.4426912771658232,0.4365781710914454
2017-18,1610612742,Dallas Mavericks,3128,7042,2161,4354,967,2688,Center,157,14.409258733314399,0.44337757695566227,0.4450157097972008
2018-19,1610612742,Dallas Mavericks,3182,7122,2160,4120,1022,3002,Center,129,14.009407469811851,0.4523539421440726,0.4413236929922136
2019-20,1610612742,Dallas Mavericks,3124,6772,1988,3677,1136,3095,Center,116,14.710720614294152,0.46200873362445416,0.46059334731795026
2020-21,1610612742,Dallas Mavericks,2958,6287,1964,3543,994,2744,Center,123,14.778431684428185,0.4665594855305466,0.4743468681145735
2021-22,1610612742,Dallas Mavericks,3222,6982,2149,3919,1073,3063,Center,117,14.81094242337439,0.4597602739726027,0.4631972397929845
2022-23,1610612742,Dallas Mavericks,3283,6909,2037,3547,1246,3362,Center,108,15.140686061658705,0.4750499001996008,0.47530864197530864
2003-04,1610612743,Denver Nuggets,2993,6763,2662,5778,331,985,Center,127,10.99659914239243,0.4504820333041192,0.4344311377245509
2004-05,1610612743,Denver Nuggets,3038,6615,2718,5675,320,940,Center,136,10.772184429327286,0.46780473195567535,0.45054945054945056
2005-06,1610612743,Denver Nuggets,3078,6672,2728,5596,350,1076,Center,105,11.06115107913669,0.46611909650924027,0.4563285320257432
2006-07,1610612743,Denver Nuggets,3164,6805,2680,5365,484,1440,Center,111,11.12417340191036,0.46442056346209704,0.46549672813801307
2007-08,1610612743,Denver Nuggets,3307,7038,2738,5433,569,1605,Center,134,11.548593350383632,0.46619718309859154,0.4736238532110092
2008-09,1610612743,Denver Nuggets,3058,6510,2510,5033,548,1477,Center,114,11.443317972350231,0.47450381679389314,0.4649149922720247
2009-10,1610612743,Denver Nuggets,3124,6678,2580,5161,544,1517,Center,120,11.702605570530098,0.47672694930329085,0.4586989409984871
2010-11,1610612743,Denver Nuggets,3144,6609,2483,4909,661,1700,Center,144,11.829626267211378,0.4884971616372871,0.46259963212752914
2011-12,1610612743,Denver Nuggets,2572,5403,2137,4093,435,1310,Center,106,10.526374236535258,0.4791666666666667,0.4730365544697792
2012-13,1610612743,Denver Nuggets,3339,6981,2818,5465,521,1516,Center,136,9.86219739292365,0.48613889682766503,0.4704192992533027
2013-14,1610612743,Denver Nuggets,3147,7042,2445,5083,702,1959,Center,118,12.018176654359557,0.4455583402951824,0.4482758620689655
2014-15,1610612743,Denver Nuggets,3099,7158,2439,5126,660,2032,Center,141,12.26348141939089,0.4369040942232193,0.4290089086859688
2015-16,1610612743,Denver Nuggets,3092,7002,2437,5060,655,1942,Center,123,11.75078548986004,0.44380236925744004,0.4394238915560576
2016-17,1610612743,Denver Nuggets,3377,7190,2507,4829,870,2361,Center,133,12.322531293463143,0.481998325425621,0.4574438591627391
2017-18,1610612743,Denver Nuggets,3338,7102,2398,4566,940,2536,Center,140,12.795550549141087,0.4777304964539007,0.4623986580933743
2018-19,1610612743,Denver Nuggets,3439,7384,2536,4813,903,2571,Center,145,12.572589382448538,0.4852216748768473,0.44664879356568365
2019-20,1610612743,Denver Nuggets,3069,6488,2268,4254,801,2234,Center,122,12.816892725030826,0.4784456587735276,0.46743894802755165
2020-21,1610612743,Denver Nuggets,3114,6422,2187,3960,927,2462,Center,129,13.64481469947057,0.48197226502311247,0.48788164935473716
2021-22,1610612743,Denver Nuggets,3416,7079,2377,4135,1039,2944,Center,133,13.933606441587795,0.4822278197593059,0.48288648031945236
2022-23,1610612743,Denver Nuggets,3574,7088,2605,4529,969,2559,Center,115,12.928329571106095,0.5138927869772664,0.49446808510638296
2003-04,1610612765,Detroit Pistons,2747,6314,2414,5346,333,968,Center,111,10.328159645232816,0.4429065743944637,0.42711323763955344
2004-05,1610612765,Detroit Pistons,2851,6421,2488,5368,363,1053,Center,113,11.10169755489799,0.4342308882698855,0.45391849529780565
2005-06,1610612765,Detroit Pistons,2983,6558,2426,5107,557,1451,Center,113,12.81793229643184,0.4595001505570611,0.45010812480692
2006-07,1610612765,Detroit Pistons,2942,6484,2493,5179,449,1305,Center,127,11.989049969154843,0.454320987654321,0.4531442663378545
2007-08,1610612765,Detroit Pistons,2999,6551,2512,5221,487,1330,Center,128,13.119218439932835,0.4679817905918058,0.4474815724815725
2008-09,1610612765,Detroit Pistons,2981,6559,2604,5480,377,1079,Center,131,12.300045738679676,0.46220036877688997,0.4468986384266263
2009-10,1610612765,Detroit Pistons,2938,6600,2566,5412,372,1188,Center,136,11.455454545454545,0.43776693105552167,0.45243829018663456
2010-11,1610612765,Detroit Pistons,3055,6646,2584,5391,471,1255,Center,126,11.478934697562444,0.4761189546410333,0.44317154054868857
2011-12,1610612765,Detroit Pistons,2291,5232,1974,4316,317,916,Center,105,10.924120795107033,0.4488854727132975,0.4269961977186312
2012-13,1610612765,Detroit Pistons,2979,6638,2466,5198,513,1440,Center,151,10.613136486893643,0.4597631339204373,0.43796711509715996
2013-14,1610612765,Detroit Pistons,3181,7123,2675,5544,506,1579,Center,109,10.658149656043802,0.45207033465683494,0.44120100083402836
2014-15,1610612765,Detroit Pistons,3041,7038,2338,4995,703,2043,Center,156,11.768684285308327,0.44019411932629177,0.42404526166902407
2015-16,1610612765,Detroit Pistons,3111,7083,2371,4939,740,2144,Center,133,12.285048708174502,0.44932432432432434,0.4290569243840272
2016-17,1610612765,Detroit Pistons,3268,7278,2638,5367,630,1911,Center,134,12.575982412750756,0.45429666119321294,0.44370860927152317
2017-18,1610612765,Detroit Pistons,3208,7129,2322,4756,886,2373,Center,133,13.146584373684949,0.458909912454109,0.4411928651059086
2018-19,1610612765,Detroit Pistons,3185,7238,2192,4384,993,2854,Center,144,13.489085382702404,0.4488558036945134,0.431182497923013
2019-20,1610612765,Detroit Pistons,2595,5658,1804,3501,791,2157,Center,118,12.75751148815836,0.46909219357117626,0.4481782808631058
2020-21,1610612765,Detroit Pistons,2783,6162,1951,3792,832,2370,Center,113,13.011522233041221,0.4480928689883914,0.45503654273911665
2021-22,1610612765,Detroit Pistons,3129,7267,2204,4429,925,2838,Center,125,13.566120820145866,0.4326553051126993,0.4284926977128686
2022-23,1610612765,Detroit Pistons,3244,7140,2310,4481,934,2659,Center,138,13.458403361344537,0.46248600223964165,0.4461883408071749
2003-04,1610612744,Golden State Warriors,2875,6511,2446,5228,429,1283,Center,123,11.502073414222085,0.44977238239757206,0.4331467661691542
2004-05,1610612744,Golden State Warriors,3029,7039,2405,5265,624,1774,Center,137,12.919448785338826,0.43596196868008946,0.42448743863701993
2005-06,1610612744,Golden State Warriors,2939,6785,2314,4953,625,1832,Center,140,12.671333824613118,0.44414655942806075,0.4224037339556593
2006-07,1610612744,Golden State Warriors,3261,7048,2561,5082,700,1966,Center,128,11.933598183881953,0.4798973481608212,0.44563682575543634
2007-08,1610612744,Golden State Warriors,3403,7406,2642,5221,761,2185,Center,140,12.331758034026466,0.46636412172984515,0.4524590163934426
2008-09,1610612744,Golden State Warriors,3231,7054,2681,5580,550,1474,Center,133,12.138644740572724,0.4750283768444949,0.44107648725212467
2009-10,1610612744,Golden State Warriors,3329,7094,2696,5407,633,1687,Center,135,12.855229771638005,0.4730822873082287,0.4653747506412083
2010-11,1610612744,Golden State Warriors,3251,7047,2566,5298,685,1749,Center,132,12.539094650205762,0.47259301334848053,0.4500850822461713
2011-12,1610612744,Golden State Warriors,2489,5443,1965,4092,524,1351,Center,103,12.89178761712291,0.4632623071271124,0.45130466740169056
2012-13,1610612744,Golden State Warriors,3130,6840,2472,5208,658,1632,Center,120,13.003362573099416,0.46561944279786605,0.44979803808424695
2013-14,1610612744,Golden State Warriors,3236,7005,2462,4968,774,2037,Center,132,12.929764453961456,0.4655858930602958,0.4582975064488392
2014-15,1610612744,Golden State Warriors,3410,7137,2527,4920,883,2217,Center,134,13.078043996076783,0.49591664319909884,0.45984383714445065
2015-16,1610612744,Golden State Warriors,3486,7155,2412,4567,1074,2588,Center,143,13.452131376659679,0.49315833566043005,0.4812534974818131
2016-17,1610612744,Golden State Warriors,3531,7139,2550,4578,981,2561,Center,128,13.675724891441378,0.5111669458403126,0.4779308405960079
2017-18,1610612744,Golden State Warriors,3509,6979,2583,4610,926,2369,Center,118,13.966900702106319,0.5098152424942263,0.4958748221906117
2018-19,1610612744,Golden State Warriors,3612,7361,2525,4537,1087,2824,Center,134,14.758185029207988,0.4921323928377645,0.48925170068027213
2019-20,1610612744,Golden State Warriors,2510,5730,1832,3698,678,2032,Center,103,13.960383944153577,0.44248985115020295,0.43330930064888246
2020-21,1610612744,Golden State Warriors,2973,6347,1925,3558,1048,2789,Center,133,14.84055459272097,0.48502230720203954,0.4521657837332502
2021-22,1610612744,Golden State Warriors,3323,7087,2147,3856,1176,3231,Center,140,15.040073373782983,0.47396268448900025,0.46367276887871856
2022-23,1610612744,Golden State Warriors,3538,7393,2175,3853,1363,3540,Center,149,15.527796564317597,0.48065556152606126,0.476436938163988
2003-04,1610612745,Houston Rockets,2738,6195,2223,4789,515,1406,Center,126,12.334301856335754,0.4507491233662735,0.4329627207325049
2004-05,1610612745,Houston Rockets,2846,6419,2293,4898,553,1521,Center,129,13.041127901542296,0.4358893777498429,0.45072598084646276
2005-06,1610612745,Houston Rockets,2708,6252,2239,4838,469,1414,Center,122,12.229526551503518,0.42794071270892464,0.43849399545602075
2006-07,1610612745,Houston Rockets,2906,6528,2201,4635,705,1893,Center,105,12.853400735294118,0.45069124423963136,0.43965780629391993
2007-08,1610612745,Houston Rockets,3003,6698,2420,4991,583,1707,Center,117,12.31516870707674,0.45240200412614207,0.44417549167927384
2008-09,1610612745,Houston Rockets,2959,6525,2338,4870,621,1655,Center,114,11.962145593869732,0.4564755838641189,0.45043370508054525
2009-10,1610612745,Houston Rockets,3093,6921,2448,5085,645,1836,Center,121,11.654674180031787,0.45609968125181105,0.4377521613832853
2010-11,1610612745,Houston Rockets,3169,6973,2493,5132,676,1841,Center,144,12.396099239925427,0.45068027210884354,0.4583454281567489
2011-12,1610612745,Houston Rockets,2489,5542,2011,4213,478,1329,Center,104,12.254601226993865,0.45087531261164704,0.44732045205978854
2012-13,1610612745,Houston Rockets,3124,6781,2257,4413,867,2368,Center,137,12.30261023447869,0.46784140969162996,0.4534952606635071
2013-14,1610612745,Houston Rockets,3114,6599,2339,4424,775,2175,Center,103,11.457948173965752,0.4781144781144781,0.4657863145258103
2014-15,1610612745,Houston Rockets,3032,6831,2099,4152,933,2679,Center,117,12.69814082857561,0.4414705882352941,0.44622559020693675
2015-16,1610612745,Houston Rockets,3093,6841,2216,4314,877,2527,Center,121,12.509574623593043,0.4528742340239276,0.4513766842413591
2016-17,1610612745,Houston Rockets,3302,7145,2124,3846,1178,3299,Center,130,13.965010496850944,0.46283971159179144,0.4614297824244137
2017-18,1610612745,Houston Rockets,3174,6906,1918,3436,1256,3470,Center,118,15.047929336808572,0.46286701208981,0.4562937062937063
2018-19,1610612745,Houston Rockets,3218,7163,1895,3442,1323,3721,Center,117,15.108194890409047,0.4513792142658122,0.4471180749860101
2019-20,1610612745,Houston Rockets,2936,6512,1810,3251,1126,3261,Center,110,14.743857493857494,0.44846457889936153,0.45330437480608127
2020-21,1610612745,Houston Rockets,2826,6372,1834,3449,992,2923,Center,120,14.226773383553045,0.4339861023373342,0.4529008109794136
2021-22,1610612745,Houston Rockets,3229,7083,2124,3913,1105,3170,Center,143,13.727234222786954,0.4600280504908836,0.4516770892552587
2022-23,1610612745,Houston Rockets,3329,7287,2473,4668,856,2619,Center,139,12.519280911211746,0.45720596355604637,0.45648021828103685
2003-04,1610612754,Indiana Pacers,2753,6322,2304,5041,449,1281,Center,104,11.700885795634292,0.4273611546909319,0.44370015948963315
2004-05,1610612754,Indiana Pacers,2668,6169,2126,4594,542,1575,Center,116,12.731885232614687,0.43556701030927836,0.4293637846655791
2005-06,1610612754,Indiana Pacers,2786,6274,2250,4738,536,1536,Center,112,12.43018807778132,0.4532949456174024,0.43487928843710294
2006-07,1610612754,Indiana Pacers,2872,6561,2391,5172,481,1389,Center,133,12.125285779606767,0.44568835098335857,0.4296683046683047
2007-08,1610612754,Indiana Pacers,3102,6993,2347,4972,755,2021,Center,120,13.542113542113542,0.4417817874259938,0.4454439930354034
2008-09,1610612754,Indiana Pacers,3220,7080,2568,5355,652,1725,Center,132,12.456497175141243,0.4548260381593715,0.454778156996587
2009-10,1610612754,Indiana Pacers,3019,6821,2361,4927,658,1894,Center,116,12.99091042369154,0.44907407407407407,0.4359583952451709
2010-11,1610612754,Indiana Pacers,3003,6786,2418,5134,585,1652,Center,109,12.697612732095491,0.4522144522144522,0.4326177698270722
2011-12,1610612754,Indiana Pacers,2354,5374,1962,4311,392,1063,Center,96,11.367696315593598,0.4439132033835969,0.432015065913371
2012-13,1610612754,Indiana Pacers,2845,6524,2290,4926,555,1598,Center,116,12.234671980380135,0.4380952380952381,0.43394437420986093
2013-14,1610612754,Indiana Pacers,2949,6572,2399,5031,550,1541,Center,113,12.494978697504564,0.46076335877862595,0.4367606915377616
2014-15,1610612754,Indiana Pacers,2998,6824,2386,5084,612,1740,Center,133,12.998974208675264,0.4462616822429907,0.4323529411764706
2015-16,1610612754,Indiana Pacers,3135,6970,2479,5096,656,1874,Center,125,13.060975609756097,0.45619596541786744,0.44342857142857145
2016-17,1610612754,Indiana Pacers,3211,6918,2512,5046,699,1872,Center,135,12.982653946227233,0.47227808101120367,0.4559208612161769
2017-18,1610612754,Indiana Pacers,3345,7083,2604,5073,741,2010,Center,140,13.027954256670903,0.47790368271954675,0.46664790318041094
2018-19,1610612754,Indiana Pacers,3390,7135,2611,5054,779,2081,Center,149,12.447372109320252,0.4784182678919521,0.4717832957110609
2019-20,1610612754,Indiana Pacers,3075,6457,2332,4411,743,2046,Center,104,12.767384234164473,0.4797615312205836,0.472782874617737
2020-21,1610612754,Indiana Pacers,3115,6567,2226,4122,889,2445,Center,126,12.669559920816202,0.46627656298121345,0.4822289156626506
2021-22,1610612754,Indiana Pacers,3398,7338,2401,4439,997,2899,Center,134,13.567593349686563,0.47622906537007026,0.44966996699669964
2022-23,1610612754,Indiana Pacers,3444,7345,2332,4315,1112,3030,Center,133,13.554663036078965,0.4736417428725121,0.4640198511166253
2015-16,1610612746,LA Clippers,3128,6726,2344,4569,784,2157,Center,142,14.12340172465061,,
2016-17,1610612746,LA Clippers,3233,6789,2401,4575,832,2214,Center,109,13.78023272941523,,
2017-18,1610612746,LA Clippers,3302,7004,2525,4808,777,2196,Center,140,11.813392347230154,,
2018-19,1610612746,LA Clippers,3384,7178,2563,5060,821,2118,Center,122,11.958205628308722,,
2022-23,1610612746,LA Clippers,3370,7060,2329,4326,1041,2734,Center,137,14.022379603399433,,
2003-04,1610612746,Los Angeles Clippers,2817,6579,2488,5555,329,1024,Center,144,10.674570603435173,0.43248945147679324,0.4237963814780742
2004-05,1610612746,Los Angeles Clippers,2924,6368,2693,5699,231,669,Center,132,11.054177135678392,0.4714108141702921,0.44666666666666666
2005-06,1610612746,Los Angeles Clippers,2993,6443,2703,5600,290,843,Center,126,11.509390035697656,0.4680651221039449,0.4610649430594029
2006-07,1610612746,Los Angeles Clippers,2880,6318,2566,5415,314,903,Center,118,11.823994935106047,0.4610721123165284,0.45069095477386933
2007-08,1610612746,Los Angeles Clippers,2820,6445,2470,5366,350,1079,Center,115,12.487975174553918,0.4381846635367762,0.4369230769230769
2008-09,1610612746,Los Angeles Clippers,2955,6695,2420,5183,535,1512,Center,130,11.886183719193427,0.4420925309948594,0.44067296340023615
2009-10,1610612746,Los Angeles Clippers,3001,6600,2519,5144,482,1456,Center,121,11.676363636363636,0.46187363834422657,0.4478889873043992
2010-11,1610612746,Los Angeles Clippers,3012,6590,2502,5075,510,1515,Center,138,11.566767830045524,0.46374162096282756,0.45042321644498184
2011-12,1610612746,Los Angeles Clippers,2437,5362,1925,3925,512,1437,Center,102,13.237784408802685,0.46701846965699206,0.4422296050203027
2012-13,1610612746,Los Angeles Clippers,3160,6606,2533,4856,627,1750,Center,107,12.525128670905238,0.49307645996387717,0.46345919610231423
2013-14,1610612746,Los Angeles Clippers,3206,6754,2515,4795,691,1959,Center,127,13.313740005922416,0.48520710059171596,0.46413752222880855
2014-15,1610612746,Los Angeles Clippers,3227,6827,2401,4628,826,2199,Center,120,14.137835066647137,0.4698046181172291,0.4755001449695564
2019-20,1610612746,Los Angeles Clippers,2992,6425,2097,4015,895,2410,Center,123,13.35035019455253,0.4669344870210136,0.4644089056130448
2020-21,1610612746,Los Angeles Clippers,3009,6242,1982,3744,1027,2498,Center,118,14.379205382890099,0.49019607843137253,0.4739699776429256
2021-22,1610612746,Los Angeles Clippers,3285,7170,2238,4368,1047,2802,Center,153,14.377963737796374,0.46346904629113217,0.45284598214285715
2003-04,1610612747,Los Angeles Lakers,3028,6676,2663,5561,365,1115,Center,123,11.129568603954464,0.45954106280193235,0.44768133174791913
2004-05,1610612747,Los Angeles Lakers,2895,6629,2251,4816,644,1813,Center,125,12.35042992909941,0.44635193133047213,0.4273834273834274
2005-06,1610612747,Los Angeles Lakers,2992,6607,2440,5024,552,1583,Center,118,12.449523232934766,0.46244343891402717,0.4431956257594168
2006-07,1610612747,Los Angeles Lakers,3103,6664,2495,4940,608,1724,Center,139,12.075930372148859,0.4754974754974755,0.45556566575674856
2007-08,1610612747,Los Angeles Lakers,3248,6818,2586,5067,662,1751,Center,147,12.246259900264008,0.47434402332361514,0.4784533648170012
2008-09,1610612747,Los Angeles Lakers,3305,6978,2760,5465,545,1513,Center,140,11.521496130696475,0.4742385425562198,0.473015873015873
2009-10,1610612747,Los Angeles Lakers,3144,6875,2612,5313,532,1562,Center,130,11.784145454545454,0.4589928057553957,0.4555882352941176
2010-11,1610612747,Los Angeles Lakers,3126,6755,2604,5270,522,1485,Center,128,12.238490007401925,0.46629705281587397,0.45913461538461536
2011-12,1610612747,Los Angeles Lakers,2428,5318,2067,4207,361,1111,Center,108,12.015419330575405,0.4678095238095238,0.4455997029335314
2012-13,1610612747,Los Angeles Lakers,3037,6632,2326,4625,711,2007,Center,141,12.835042219541617,0.4666666666666667,0.44920108531805847
2013-14,1610612747,Los Angeles Lakers,3138,6974,2365,4948,773,2026,Center,143,13.033983366790938,0.45936599423631125,0.4406392694063927
2014-15,1610612747,Los Angeles Lakers,3054,7020,2522,5474,532,1546,Center,138,12.53931623931624,0.43940264215967834,0.430751837196156
2015-16,1610612747,Los Angeles Lakers,2876,6947,2241,4940,635,2007,Center,138,13.006765510292212,0.4131874460120933,0.4147956246401842
2016-17,1610612747,Los Angeles Lakers,3216,7140,2494,5054,722,2086,Center,130,12.063305322128851,0.4647174585324712,0.43622662573262627
2017-18,1610612747,Los Angeles Lakers,3338,7248,2516,4864,822,2384,Center,125,12.413217439293598,0.4575109649122807,0.4636111111111111
2018-19,1610612747,Los Angeles Lakers,3491,7425,2644,4884,847,2541,Center,129,12.18949494949495,0.4717391304347826,0.46862483311081443
2019-20,1610612747,Los Angeles Lakers,3006,6269,2224,4027,782,2242,Center,96,12.919923432764396,0.47907276239536384,0.4799241226683528
2020-21,1610612747,Los Angeles Lakers,2925,6197,2129,3949,796,2248,Center,125,12.981119896724222,0.4792746113989637,0.46477967192023156
2021-22,1610612747,Los Angeles Lakers,3415,7279,2433,4453,982,2826,Center,134,13.520675917021569,0.4729064039408867,0.4653793103448276
2022-23,1610612747,Los Angeles Lakers,3516,7298,2631,4740,885,2558,Center,134,12.748287201973143,0.4824753559693319,0.4810751508502468
2003-04,1610612763,Memphis Grizzlies,2963,6657,2516,5343,447,1314,Center,140,10.770467177407241,0.44828622970535176,0.4419093365355749
2004-05,1610612763,Memphis Grizzlies,2802,6271,2271,4785,531,1486,Center,120,11.085472811353851,0.44881141045958794,0.444801026957638
2005-06,1610612763,Memphis Grizzlies,2746,6125,2156,4547,590,1578,Center,127,11.662693877551021,0.4544857048964837,0.44224529526281636
2006-07,1610612763,Memphis Grizzlies,2998,6448,2498,5086,500,1362,Center,151,11.403535980148883,0.4751533742331288,0.4545169385194479
2007-08,1610612763,Memphis Grizzlies,3060,6737,2440,4958,620,1779,Center,145,12.097818019890159,0.47152278177458035,0.4372243457806527
2008-09,1610612763,Memphis Grizzlies,2865,6310,2467,5205,398,1105,Center,118,11.023296354992077,0.4585304320403658,0.4495062121694807
2009-10,1610612763,Memphis Grizzlies,3223,6875,2879,5855,344,1020,Center,127,10.13410909090909,0.462253193960511,0.4753716117749927
2010-11,1610612763,Memphis Grizzlies,3200,6801,2891,5875,309,926,Center,125,10.27348919276577,0.49228486646884273,0.44914019236374236
2011-12,1610612763,Memphis Grizzlies,2425,5422,2148,4573,277,849,Center,101,11.179822943563261,0.45925925925925926,0.43534166054371787
2012-13,1610612763,Memphis Grizzlies,2964,6679,2582,5572,382,1107,Center,101,11.039377152268303,0.4377015537965406,0.4501223990208078
2013-14,1610612763,Memphis Grizzlies,3122,6723,2717,5576,405,1147,Center,130,10.781050126431653,0.4716417910447761,0.4571597983990513
2014-15,1610612763,Memphis Grizzlies,3097,6763,2674,5517,423,1246,Center,132,10.971166642022771,0.4574436969874232,0.45843301435406697
2015-16,1610612763,Memphis Grizzlies,3018,6858,2515,5338,503,1520,Center,120,11.328083989501312,0.4429237041351194,0.43720794392523366
2016-17,1610612763,Memphis Grizzlies,2982,6850,2217,4685,765,2165,Center,119,13.003649635036496,0.4274831526516261,0.44311899912714575
2017-18,1610612763,Memphis Grizzlies,3013,6788,2255,4636,758,2152,Center,124,12.791543901001768,0.44181286549707605,0.44596199524940616
2018-19,1610612763,Memphis Grizzlies,3113,6924,2302,4556,811,2368,Center,140,12.81369150779896,0.4502572898799314,0.44892002335084646
2019-20,1610612763,Memphis Grizzlies,3106,6634,2308,4337,798,2297,Center,124,12.489900512511305,0.47542448614834676,0.4607873054623131
2020-21,1610612763,Memphis Grizzlies,3085,6608,2282,4350,803,2258,Center,116,12.488801452784504,0.4508618082854551,0.48288397455316573
2021-22,1610612763,Memphis Grizzlies,3571,7739,2626,5060,945,2679,Center,130,12.45419304819744,0.4724735073662445,0.4503875968992248
2022-23,1610612763,Memphis Grizzlies,3585,7551,2600,4744,985,2807,Center,121,12.554628526023043,0.485062893081761,0.4642570281124498
2003-04,1610612748,Miami Heat,2729,6417,2244,5060,485,1357,Center,115,11.911173445535297,0.43644859813084114,0.4140941690053009
2004-05,1610612748,Miami Heat,3097,6368,2622,5108,475,1260,Center,122,11.143687185929648,0.48577680525164113,0.4869043862417166
2005-06,1610612748,Miami Heat,3039,6355,2542,4914,497,1441,Center,120,11.041070023603462,0.49681325685149774,0.46005595275101024
2006-07,1610612748,Miami Heat,2919,6288,2391,4749,528,1539,Center,111,12.06663486005089,0.4811320754716981,0.44803982576228996
2007-08,1610612748,Miami Heat,2808,6336,2317,4963,491,1373,Center,124,12.987058080808081,0.45011016682404786,0.43621399176954734
2008-09,1610612748,Miami Heat,3034,6645,2452,5015,582,1630,Center,124,12.881264108352145,0.46612220205686633,0.4471398622342019
2009-10,1610612748,Miami Heat,2984,6518,2490,5092,494,1426,Center,113,12.665388155876036,0.45595382746051033,0.4597024178549287
2010-11,1610612748,Miami Heat,3030,6299,2484,4822,546,1477,Center,116,13.190347674234005,0.47935196950444725,0.4827039035226912
2011-12,1610612748,Miami Heat,2446,5212,2076,4182,370,1030,Center,102,11.576745970836532,0.4768875192604006,0.4617737003058104
2012-13,1610612748,Miami Heat,3148,6346,2431,4539,717,1807,Center,124,12.720453829183738,0.5085173501577287,0.4836272040302267
2013-14,1610612748,Miami Heat,3142,6272,2477,4443,665,1829,Center,126,12.279815051020408,0.5128612257859638,0.48895292987512007
2014-15,1610612748,Miami Heat,2885,6330,2329,4671,556,1659,Center,130,12.378041074249605,0.4636161423578011,0.4480050267043669
2015-16,1610612748,Miami Heat,3148,6693,2652,5217,496,1476,Center,145,11.555953981772001,0.48327809581199155,0.4576170717249555
2016-17,1610612748,Miami Heat,3200,7030,2394,4824,806,2206,Center,126,12.573684210526316,0.470621954714818,0.43998870375600113
2017-18,1610612748,Miami Heat,3184,6997,2281,4491,903,2506,Center,128,13.201800771759325,0.46029035012809566,0.4497703788748565
2018-19,1610612748,Miami Heat,3251,7218,2323,4560,928,2658,Center,124,12.803823773898587,0.4490136148930258,0.4517822602928986
2019-20,1610612748,Miami Heat,2880,6160,1901,3576,979,2584,Center,110,14.202597402597403,0.48321263989466756,0.45227418321588725
2020-21,1610612748,Miami Heat,2824,6029,1892,3423,932,2606,Center,120,14.325261237352795,0.47094390325831376,0.4659239842726081
2021-22,1610612748,Miami Heat,3246,6954,2132,4018,1114,2936,Center,129,14.407966637906242,0.47429231658001153,0.45933562428407787
2022-23,1610612748,Miami Heat,3215,6991,2235,4139,980,2852,Center,139,14.132599055929052,0.4687769784172662,0.4510807736063709
2003-04,1610612749,Milwaukee Bucks,2970,6650,2569,5505,401,1145,Center,119,10.806165413533835,0.45814445451798125,0.43519904220293326
2004-05,1610612749,Milwaukee Bucks,2964,6580,2639,5655,325,925,Center,148,10.719300911854104,0.4573189522342065,0.44377811094452774
2005-06,1610612749,Milwaukee Bucks,2976,6566,2469,5231,507,1335,Center,123,11.066098081023455,0.4623100303951368,0.4441391941391941
2006-07,1610612749,Milwaukee Bucks,3121,6714,2597,5242,524,1472,Center,120,11.052129877867143,0.4782214156079855,0.4518779342723005
2007-08,1610612749,Milwaukee Bucks,3026,6745,2574,5432,452,1313,Center,135,11.224462564862861,0.45835829838226483,0.43909597886703844
2008-09,1610612749,Milwaukee Bucks,3009,6754,2498,5347,511,1407,Center,128,12.048711874444773,0.4548927416985013,0.4359892569382274
2009-10,1610612749,Milwaukee Bucks,3048,6992,2405,5185,643,1807,Center,116,12.580091533180777,0.4388857305287095,0.43293033966609096
2010-11,1610612749,Milwaukee Bucks,2814,6543,2331,5130,483,1413,Center,108,12.287788476234143,0.4342839429634222,0.4259873379559843
2011-12,1610612749,Milwaukee Bucks,2496,5645,2066,4387,430,1258,Center,121,11.857573073516386,0.4497708847373987,0.43447293447293445
2012-13,1610612749,Milwaukee Bucks,3128,7196,2527,5527,601,1669,Center,131,11.724291272929404,0.43940643033800497,0.4298566207478212
2013-14,1610612749,Milwaukee Bucks,2952,6735,2404,5184,548,1551,Center,137,11.621974758723088,0.43546944858420267,0.4411242603550296
2014-15,1610612749,Milwaukee Bucks,3083,6722,2538,5222,545,1500,Center,128,11.400922344540316,0.4629963898916967,0.4543849323131254
2015-16,1610612749,Milwaukee Bucks,3142,6726,2705,5463,437,1263,Center,139,10.066012488849243,0.46959858323494685,0.4646494907130018
2016-17,1610612749,Milwaukee Bucks,3175,6701,2462,4769,713,1932,Center,117,11.374421728100284,0.4794520547945205,0.4681423870774753
2017-18,1610612749,Milwaukee Bucks,3257,6807,2539,4783,718,2024,Center,143,12.39474070809461,0.4828818100625186,0.4741879350348028
2018-19,1610612749,Milwaukee Bucks,3555,7471,2450,4337,1105,3134,Center,148,13.412528443314148,0.483637339055794,0.4680737376436014
2019-20,1610612749,Milwaukee Bucks,3160,6638,2153,3798,1007,2840,Center,128,14.131063573365472,0.48397234443746073,0.46875
2020-21,1610612749,Milwaukee Bucks,3221,6610,2183,3941,1038,2669,Center,124,14.169591527987897,0.49104160340115394,0.483569490503467
2021-22,1610612749,Milwaukee Bucks,3429,7331,2276,4180,1153,3151,Center,136,14.589141999727186,0.46438281674823273,0.4711196277032576
2022-23,1610612749,Milwaukee Bucks,3504,7411,2287,4105,1217,3306,Center,115,14.809067602212927,0.4791386271870794,0.46645021645021645
2003-04,1610612750,Minnesota Timberwolves,3033,6571,2707,5674,326,897,Center,130,12.582407548318368,0.4698500153045608,0.4533898305084746
2004-05,1610612750,Minnesota Timberwolves,3045,6629,2650,5484,395,1145,Center,125,12.794991703122642,0.4621394230769231,0.4565283247500757
2005-06,1610612750,Minnesota Timberwolves,2888,6340,2578,5398,310,942,Center,133,12.084069400630915,0.46038677479725515,0.4505424377791959
2006-07,1610612750,Minnesota Timberwolves,2997,6502,2613,5413,384,1089,Center,133,12.410796677945248,0.4622154779969651,0.4596195821640162
2007-08,1610612750,Minnesota Timberwolves,3076,6817,2635,5558,441,1259,Center,126,11.238521343699574,0.45690672963400236,0.4456109652960047
2008-09,1610612750,Minnesota Timberwolves,2986,6766,2443,5227,543,1539,Center,143,11.579219627549513,0.4411335086181712,0.4415195931797786
2009-10,1610612750,Minnesota Timberwolves,3106,6923,2703,5742,403,1181,Center,160,11.095189946554962,0.45577035735207966,0.4417212881162724
2010-11,1610612750,Minnesota Timberwolves,3090,7014,2501,5449,589,1565,Center,145,12.240661534074707,0.43920454545454546,0.4419004006868918
2011-12,1610612750,Minnesota Timberwolves,2355,5433,1882,4011,473,1422,Center,99,12.172280508006626,0.4252577319587629,0.4416635995583364
2012-13,1610612750,Minnesota Timberwolves,2943,6702,2493,5227,450,1475,Center,136,11.80572963294539,0.43900240384615385,0.43924125666864255
2013-14,1610612750,Minnesota Timberwolves,3188,7173,2589,5418,599,1755,Center,133,11.626516102049353,0.4492067909824659,0.43966480446927375
2014-15,1610612750,Minnesota Timberwolves,2985,6819,2580,5597,405,1222,Center,135,11.599208095028597,0.43640093786635403,0.43909597886703844
2015-16,1610612750,Minnesota Timberwolves,3094,6666,2640,5321,454,1345,Center,146,11.85958595859586,0.46348143639683503,0.464792899408284
2016-17,1610612750,Minnesota Timberwolves,3235,6921,2634,5199,601,1722,Center,150,11.9724028319607,0.4737767360093759,0.46123147092360317
2017-18,1610612750,Minnesota Timberwolves,3365,7063,2707,5218,658,1845,Center,140,12.290952852895371,0.4810871392546932,0.4716657126502576
2018-19,1610612750,Minnesota Timberwolves,3413,7483,2586,5126,827,2357,Center,132,12.596151276226113,0.4620523784072688,0.45014701951349906
2019-20,1610612750,Minnesota Timberwolves,2586,5865,1733,3325,853,2540,Center,111,13.490537084398976,0.4286675639300135,0.4535084687175942
2020-21,1610612750,Minnesota Timberwolves,2932,6546,1988,3840,944,2706,Center,134,13.232508402077604,0.4396524976729755,0.45591333132711404
2021-22,1610612750,Minnesota Timberwolves,3411,7458,2200,4072,1211,3386,Center,126,14.015017430946635,0.4469983775013521,0.4675531914893617
2022-23,1610612750,Minnesota Timberwolves,3515,7167,2518,4436,997,2731,Center,145,12.717455002092926,0.484781405644715,0.49620039403321137
2003-04,1610612751,New Jersey Nets,2813,6372,2436,5249,377,1123,Center,124,11.530445699937225,0.45256854711629374,0.4304470146920913
2004-05,1610612751,New Jersey Nets,2753,6419,2318,5216,435,1203,Center,117,12.567689671288363,0.4325077399380805,0.42521166509877706
2005-06,1610612751,New Jersey Nets,2778,6317,2301,4870,477,1447,Center,136,12.53142314389742,0.4455259026687598,0.4339080459770115
2006-07,1610612751,New Jersey Nets,2913,6379,2304,4703,609,1676,Center,119,12.488634582222918,0.4566167290886392,0.4566929133858268
2007-08,1610612751,New Jersey Nets,2856,6450,2358,5020,498,1430,Center,138,12.06263565891473,0.4402593393022538,0.44534412955465585
2008-09,1610612751,New Jersey Nets,2924,6535,2273,4801,651,1734,Center,145,12.449885233358836,0.4439681567666871,0.4509024166411747
2009-10,1610612751,New Jersey Nets,2813,6554,2436,5369,377,1185,Center,126,11.060115959719255,0.42342892007321536,0.434981684981685
2010-11,1610612751,New Jersey Nets,2918,6638,2459,5301,459,1337,Center,135,12.264236215727628,0.44317498496692725,0.4359903381642512
2011-12,1610612751,New Jersey Nets,2262,5320,1755,3839,507,1481,Center,110,13.298872180451127,0.4284649776453055,0.4218512898330804
2003-04,1610612740,New Orleans Hornets,2772,6605,2241,4939,531,1666,Center,107,12.448448145344436,0.42900856793145653,0.4105483967635601
2004-05,1610612740,New Orleans Hornets,2718,6556,2303,5240,415,1316,Center,133,12.247559487492373,0.42770352369380316,0.4013480392156863
2007-08,1610612740,New Orleans Hornets,3164,6796,2534,5175,630,1621,Center,126,12.389199529134785,0.4725925925925926,0.4586378251973107
2008-09,1610612740,New Orleans Hornets,2910,6364,2355,4840,555,1524,Center,147,12.406033940917661,0.4625959079283887,0.4521013597033375
2009-10,1610612740,New Orleans Hornets,3178,6842,2607,5270,571,1572,Center,143,11.956153171587255,0.4645369284876905,0.4644314868804665
2010-11,1610612740,New Orleans Hornets,2944,6416,2500,5184,444,1232,Center,116,12.272288029925187,0.46954076850984067,0.44821150855365477
2011-12,1610612740,New Orleans Hornets,2300,5103,2041,4326,259,777,Center,97,11.27787575935724,0.44929797191887677,0.4521465143757385
2012-13,1610612740,New Orleans Hornets,2955,6589,2420,5115,535,1474,Center,140,11.592502655941722,0.44910903050437934,0.4478340451494814
2013-14,1610612740,New Orleans Pelicans,3101,6761,2615,5458,486,1303,Center,134,10.98520928856678,0.4642962962962963,0.45304193738924986
2014-15,1610612740,New Orleans Pelicans,3107,6793,2522,5212,585,1581,Center,140,11.394376564110113,0.46688159437280186,0.44779650990831116
2015-16,1610612740,New Orleans Pelicans,3152,7035,2451,5089,701,1946,Center,133,12.466382373845061,0.4581211092246746,0.43787489288774634
2016-17,1610612740,New Orleans Pelicans,3208,7125,2442,4934,766,2191,Center,135,12.880140350877193,0.45522594954255613,0.4451392836839113
2017-18,1610612740,New Orleans Pelicans,3500,7241,2663,4929,837,2312,Center,141,12.525065598674216,0.4969342251950948,0.4700246372844238
2018-19,1610612740,New Orleans Pelicans,3581,7563,2739,5114,842,2449,Center,141,11.953325399973556,0.4716283979941937,0.4753577106518283
2019-20,1610612740,New Orleans Pelicans,3065,6598,2083,3942,982,2656,Center,118,13.341921794483177,0.4638863705046842,0.4651869869261174
2020-21,1610612740,New Orleans Pelicans,3060,6412,2298,4222,762,2190,Center,123,12.10386774797255,0.4809136420525657,0.4735696517412935
2021-22,1610612740,New Orleans Pelicans,3294,7212,2421,4583,873,2629,Center,154,13.145452024403772,0.4654226125137212,0.44786995515695066
2022-23,1610612740,New Orleans Pelicans,3447,7180,2548,4712,899,2468,Center,150,12.606406685236768,0.4832441565756125,0.4769909065858363
2005-06,1610612740,New Orleans/Oklahoma City Hornets,2831,6428,2531,5543,300,885,Center,128,10.85298693217175,0.4520123839009288,0.42870544090056284
2006-07,1610612740,New Orleans/Oklahoma City Hornets,2971,6674,2516,5418,455,1256,Center,149,11.137249026071322,0.4437537004144464,0.44660194174757284
2003-04,1610612752,New York Knicks,2881,6513,2475,5398,406,1115,Center,119,11.851988331030247,0.4461631786472551,0.43843283582089554
2004-05,1610612752,New York Knicks,2978,6599,2537,5359,441,1240,Center,141,11.758448249734808,0.4611128189363664,0.44172145845786015
2005-06,1610612752,New York Knicks,2822,6205,2502,5321,320,884,Center,136,9.723609991941982,0.4575634199812089,0.45185922974767595
2006-07,1610612752,New York Knicks,2903,6356,2429,4986,474,1370,Center,139,10.52092511013216,0.4577332498434565,0.45572422517394057
2007-08,1610612752,New York Knicks,2967,6757,2477,5303,490,1454,Center,139,11.175225691875092,0.445176752546435,0.43316759286341033
2008-09,1610612752,New York Knicks,3157,7091,2334,4807,823,2284,Center,112,12.498237202087152,0.44910688970796714,0.44135802469135804
2009-10,1610612752,New York Knicks,3127,6876,2384,4731,743,2145,Center,144,13.049156486329261,0.46040034812880765,0.44911052785068534
2010-11,1610612752,New York Knicks,3140,6865,2375,4786,765,2079,Center,130,13.052002913328478,0.4715041128084606,0.4435134354232881
2011-12,1610612752,New York Knicks,2365,5335,1848,3797,517,1538,Center,107,12.533458294283037,0.4516616314199396,0.43505768515072574
2012-13,1610612752,New York Knicks,2996,6689,2105,4318,891,2371,Center,114,14.154133652264912,0.45784578457845787,0.43802145411203813
2013-14,1610612752,New York Knicks,3027,6739,2268,4701,759,2038,Center,123,13.912004748479003,0.4545183417834775,0.44388659184878915
2014-15,1610612752,New York Knicks,2882,6726,2322,5112,560,1614,Center,139,13.267618198037466,0.42819148936170215,0.4287851585876721
2015-16,1610612752,New York Knicks,3021,6882,2412,5124,609,1758,Center,123,12.960331299040977,0.43837977592645794,0.43957659511908265
2016-17,1610612752,New York Knicks,3243,7254,2540,5234,703,2020,Center,141,12.745106148331955,0.46177541304956593,0.4327993483573174
2017-18,1610612752,New York Knicks,3334,7193,2661,5279,673,1914,Center,135,12.672042263311553,0.46982281284606864,0.4571348785255515
2018-19,1610612752,New York Knicks,3134,7241,2311,4820,823,2421,Center,135,12.98895180223726,0.4402445803224013,0.42547351084271207
2019-20,1610612752,New York Knicks,2638,5896,2007,4024,631,1872,Center,127,12.432835820895523,0.4486523370863187,0.4462057335581788
2020-21,1610612752,New York Knicks,2839,6225,1992,4062,847,2163,Center,115,13.049477911646587,0.46257629296498554,0.4495501285347044
2021-22,1610612752,New York Knicks,3088,7069,2006,4040,1082,3029,Center,114,14.172725986702504,0.4351535836177474,0.4385026737967914
2022-23,1610612752,New York Knicks,3444,7328,2407,4398,1037,2930,Center,145,13.152292576419214,0.47901234567901235,0.46103719793646486
2008-09,1610612760,Oklahoma City Thunder,2999,6715,2671,5767,328,948,Center,144,10.684288905435592,0.4528014616321559,0.44068784610900613
2009-10,1610612760,Oklahoma City Thunder,3063,6629,2645,5400,418,1229,Center,118,11.109518781113291,0.47617583768828775,0.4484597156398104
2010-11,1610612760,Oklahoma City Thunder,3066,6609,2579,5206,487,1403,Center,122,11.965501588742624,0.47262159681859894,0.4553892215568862
2011-12,1610612760,Oklahoma City Thunder,2462,5229,1990,3912,472,1317,Center,83,12.101740294511378,0.49170204554226166,0.45034116755117515
2012-13,1610612760,Oklahoma City Thunder,3125,6503,2528,4916,597,1587,Center,122,12.105335998769798,0.49493709726910096,0.46609124537607893
2013-14,1610612760,Oklahoma City Thunder,3194,6781,2530,4943,664,1838,Center,115,12.484736764489014,0.4827893175074184,0.4593960715332747
2014-15,1610612760,Oklahoma City Thunder,3183,7116,2552,5255,631,1861,Center,127,11.937183811129849,0.45484949832775917,0.43962585034013607
2015-16,1610612760,Oklahoma City Thunder,3372,7080,2694,5137,678,1943,Center,138,11.876553672316383,0.4775613886536833,0.47497879558948264
2016-17,1610612760,Oklahoma City Thunder,3236,7168,2545,5053,691,2115,Center,147,11.652064732142858,0.4689423614997202,0.4340567612687813
2017-18,1610612760,Oklahoma City Thunder,3271,7221,2390,4730,881,2491,Center,142,13.253704473064673,0.46353139960574485,0.4427792915531335
2018-19,1610612760,Oklahoma City Thunder,3497,7706,2565,5029,932,2677,Center,133,12.425772125616403,0.45227568270481144,0.4553224553224553
2019-20,1610612760,Oklahoma City Thunder,2879,6156,2109,3985,770,2171,Center,132,13.354775828460038,0.48428072403937755,0.45028267376122383
2020-21,1610612760,Oklahoma City Thunder,2795,6338,1938,3809,857,2529,Center,111,13.185705269801199,0.44848293299620734,0.4335223692501575
2021-22,1610612760,Oklahoma City Thunder,3141,7310,2150,4244,991,3066,Center,131,13.797127222982215,0.4382207578253707,0.4212104689203926
2022-23,1610612760,Oklahoma City Thunder,3533,7590,2538,4793,995,2797,Center,152,12.661528326745717,0.480946123521682,0.4499339498018494
2003-04,1610612753,Orlando Magic,2904,6768,2475,5520,429,1248,Center,132,12.388002364066194,0.4302941176470588,0.4278503562945368
2004-05,1610612753,Orlando Magic,3034,6679,2714,5763,320,916,Center,123,11.244647402305734,0.46858328393598103,0.4396369137670197
2005-06,1610612753,Orlando Magic,2911,6167,2612,5371,299,796,Center,148,10.545484027890383,0.4784998383446492,0.46551724137931033
2006-07,1610612753,Orlando Magic,2875,6090,2533,5128,342,962,Center,129,10.428735632183908,0.47480814147480815,0.469447138700291
2007-08,1610612753,Orlando Magic,3058,6446,2257,4372,801,2074,Center,138,12.42413900093081,0.4792770333437208,0.4695705900525178
2008-09,1610612753,Orlando Magic,2929,6416,2112,4269,817,2147,Center,108,13.205112219451372,0.4581772784019975,0.45485678704856786
2009-10,1610612753,Orlando Magic,3005,6394,2164,4153,841,2241,Center,138,13.285267438223334,0.48330733229329176,0.4565694575101913
2010-11,1610612753,Orlando Magic,2956,6409,2186,4308,770,2101,Center,138,13.584958651895771,0.46591266101162426,0.4566026038437694
2011-12,1610612753,Orlando Magic,2275,5162,1605,3377,670,1785,Center,105,13.379891514916698,0.45026778882938023,0.43092621664050235
2012-13,1610612753,Orlando Magic,3093,6904,2587,5367,506,1537,Center,149,12.090527230590961,0.45266530731138943,0.44338807260155577
2013-14,1610612753,Orlando Magic,3021,6782,2459,5188,562,1594,Center,134,12.629017988793866,0.4628099173553719,0.4281084266352387
2014-15,1610612753,Orlando Magic,3076,6792,2522,5194,554,1598,Center,147,11.556242638398116,0.45441219583699793,0.45134575569358176
2015-16,1610612753,Orlando Magic,3242,7117,2606,5302,636,1815,Center,117,12.49711957285373,0.4605079542283003,0.4504810413129598
2016-17,1610612753,Orlando Magic,3138,7130,2438,4994,700,2136,Center,120,13.05960729312763,0.4349421394298617,0.44521884583217175
2017-18,1610612753,Orlando Magic,3182,7042,2338,4637,844,2405,Center,151,13.304600965634762,0.45252984650369527,0.45119182746878544
2018-19,1610612753,Orlando Magic,3316,7307,2379,4674,937,2633,Center,132,13.900095798549335,0.4652701212789416,0.4425115520521881
2019-20,1610612753,Orlando Magic,2871,6468,2064,4114,807,2354,Center,109,13.663110698824985,0.44110032362459545,0.44641799881586736
2020-21,1610612753,Orlando Magic,2754,6423,1970,4135,784,2288,Center,121,13.871399657480929,0.43466085874299937,0.4228731692115924
2021-22,1610612753,Orlando Magic,3139,7240,2140,4218,999,3022,Center,130,13.959806629834254,0.43540802213001384,0.4317241379310345
2022-23,1610612753,Orlando Magic,3323,7074,2440,4523,883,2551,Center,128,13.013712185467911,0.4833759590792839,0.45625879043600565
2003-04,1610612755,Philadelphia 76ers,2682,6260,2343,5268,339,992,Center,104,10.928115015974441,0.4362714013950539,0.4204764971023825
2004-05,1610612755,Philadelphia 76ers,2946,6736,2441,5283,505,1453,Center,100,11.64771377672209,0.44507125890736343,0.42963182897862234
2005-06,1610612755,Philadelphia 76ers,3001,6546,2626,5515,375,1031,Center,120,10.708677054689886,0.46392997283428916,0.4528301886792453
2006-07,1610612755,Philadelphia 76ers,2932,6408,2648,5585,284,823,Center,126,11.019194756554308,0.45411542100283825,0.4609206054989188
2007-08,1610612755,Philadelphia 76ers,3056,6648,2754,5696,302,952,Center,130,10.58739470517449,0.4644262791401756,0.45500747384155454
2008-09,1610612755,Philadelphia 76ers,2997,6531,2656,5460,341,1071,Center,117,10.437911499004747,0.4596996628869139,0.458078335373317
2009-10,1610612755,Philadelphia 76ers,3087,6706,2613,5325,474,1381,Center,108,11.735908141962422,0.4623009912886753,0.4583950251702695
2010-11,1610612755,Philadelphia 76ers,3125,6775,2682,5528,443,1247,Center,124,11.907749077490775,0.4672009498367468,0.45537287140340577
2011-12,1610612755,Philadelphia 76ers,2471,5516,2122,4553,349,963,Center,98,12.051667875271937,0.4452501812907904,0.4506889050036258
2012-13,1610612755,Philadelphia 76ers,3059,6894,2541,5457,518,1437,Center,127,12.252393385552654,0.45268320830929026,0.4346557759626604
2013-14,1610612755,Philadelphia 76ers,3108,7148,2531,5303,577,1845,Center,136,10.912842753217683,0.44168314035583167,0.42805655669531467
2014-15,1610612755,Philadelphia 76ers,2765,6776,2073,4617,692,2159,Center,133,12.222697756788666,0.4187481633852483,0.3972724577527424
2015-16,1610612755,Philadelphia 76ers,2970,6885,2206,4632,764,2253,Center,136,12.4079883805374,0.4340882694541231,0.4286544609125254
2016-17,1610612755,Philadelphia 76ers,3082,6977,2257,4549,825,2428,Center,138,12.754765658592518,0.4421906693711968,0.44129325014180376
2017-18,1610612755,Philadelphia 76ers,3349,7098,2448,4653,901,2445,Center,129,13.33868695407157,0.4756801319043693,0.4677652500722752
2018-19,1610612755,Philadelphia 76ers,3407,7233,2518,4759,889,2474,Center,133,13.007051016175861,0.48423109126430364,0.45808219178082193
2019-20,1610612755,Philadelphia 76ers,3000,6417,2152,4110,848,2307,Center,119,13.3037244818451,0.4839764551994768,0.45251562965168207
2020-21,1610612755,Philadelphia 76ers,2981,6257,2170,4088,811,2169,Center,114,13.214639603643919,0.48646947765890497,0.46606040922377395
2021-22,1610612755,Philadelphia 76ers,3230,6932,2280,4324,950,2608,Center,123,13.528274668205425,0.466189111747851,0.4657176060429983
2022-23,1610612755,Philadelphia 76ers,3347,6870,2312,4195,1035,2675,Center,125,13.477292576419215,0.4791848617176128,0.49519650655021835
2003-04,1610612756,Phoenix Suns,2958,6671,2543,5469,415,1202,Center,126,11.073452256033578,0.45112325440194295,0.43588984305596684
2004-05,1610612756,Phoenix Suns,3351,7018,2555,4992,796,2026,Center,137,12.611570247933884,0.47851893725268513,0.4764367816091954
2005-06,1610612756,Phoenix Suns,3430,7167,2593,5070,837,2097,Center,125,13.985070461838983,0.48811544991511036,0.469309110927608
2006-07,1610612756,Phoenix Suns,3388,6855,2603,4890,785,1965,Center,146,12.766010211524435,0.493395949515703,0.4950696055684455
2007-08,1610612756,Phoenix Suns,3392,6782,2698,5018,694,1764,Center,139,12.357564140371572,0.5001458151064451,0.5001491201908739
2008-09,1610612756,Phoenix Suns,3372,6694,2820,5250,552,1444,Center,135,10.610546758291006,0.5195114685731308,0.4878633503146539
2009-10,1610612756,Phoenix Suns,3339,6788,2609,5018,730,1770,Center,122,12.131850324101356,0.4979508196721312,0.48576512455516013
2010-11,1610612756,Phoenix Suns,3219,6844,2518,4987,701,1857,Center,145,12.892314436002337,0.46922626025791325,0.47144522144522144
2011-12,1610612756,Phoenix Suns,2495,5445,2051,4150,444,1295,Center,103,12.78457300275482,0.46976401179941,0.446761800219539
2012-13,1610612756,Phoenix Suns,3061,6917,2581,5462,480,1455,Center,134,12.245337574092815,0.4364211737629459,0.44870677128741643
2013-14,1610612756,Phoenix Suns,3171,6843,2407,4790,764,2053,Center,126,12.600175361683473,0.4768735362997658,0.4499562299387219
2014-15,1610612756,Phoenix Suns,3178,7038,2480,4990,698,2048,Center,149,12.607132708155726,0.45882692863334296,0.44450656975118813
2015-16,1610612756,Phoenix Suns,3050,7013,2313,4900,737,2113,Center,154,12.562811920718666,0.44004524886877827,0.4296807592752373
2016-17,1610612756,Phoenix Suns,3270,7258,2655,5406,615,1852,Center,155,12.071369523284652,0.45654565456545654,0.44450579790171174
2017-18,1610612756,Phoenix Suns,3153,7141,2390,4855,763,2286,Center,142,12.476123792185968,0.43859649122807015,0.4445070422535211
2018-19,1610612756,Phoenix Suns,3289,7164,2499,4764,790,2400,Center,152,12.605946398659967,0.46552209400506617,0.452783162558848
2019-20,1610612756,Phoenix Suns,3006,6429,2175,4109,831,2320,Center,112,12.93031575672733,0.4726470588235294,0.46186860349950476
2020-21,1610612756,Phoenix Suns,3118,6357,2178,3867,940,2490,Center,97,14.45445965077867,0.49420970266040687,0.48671726755218214
2021-22,1610612756,Phoenix Suns,3581,7389,2630,4773,951,2616,Center,156,13.727703342806874,0.4900788257678717,0.47924528301886793
2022-23,1610612756,Phoenix Suns,3453,7388,2452,4714,1001,2674,Center,145,13.836220898754737,0.46830601092896174,0.46646995708154504
2003-04,1610612757,Portland Trail Blazers,2898,6467,2517,5365,381,1102,Center,117,11.14055976496057,0.45521472392638035,0.4409105082631743
2004-05,1610612757,Portland Trail Blazers,2896,6422,2476,5261,420,1161,Center,137,10.81002802865151,0.46175726927939315,0.44045426642111724
2005-06,1610612757,Portland Trail Blazers,2791,6267,2427,5225,364,1042,Center,134,11.579064943354076,0.45558375634517767,0.434991974317817
2006-07,1610612757,Portland Trail Blazers,2874,6392,2448,5160,426,1232,Center,127,11.80287859824781,0.4560149207336027,0.4431496062992126
2007-08,1610612757,Portland Trail Blazers,2935,6546,2397,5120,538,1426,Center,129,13.708829819737245,0.4598159509202454,0.43700547778454046
2008-09,1610612757,Portland Trail Blazers,3018,6494,2422,4939,596,1555,Center,132,12.396827841084077,0.47529554410427405,0.4538341158059468
2009-10,1610612757,Portland Trail Blazers,2974,6453,2483,5065,491,1388,Center,124,12.52223771889044,0.46008077042559803,0.4616573902288188
2010-11,1610612757,Portland Trail Blazers,2950,6598,2433,5096,517,1502,Center,111,12.13064565019703,0.4528985507246377,0.44126597687157637
2011-12,1610612757,Portland Trail Blazers,2402,5417,1924,4035,478,1382,Center,105,12.513752999815395,0.4563142437591777,0.4303750464166357
2012-13,1610612757,Portland Trail Blazers,3008,6713,2336,4811,672,1902,Center,148,13.118724862207657,0.45308310991957107,0.4430870083432658
2013-14,1610612757,Portland Trail Blazers,3207,7134,2437,5063,770,2071,Center,117,13.400616764788337,0.458391706360325,0.44067321178120616
2014-15,1610612757,Portland Trail Blazers,3172,7046,2368,4818,804,2228,Center,140,13.737865455577632,0.4505805720758992,0.44978662873399716
2015-16,1610612757,Portland Trail Blazers,3167,7036,2303,4704,864,2332,Center,131,13.267197271176805,0.4618202310510003,0.4381990249498136
2016-17,1610612757,Portland Trail Blazers,3241,7057,2391,4787,850,2270,Center,137,12.959756270369846,0.46863572433192685,0.4497430039977156
2017-18,1610612757,Portland Trail Blazers,3222,7132,2377,4824,845,2308,Center,145,12.993970835670218,0.45853382394565523,0.4451236454570714
2018-19,1610612757,Portland Trail Blazers,3470,7427,2566,4907,904,2520,Center,141,12.70311027332705,0.4789374832304803,0.4554054054054054
2019-20,1610612757,Portland Trail Blazers,3122,6749,2170,4224,952,2525,Center,146,13.80500814935546,0.46896127842655194,0.45665236051502145
2020-21,1610612757,Portland Trail Blazers,2973,6558,1841,3619,1132,2939,Center,133,15.085696858798414,0.4462381967712458,0.46045801526717556
2021-22,1610612757,Portland Trail Blazers,3161,7144,2118,4127,1043,3017,Center,134,14.071248600223964,0.44521306032097396,0.4396600566572238
2022-23,1610612757,Portland Trail Blazers,3317,7001,2261,4108,1056,2893,Center,135,13.739180117126125,0.4771949828962372,0.4703693100486688
2003-04,1610612758,Sacramento Kings,3103,6711,2502,5213,601,1498,Center,115,12.625093130680971,0.4730700179533214,0.45176610270109824
2004-05,1610612758,Sacramento Kings,3203,6978,2681,5582,522,1396,Center,122,13.017913442247062,0.4742857142857143,0.4436457734330075
2005-06,1610612758,Sacramento Kings,2954,6500,2460,5092,494,1408,Center,122,12.897230769230768,0.4650371287128713,0.44400244798041616
2006-07,1610612758,Sacramento Kings,2941,6532,2411,5019,530,1513,Center,139,12.333282302510716,0.460546515198035,0.44
2007-08,1610612758,Sacramento Kings,3043,6558,2533,5191,510,1367,Center,133,11.675510826471486,0.46287279367011563,0.46515892420537897
2008-09,1610612758,Sacramento Kings,2990,6684,2404,5091,586,1593,Center,127,12.347845601436266,0.4460537984037836,0.44865192365949713
2009-10,1610612758,Sacramento Kings,3143,6894,2662,5512,481,1382,Center,156,11.211198143313025,0.4626993166287016,0.4488468361916026
2010-11,1610612758,Sacramento Kings,3133,6977,2706,5702,427,1275,Center,147,11.503224881754337,0.4435507038207412,0.4545194508009153
2011-12,1610612758,Sacramento Kings,2490,5712,2079,4411,411,1301,Center,117,11.273809523809524,0.44800845964046526,0.424
2012-13,1610612758,Sacramento Kings,3086,6904,2476,5223,610,1681,Center,139,11.72305909617613,0.4650482597250658,0.4292682926829268
2013-14,1610612758,Sacramento Kings,3026,6766,2535,5291,491,1475,Center,127,11.781554832988471,0.4545995832092885,0.4399765189316114
2014-15,1610612758,Sacramento Kings,3010,6617,2549,5267,461,1350,Center,131,11.011938945141303,0.45874587458745875,0.4509744214372716
2015-16,1610612758,Sacramento Kings,3283,7082,2623,5244,660,1838,Center,150,11.648828014685117,0.4671033893477642,0.460095211425371
2016-17,1610612758,Sacramento Kings,3100,6727,2368,4774,732,1953,Center,139,12.616173628660622,0.4702881152460984,0.4515463917525773
2017-18,1610612758,Sacramento Kings,3179,7063,2441,5096,738,1967,Center,148,12.864363584878946,0.46145092460881937,0.4388387824126268
2018-19,1610612758,Sacramento Kings,3541,7637,2614,5182,927,2455,Center,139,12.567107502946183,0.4627798021863613,0.4645586297760211
2019-20,1610612758,Sacramento Kings,2943,6364,2029,3853,914,2511,Center,137,13.669704588309239,0.4659533073929961,0.45914634146341465
2020-21,1610612758,Sacramento Kings,3067,6382,2193,3982,874,2400,Center,139,13.17141961767471,0.4949077021005729,0.4666666666666667
2021-22,1610612758,Sacramento Kings,3321,7223,2384,4501,937,2722,Center,142,13.368406479302228,0.4646293152235427,0.45513689346706426
2022-23,1610612758,Sacramento Kings,3573,7232,2445,4172,1128,3060,Center,149,13.781111725663717,0.5073631564323423,0.4808698045692265
2003-04,1610612759,San Antonio Spurs,2842,6434,2434,5294,408,1140,Center,116,11.164594342555176,0.4565896314803248,0.42698019801980197
2004-05,1610612759,San Antonio Spurs,2923,6450,2416,5055,507,1395,Center,123,11.187131782945736,0.47252396166134186,0.43493975903614457
2005-06,1610612759,San Antonio Spurs,2993,6342,2469,4980,524,1362,Center,116,11.421948912015138,0.47686053783614757,0.4669211195928753
2006-07,1610612759,San Antonio Spurs,2999,6328,2404,4767,595,1561,Center,133,12.225979772439949,0.4757097791798107,0.4721342621912603
2007-08,1610612759,San Antonio Spurs,2938,6424,2344,4814,594,1610,Center,125,12.81242216687422,0.4680719156850589,0.44652908067542213
2008-09,1610612759,San Antonio Spurs,3041,6532,2417,4914,624,1618,Center,130,12.999387630128597,0.48149300155520997,0.45010551703346396
2009-10,1610612759,San Antonio Spurs,3149,6657,2596,5112,553,1545,Center,111,11.759050623403935,0.49173926103935117,0.4543269230769231
2010-11,1610612759,San Antonio Spurs,3148,6626,2463,4901,685,1725,Center,123,12.166012677331723,0.4883863080684597,0.46213476446034585
2011-12,1610612759,San Antonio Spurs,2611,5463,2059,4058,552,1405,Center,106,11.946915614131429,0.49029126213592233,0.4660682226211849
2012-13,1610612759,San Antonio Spurs,3210,6674,2547,4911,663,1763,Center,131,11.982768954150435,0.49743589743589745,0.464721643346234
2013-14,1610612759,San Antonio Spurs,3326,6843,2628,5087,698,1756,Center,156,12.08037410492474,0.4977830328111144,0.4745664739884393
2014-15,1610612759,San Antonio Spurs,3208,6852,2531,5007,677,1845,Center,118,12.052247518972562,0.4887196015235863,0.44780459435882525
2015-16,1610612759,San Antonio Spurs,3288,6792,2719,5279,569,1513,Center,128,12.139134275618375,0.48784060943451507,0.4803196211897011
2016-17,1610612759,San Antonio Spurs,3222,6862,2469,4937,753,1925,Center,117,12.995919556980471,0.47300469483568075,0.46612623045744067
2017-18,1610612759,San Antonio Spurs,3202,6999,2506,5022,696,1977,Center,129,12.713101871695956,0.4735184655024334,0.4415288077581289
2018-19,1610612759,San Antonio Spurs,3468,7248,2656,5177,812,2071,Center,121,13.39059050772627,0.4870292887029289,0.4701064701064701
2019-20,1610612759,San Antonio Spurs,2995,6350,2235,4329,760,2021,Center,131,13.604094488188977,0.4751796211626388,0.4683698296836983
2020-21,1610612759,San Antonio Spurs,3014,6518,2298,4472,716,2046,Center,116,12.87066584841976,0.4627463054187192,0.4620795107033639
2021-22,1610612759,San Antonio Spurs,3546,7601,2621,4975,925,2626,Center,142,12.881989211945797,0.47251273799946364,0.4607438016528926
2022-23,1610612759,San Antonio Spurs,3533,7593,2622,4953,911,2640,Center,124,12.580534703015935,0.47780126849894294,0.4528747702809136
2003-04,1610612760,Seattle SuperSonics,2939,6590,2216,4654,723,1936,Center,130,13.139605462822459,0.44738424533974747,0.44454656862745096
2004-05,1610612760,Seattle SuperSonics,2882,6498,2216,4674,666,1824,Center,110,12.487842413050169,0.4503513596089215,0.4365891472868217
2005-06,1610612760,Seattle SuperSonics,3077,6711,2472,5080,605,1631,Center,121,12.14558188049471,0.4660107334525939,0.4509979148048853
2006-07,1610612760,Seattle SuperSonics,3047,6628,2522,5177,525,1451,Center,137,11.454435727217863,0.45683126325355955,0.4625788999098287
2007-08,1610612760,Seattle SuperSonics,3125,7032,2812,6093,313,939,Center,150,11.272468714448237,0.44961461604339137,0.4392179087560215
2003-04,1610612761,Toronto Raptors,2654,6348,2193,5054,461,1294,Center,136,12.6734404536862,0.42728682170542637,0.4085814921549792
2004-05,1610612761,Toronto Raptors,2952,6656,2304,4975,648,1681,Center,136,12.508713942307692,0.4499243570347958,0.43718293046851686
2005-06,1610612761,Toronto Raptors,3013,6639,2405,5019,608,1620,Center,148,12.488175930109957,0.45481307035619667,0.4528069093152375
2006-07,1610612761,Toronto Raptors,3032,6547,2501,5083,531,1464,Center,124,12.783564991599206,0.4782741738066095,0.448002439768222
2007-08,1610612761,Toronto Raptors,3148,6726,2576,5267,572,1459,Center,139,13.188670829616415,0.4748073503260225,0.46121718377088305
2008-09,1610612761,Toronto Raptors,3054,6673,2575,5384,479,1289,Center,126,12.71572006593736,0.47060587882423516,0.444743935309973
2009-10,1610612761,Toronto Raptors,3199,6631,2681,5234,518,1397,Center,133,12.22108279294224,0.48086124401913877,0.4840279890477639
2010-11,1610612761,Toronto Raptors,3144,6755,2799,5664,345,1091,Center,149,11.298889711324945,0.48179356003611196,0.4495920745920746
2011-12,1610612761,Toronto Raptors,2268,5154,1903,4079,365,1075,Center,122,12.624369421808304,0.4474290099769762,0.4324960753532182
2012-13,1610612761,Toronto Raptors,2978,6682,2408,5020,570,1662,Center,117,13.033672553127806,0.444311377245509,0.44703770197486536
2013-14,1610612761,Toronto Raptors,2992,6716,2279,4801,713,1915,Center,108,13.071768910065515,0.4463226571767497,0.44467703349282295
2014-15,1610612761,Toronto Raptors,3108,6828,2382,4769,726,2059,Center,133,12.74721734036321,0.46008403361344535,0.4505148741418764
2015-16,1610612761,Toronto Raptors,3006,6658,2298,4754,708,1904,Center,130,12.312406127966357,0.4592481203007519,0.44374437443744374
2016-17,1610612761,Toronto Raptors,3211,6914,2486,4922,725,1992,Center,152,12.721290135956032,0.47521613832853027,0.4535423925667828
2017-18,1610612761,Toronto Raptors,3383,7169,2415,4464,968,2705,Center,133,13.189566187752824,0.4701042238069117,0.47374396820891285
2018-19,1610612761,Toronto Raptors,3460,7305,2445,4534,1015,2771,Center,138,13.264202600958248,0.47834377553800056,0.468904788112273
2019-20,1610612761,Toronto Raptors,2897,6331,1902,3668,995,2663,Center,114,13.458695308797978,0.46503606146127313,0.45003182686187143
2020-21,1610612761,Toronto Raptors,2859,6383,1818,3552,1041,2831,Center,127,14.37004543318189,0.4435785536159601,0.45228346456692914
2021-22,1610612761,Toronto Raptors,3332,7489,2353,4681,979,2808,Center,138,13.792762718654027,0.45267379679144387,0.43718324886636434
2022-23,1610612761,Toronto Raptors,3434,7489,2554,4863,880,2626,Center,138,13.08385632260649,0.46327077747989276,0.4538441074753924
2003-04,1610612762,Utah Jazz,2690,6172,2438,5386,252,786,Center,117,11.206416072585872,0.44212585588522985,0.42962962962962964
2004-05,1610612762,Utah Jazz,2828,6301,2578,5539,250,762,Center,132,11.285986351372799,0.45466196731816727,0.4430817610062893
2005-06,1610612762,Utah Jazz,2744,6207,2433,5282,311,925,Center,107,11.340583212502015,0.44195849546044097,0.44220300992635286
2006-07,1610612762,Utah Jazz,3069,6471,2715,5415,354,1056,Center,140,11.025652912996446,0.49147286821705427,0.4571780653111522
2007-08,1610612762,Utah Jazz,3279,6592,2872,5497,407,1095,Center,139,10.88501213592233,0.5132905591200734,0.481771617957216
2008-09,1610612762,Utah Jazz,3143,6623,2751,5501,392,1122,Center,132,10.863505964064624,0.4858361254949741,0.46347305389221555
2009-10,1610612762,Utah Jazz,3227,6575,2788,5368,439,1207,Center,140,10.57277566539924,0.5113636363636364,0.4706236818318771
2010-11,1610612762,Utah Jazz,3064,6590,2629,5334,435,1256,Center,132,11.591502276176024,0.47090744648779015,0.4589062022609227
2011-12,1610612762,Utah Jazz,2523,5531,2250,4686,273,845,Center,108,10.696076658832038,0.46372584761210356,0.4487087517934003
2012-13,1610612762,Utah Jazz,3046,6710,2539,5325,507,1385,Center,119,11.978241430700447,0.4703389830508475,0.4380504991192014
2013-14,1610612762,Utah Jazz,2951,6650,2408,5075,543,1575,Center,159,12.236541353383458,0.45506982392228296,0.432657926102503
2014-15,1610612762,Utah Jazz,2900,6492,2290,4711,610,1781,Center,109,12.18222427603204,0.4497869750456482,0.44354335620711166
2015-16,1610612762,Utah Jazz,2957,6593,2263,4637,694,1956,Center,136,12.280752313059306,0.4541511771995043,0.4430906389301634
2016-17,1610612762,Utah Jazz,3033,6514,2242,4387,791,2127,Center,133,12.632944427387166,0.4684769038701623,0.46283987915407854
2017-18,1610612762,Utah Jazz,3139,6797,2252,4372,887,2425,Center,124,13.243342651169634,0.46477205447010067,0.45890611289850836
2018-19,1610612762,Utah Jazz,3314,7082,2321,4293,993,2789,Center,131,12.980090369951991,0.4664788732394366,0.4694224235560589
2019-20,1610612762,Utah Jazz,2886,6130,1923,3593,963,2537,Center,120,13.636378466557911,0.47342026078234706,0.4683020070086015
2020-21,1610612762,Utah Jazz,2971,6344,1766,3246,1205,3098,Center,114,15.009142496847415,0.4716379859783301,0.4650655021834061
2021-22,1610612762,Utah Jazz,3327,7067,2135,3759,1192,3308,Center,135,14.585255412480544,0.47959470869687587,0.46186681844052363
2022-23,1610612762,Utah Jazz,3485,7365,2391,4266,1094,3099,Center,141,13.717990495587237,0.47029702970297027,0.47599892732636095
2003-04,1610612764,Washington Wizards,2759,6557,2325,5287,434,1270,Center,125,11.501906359615678,0.4266747133373567,0.4147394387912427
2004-05,1610612764,Washington Wizards,2966,6794,2452,5296,514,1498,Center,116,12.071975272299088,0.4423584628923438,0.43072378138847855
2005-06,1610612764,Washington Wizards,2975,6656,2478,5262,497,1394,Center,117,12.153846153846153,0.45725585640401584,0.4369249035322054
2006-07,1610612764,Washington Wizards,3070,6820,2509,5206,561,1614,Center,127,12.758797653958945,0.45807770961145194,0.4421548425080954
2007-08,1610612764,Washington Wizards,2986,6695,2411,5081,575,1614,Center,133,12.592531740104556,0.4580587177950869,0.4340184688710158
2008-09,1610612764,Washington Wizards,2994,6655,2599,5457,395,1198,Center,132,11.453493613824193,0.45146794487717196,0.448296653602653
2009-10,1610612764,Washington Wizards,3008,6700,2576,5475,432,1225,Center,134,12.151641791044776,0.4567864567864568,0.44104410441044106
2010-11,1610612764,Washington Wizards,3048,6888,2656,5706,392,1182,Center,139,11.704268292682928,0.44598899507674483,0.43901018922852986
2011-12,1610612764,Washington Wizards,2412,5472,2070,4400,342,1072,Center,111,11.683479532163743,0.45174165457184323,0.42967599410898377
2012-13,1610612764,Washington Wizards,2910,6692,2365,5198,545,1494,Center,123,12.598625224148236,0.4518341783477483,0.41778975741239893
2013-14,1610612764,Washington Wizards,3177,6918,2530,5216,647,1702,Center,119,12.728100607111882,0.4638360175695461,0.454753068798173
2014-15,1610612764,Washington Wizards,3139,6790,2642,5409,497,1381,Center,128,12.111045655375552,0.4720351390922401,0.4524444444444444
2015-16,1610612764,Washington Wizards,3237,7027,2529,5050,708,1977,Center,122,12.902661164081401,0.4658119658119658,0.4555018481660506
2016-17,1610612764,Washington Wizards,3385,7129,2632,5107,753,2022,Center,134,12.630944031420956,0.48240635641316687,0.46740638002773927
2017-18,1610612764,Washington Wizards,3275,7018,2461,4845,814,2173,Center,126,13.448845825021374,0.479136690647482,0.45441716059836296
2018-19,1610612764,Washington Wizards,3456,7387,2526,4656,930,2731,Center,138,13.281034249356978,0.4801845819761129,0.4555765595463138
2019-20,1610612764,Washington Wizards,2990,6544,2126,4199,864,2345,Center,118,13.685971882640587,0.4559902200488998,0.4578239608801956
2020-21,1610612764,Washington Wizards,3108,6547,2375,4459,733,2088,Center,117,13.074385214602108,0.48287359806001817,0.4664408866995074
2021-22,1610612764,Washington Wizards,3327,7056,2467,4544,860,2512,Center,152,13.373299319727892,0.47822422028659733,0.4646840148698885
2022-23,1610612764,Washington Wizards,3456,7127,2531,4526,925,2601,Center,141,13.525466535709274,0.48467966573816157,0.4851569126378287
